time,memory,continent,program_vocabulary,program_length,calculated_estimated_program_length,volume,difficulty,effort,loc,slocP,lsloc,comments,blankLine,cyclomatic_complexity,numberOfFunction,gender
93,47000,Asia,62,263,307.3464548,1565.95363,23.32758621,36529.91829,31,24,24,7,0,15,3,male
156,5600,Asia,68,258,345.9899115,1570.565413,33.93939394,53304.03826,26,23,23,3,0,16,1,male
77,67100,Asia,50,313,235.9518742,1766.526987,24.26470588,42864.25778,48,42,39,6,3,18,2,male
202,68100,North America,72,418,372.5956925,2579.028651,53.30769231,137482.0658,42,36,35,6,1,26,2,male
202,68100,Asia,72,418,372.5956925,2579.028651,53.30769231,137482.0658,41,36,36,5,0,26,2,male
248,68100,Europe,72,418,372.5956925,2579.028651,53.30769231,137482.0658,41,36,36,5,0,26,2,male
77,50600,Europe,67,325,339.6973857,1971.478987,47.61290323,93867.83821,52,43,41,9,2,19,2,male
77,72000,Asia,50,345,235.9518742,1947.130385,24.26470588,47246.54612,57,51,51,6,0,34,2,male
77,72000,Asia,50,345,235.9518742,1947.130385,24.26470588,47246.54612,57,51,51,6,0,34,2,male
202,35200,Asia,65,424,326.4650059,2553.483953,49.5,126397.4557,66,58,58,8,0,25,3,male
62,4700,Asia,66,420,333.3240179,2538.64553,72,182782.4782,53,50,50,3,0,24,4,male
78,67100,Europe,60,408,295.1851693,2410.011363,56.23076923,135516.7928,65,50,43,15,7,30,2,male
46,36800,North America,80,463,428.700868,2927.052708,34.79591837,101849.4871,59,50,48,9,2,26,2,male
61,48600,Asia,84,448,455.1665461,2863.758205,51,146051.6685,40,30,27,10,3,23,2,male
124,4200,Asia,61,328,301.3556992,1945.281847,26.44444444,51441.89772,36,27,23,9,4,21,1,male
92,68000,North America,56,397,270.0391,2305.519904,56,129109.1146,64,55,50,9,5,24,2,male
62,75500,Asia,55,420,265.2124025,2428.17108,23.47619048,57004.20678,48,42,42,6,0,44,2,male
109,115300,Asia,33,345,166.4650059,1740.315971,0,0,84,78,78,6,0,28,2,male
62,43600,Asia,70,448,359.0498112,2745.918792,36.5,100226.0359,77,60,53,17,7,31,2,male
186,82000,Unknown,41,262,195.0346806,1403.678625,17.5,24564.37594,66,34,17,32,17,14,2,male
202,69000,Asia,54,399,258.7036718,2296.200113,46.35714286,106445.2767,83,78,78,5,0,34,2,male
62,42900,Asia,76,515,400.2149912,3217.682669,42.54545455,136897.7718,50,42,40,8,2,33,2,male
139,99100,Europe,75,405,392.6333688,2522.67157,37.31707317,94138.71955,52,39,33,13,6,22,2,male
46,5800,Asia,85,541,461.2380824,3467.480496,49.2244898,170684.9583,53,39,36,14,3,29,2,male
93,36900,Asia,73,424,379.3421297,2624.485613,42.9,112590.4328,59,46,42,13,4,17,2,male
77,55400,Asia,67,441,339.5249056,2675.145333,40.22857143,107617.2751,72,66,66,6,0,27,2,female
62,55700,Asia,84,514,455.1665461,3285.651155,41.14,135171.6885,59,54,54,5,0,27,3,male
77,55500,Asia,82,405,439.8831639,2574.808562,37.41111111,96326.4492,53,41,37,12,4,24,2,male
171,52500,Asia,93,533,519.2878033,3485.371646,50.68965517,176672.2869,58,50,47,8,3,26,2,male
248,121900,Europe,60,453,294.4615345,2675.82144,49.58064516,132668.9533,63,55,52,8,3,32,2,male
77,68000,Asia,62,479,307.3464548,2852.060033,51.20689655,146045.1431,65,60,59,5,1,31,3,male
46,16600,Europe,66,434,332.9300119,2623.267048,19.5,51153.70743,40,34,34,6,0,31,1,male
46,7600,Asia,53,350,255.6041684,2004.772159,25.41176471,50944.7984,80,74,74,6,0,31,1,female
62,37000,Asia,85,593,461.7177151,3800.768825,65.45,248760.3196,38,34,34,4,0,36,3,male
61,5800,South America,67,424,339.6973857,2572.021817,54.58064516,140382.6101,64,45,30,19,15,20,1,male
249,73900,Asia,59,385,288.6764386,2264.817574,46.32692308,104922.0295,98,91,89,7,2,32,2,male
202,41600,Asia,82,476,440.5905816,3026.194754,46.54255319,140846.8303,64,58,57,6,1,31,3,female
124,115500,North America,70,398,360.0838417,2439.454641,71.33333333,174014.431,75,60,51,15,9,22,3,male
249,68100,Asia,71,457,365.6422056,2810.434434,43.26388889,121590.3231,69,56,52,13,4,32,2,male
62,52400,Asia,83,530,450.002951,3378.770899,42.625,144020.1096,55,46,46,9,0,34,2,male
92,71100,Asia,64,398,320.1804545,2388,64.6,154264.8,51,38,31,13,7,26,2,male
46,4800,Asia,78,547,414.08385,3438.115014,38.60869565,132741.1362,56,53,52,3,1,31,1,male
46,4800,Asia,59,428,288.6764386,2517.771225,46.96153846,118238.4102,82,64,62,18,2,26,1,male
249,40000,Asia,65,485,326.4650059,2920.848389,67.39393939,196847.4793,51,39,36,12,3,32,2,male
46,5600,Asia,59,426,289.0701413,2506.005939,76.84,192561.4964,68,57,53,11,4,28,1,male
93,11700,Asia,89,509,489.1726399,3296.148316,28.81730769,94986.12023,49,43,43,6,0,32,2,male
77,42800,Europe,85,484,461.7177151,3102.145213,33.6,104232.0792,59,43,39,16,4,31,2,male
61,36900,Europe,70,432,359.0910367,2647.850263,48.70588235,128965.8834,67,59,58,8,1,25,2,male
139,103600,Asia,76,613,399.4510684,3829.979566,63.95238095,244936.3122,47,36,31,11,5,40,3,female
264,145200,Asia,41,367,188.529325,1966.221586,17.77777778,34955.05041,73,54,44,19,10,30,3,female
436,82900,Asia,60,488,294.8469685,2882.562611,70.27777778,202580.0946,68,54,46,14,8,34,4,male
46,5500,Asia,59,477,288.1860234,2806.020735,54.25,152226.6248,50,42,38,8,4,31,1,male
93,68000,Europe,68,453,346.1173001,2757.620667,61.875,170627.7788,49,43,42,6,1,35,3,male
93,63400,Asia,59,370,288.6764386,2176.577928,30.46153846,66301.91228,62,54,52,8,2,24,2,female
62,38800,Asia,64,478,320.0450916,2868,76.64516129,219818.3226,70,56,49,14,7,27,3,male
77,68000,Europe,66,486,334.0271833,2937.575542,73.96428571,217275.6767,93,69,51,24,18,34,3,male
218,33200,Asia,83,521,450.002951,3321.395544,36.36538462,120783.8264,74,56,56,18,0,25,2,female
46,5600,Asia,52,429,249.0117739,2445.488639,71.02941176,173701.6195,70,63,59,7,4,33,1,male
62,21400,North America,42,393,210.885574,2119.180747,19.5,41324.02457,47,38,38,9,0,23,1,male
46,8500,Asia,58,564,282.2114327,3303.901281,80.61538462,266345.2725,68,62,61,6,1,34,1,male
61,55600,Asia,73,459,378.8670746,2841.129473,43.2972973,123013.2274,55,47,47,8,0,29,2,female
93,83700,Europe,53,482,252.2386659,2760.857659,51.04761905,140935.21,86,61,42,25,19,37,2,male
186,85400,North America,74,529,385.4995491,3284.80083,67.5,221724.0561,56,47,47,9,0,33,3,male
92,82700,Asia,53,450,253.6843594,2577.564205,35.78947368,92249.66627,91,73,65,18,8,37,2,male
77,68000,North America,65,558,326.5538222,3360.48124,56.07352941,188434.0436,74,63,59,11,4,29,2,male
109,72300,Europe,58,449,283.5668306,2630.233467,92.06521739,242153.0159,67,60,56,7,4,26,2,male
77,70100,Asia,84,468,453.092115,2991.604554,51.36363636,153659.6884,51,39,37,12,2,28,3,male
109,75500,Asia,68,573,346.1173001,3488.116208,88.44444444,308504.5002,53,47,45,6,2,30,2,male
124,107100,Asia,68,438,346.3298602,2666.308724,56.09677419,149571.3184,88,69,62,19,7,31,4,male
46,3900,Asia,72,378,372.5956925,2332.231651,33.09090909,77175.66553,78,54,46,24,8,15,2,female
61,55700,Asia,79,545,419.2271063,3435.560508,47.13095238,161921.2387,72,62,61,10,1,36,3,male
77,46400,Asia,78,476,412.85429,2991.851456,53.31395349,159507.4294,72,55,49,17,6,25,3,male
77,68800,AsiaEurope,62,431,308.8461793,2566.25861,41.44,106345.7568,62,54,52,8,2,34,2,male
108,68500,AsiaEurope,72,556,372.5956925,3430.478301,73.27272727,251360.5009,74,66,66,8,0,35,2,male
62,71000,Asia,79,478,419.0808777,3013.207198,39.3902439,118690.9664,64,50,50,14,0,21,3,male
77,36300,Asia,99,535,561.9099458,3546.705792,54.90322581,194725.589,52,37,33,15,4,24,3,male
202,37800,Asia,75,520,392.9423377,3238.985719,64.42857143,208683.2228,80,57,42,23,15,32,3,male
46,35900,AsiaEurope,76,558,398.9944238,3486.343553,73.8,257292.1542,62,51,51,11,0,29,2,male
31,13700,Asia,77,541,405.551932,3390.331519,47.74358974,161866.5971,56,43,43,13,0,24,1,female
46,13700,Asia,77,541,405.551932,3390.331519,47.74358974,161866.5971,56,43,43,13,0,24,1,female
46,8700,Asia,89,592,487.9979062,3833.634191,50.6122449,194028.8325,55,43,38,12,5,28,4,male
46,5300,Europe,63,258,314.4992626,1542.13822,34,52432.69949,65,44,31,21,13,18,1,male
61,36900,Europe,78,469,414.08385,2947.853641,34.43478261,101508.6993,55,43,38,12,5,32,2,male
46,3700,Europe,65,450,326.4650059,2710.065516,55.75757576,151106.6833,85,66,53,19,13,22,2,male
156,7600,AsiaEurope,55,402,263.3031226,2324.106605,63.6,147813.1801,60,53,50,7,3,27,1,female
93,38800,Asia,86,544,467.1963626,3495.888027,60.15957447,210311.1361,67,44,41,23,3,29,5,male
61,35900,Asia,75,541,392.4020294,3369.790912,33.6875,113519.8313,70,46,33,24,13,30,2,male
109,83600,Asia,59,427,288.6764386,2511.888582,74.88461538,188101.8104,61,51,47,10,4,27,2,male
124,99900,North America,65,454,327.3557123,2734.154987,86.55357143,236650.879,67,58,54,9,4,28,2,male
46,4600,Europe,75,558,392.4020294,3475.680829,83.125,288915.9689,48,38,36,10,2,29,1,male
46,4700,AsiaEurope,72,504,372.2346001,3109.642201,91.5,284532.2614,74,54,40,20,14,25,5,male
124,100000,South America,81,485,433.6087556,3074.827251,42.98913043,132184.1498,64,47,37,17,10,25,2,male
108,103700,Europe,63,489,314.4992626,2922.889883,87.33333333,255265.7164,68,59,59,9,0,28,3,female
77,37800,Asia,80,446,425.7542476,2819.57993,56.5,159306.2661,53,39,37,14,2,19,3,male
140,4800,Europe,61,495,301.3556992,2935.714982,54.77777778,160811.9429,72,65,64,7,1,26,1,male
77,42900,Asia,83,526,446.8336245,3353.270741,67.56521739,226564.4666,61,57,57,4,0,35,4,male
187,149600,Asia,75,555,392.17102,3456.994373,35.53947368,122859.7606,58,37,37,21,0,24,2,female
170,149600,Asia,75,555,392.17102,3456.994373,35.53947368,122859.7606,58,37,37,21,0,24,2,male
46,5800,Asia,84,554,454.1955001,3541.343852,56.625,200528.5956,80,54,37,26,17,26,1,male
46,5800,Asia,84,554,454.1955001,3541.343852,56.625,200528.5956,80,54,37,26,17,26,1,female
46,2300,Asia,84,554,454.1955001,3541.343852,56.625,200528.5956,80,54,37,26,17,26,1,male
124,90500,Asia,48,394,227.6306219,2200.475225,24.23076923,53319.20738,93,76,76,17,0,28,2,male
77,73900,Asia,65,622,326.7316235,3745.91278,77,288435.284,69,64,64,5,0,44,3,male
93,83800,AsiaAfrica,59,384,289.5640056,2258.934931,64.89583333,146595.4648,72,58,50,14,8,26,2,female
62,12000,Asia,66,462,333.3240179,2792.510083,72,201060.726,59,42,35,17,7,23,1,male
46,5600,Asia,52,321,249.0117739,1829.84115,23.67647059,43324.18016,63,43,40,20,3,18,1,male
187,101000,Asia,76,579,399.1845378,3617.55003,81.09756098,293374.4842,69,62,61,7,1,32,2,male
140,55900,Asia,78,590,414.08385,3708.387309,50.7826087,188321.5816,60,43,40,17,3,22,3,male
108,83700,Asia,42,389,194.994331,2097.611477,45.83333333,96140.52605,84,72,72,12,0,21,2,male
92,71100,Asia,69,441,352.582306,2693.859285,53.45454545,143999.0236,57,51,51,6,0,32,2,male
124,52600,Asia,73,501,378.8670746,3101.102104,70.05405405,217244.7744,77,62,57,15,5,27,2,male
248,69100,Asia,58,434,281.9620482,2542.363752,45.35185185,115300.9042,88,75,70,13,5,24,2,male
77,55400,Asia,89,558,488.714938,3613.459254,67.80392157,245006.7079,56,44,41,12,3,29,2,male
77,53700,Asia,83,578,446.8336245,3684.772791,63.14130435,232661.3603,73,65,65,8,0,31,3,male
61,62500,Asia,68,396,345.9474732,2410.635285,26.5,63881.83506,68,56,55,12,1,24,2,female
77,36900,Asia,81,485,433.6087556,3074.827251,42.98913043,132184.1498,64,47,37,17,10,25,2,female
62,36400,Europe,70,479,359.4212455,2935.926565,61.05263158,179246.0429,92,75,68,17,7,27,2,male
93,67100,Asia,62,486,307.1601712,2893.739407,59.5,172177.4947,65,56,52,9,4,33,2,male
92,52400,Asia,44,397,212.401259,2167.394353,26.42857143,57281.13646,94,81,81,13,0,30,3,male
62,17100,Asia,82,516,439.8831639,3280.496834,35.35555556,115983.7881,66,42,42,24,0,19,2,female
61,23700,AsiaEurope,61,385,302.2137048,2283.333875,61.92,141384.0335,102,85,79,17,6,25,2,male
77,68000,Asia,62,458,308.3287327,2727.02191,31.84615385,86845.15929,86,72,61,14,11,28,3,male
249,116000,Asia,42,440,207.4212455,2372.619666,19,45079.77365,97,82,79,15,3,39,2,male
109,53400,Asia,78,471,413.1887278,2960.424445,52.15909091,154413.0478,69,45,29,24,16,29,4,male
186,84700,Asia,58,523,281.8126557,3063.72406,69.64285714,213366.4971,43,32,31,11,1,21,2,male
77,67100,Asia,92,503,508.6701412,3281.351664,65.94,216372.3287,67,55,54,12,1,23,1,male
92,67100,Asia,92,503,508.6701412,3281.351664,65.94,216372.3287,67,55,54,12,1,23,1,male
171,8800,Asia,68,467,345.9899115,2842.845147,39.24242424,111560.1353,64,56,55,8,1,32,2,male
62,36800,Europe,52,483,245.8187515,2753.312384,92.26190476,254025.8449,91,70,64,21,6,28,2,male
77,75100,Asia,51,428,239.4453837,2427.798046,26.42857143,64163.23408,72,66,66,6,0,29,2,male
46,9200,Asia,81,574,432.75063,3639.073902,48.1627907,175267.9547,85,77,77,8,0,29,3,female
93,65000,Asia,71,523,365.6422056,3216.317744,67.56944444,217324.8031,74,58,56,16,2,25,2,male
77,51500,Europe,80,483,425.7903187,3053.49127,69.91463415,213483.725,90,66,53,24,13,26,9,male
77,52900,Europe,78,544,412.2613731,3419.258807,81,276959.9634,63,50,44,13,6,24,3,male
46,8800,Asia,92,625,509.2999891,4077.226223,48.46153846,197588.6554,69,55,55,14,0,34,3,male
77,65200,Asia,70,536,359.2147805,3285.295697,95.3030303,313098.6354,80,71,68,9,3,32,3,female
202,68100,Asia,56,490,273.4603973,2845.603912,44.78947368,127453.1015,94,85,81,9,4,46,2,male
233,50700,Asia,81,509,433.2506894,3226.983651,53.6,172966.3237,57,47,43,10,4,26,3,male
92,68000,Asia,62,447,310.1726115,2661.525751,76.30434783,203085.9866,89,60,37,29,23,34,3,male
93,53500,AsiaEurope,94,487,522.9001971,3192.084771,56.94230769,181764.6732,81,45,23,36,22,27,4,male
218,11700,AsiaEurope,60,483,295.1851693,2853.028158,56.23076923,160427.9679,88,83,83,5,0,33,4,male
62,52700,Asia,73,623,379.3421297,3856.2607,55.275,213154.8102,77,65,63,12,2,40,3,male
93,67100,Asia,66,494,333.3240179,2985.930695,75.6,225736.3605,88,62,54,26,8,27,2,male
61,36900,Unknown,73,623,379.3421297,3856.2607,55.275,213154.8102,77,65,63,12,2,40,3,male
46,54800,Asia,81,586,432.6080183,3715.152102,59.42857143,220786.182,97,85,85,12,0,34,3,female
77,81800,Asia,56,420,271.7635715,2439.089067,106.6666667,260169.5005,66,55,51,11,4,26,2,male
108,85000,AsiaEurope,67,503,339.6973857,3051.242863,54,164767.1146,79,65,60,14,5,33,2,male
156,104000,Europe,64,554,320.7232379,3324,86.78571429,288475.7143,67,63,61,4,2,28,1,male
62,44800,Asia,54,395,257.6220106,2273.180563,47.17391304,107234.8222,78,67,67,11,0,28,3,male
62,32200,Asia,87,462,474.942584,2976.639895,39.22,116743.8167,81,56,49,25,7,23,3,female
61,36900,AsiaEurope,68,390,345.9474732,2374.110508,32,75971.53626,74,67,67,7,0,20,2,male
46,8200,North America,76,489,398.9944238,3055.236554,39.15,119612.5111,93,54,35,39,19,16,4,male
77,69100,Australia,64,455,320.7232379,2730,71.35714286,194805,66,53,48,13,5,33,2,male
93,9200,South America,91,583,502.1708162,3794.044275,65.88235294,249960.564,79,61,51,18,10,28,4,male
109,81900,Asia,83,568,446.8336245,3621.022397,56.30434783,203879.3045,105,80,65,25,15,27,3,male
93,67700,Asia,66,489,333.3240179,2955.708724,83.4,246506.1076,61,51,45,10,6,35,4,male
77,52500,Asia,73,534,378.8670746,3305.366314,41.625,137585.8728,101,77,65,24,12,35,3,male
46,5500,AsiaAfrica,58,414,284.2247957,2425.204132,72.81818182,176598.9554,57,49,47,8,2,22,1,male
686,102100,Europe,62,590,307.9068682,3512.975823,70,245908.3076,90,62,48,28,14,40,2,male
77,69100,Asia,71,504,365.7235111,3099.472548,73.45588235,227674.4909,78,54,45,24,9,31,3,male
124,87900,Europe,82,534,439.460071,3394.93277,47.1627907,160114.5037,72,54,45,18,9,23,2,male
202,7800,Asia,58,552,283.0128366,3233.605509,80.04166667,258823.1743,76,61,51,15,10,34,2,male
265,71300,Asia,69,576,353.3374044,3518.510087,37.7,132647.8303,83,69,69,14,0,28,4,female
62,68300,Asia,76,513,399.1845378,3205.186814,38.41463415,123126.0788,57,51,51,6,0,40,3,male
155,146100,Asia,0,0,0,0,0,0,63,52,47,11,5,36,3,female
62,39900,Asia,83,556,447.1829761,3544.521924,54.76595745,194119.1368,84,64,57,20,7,32,3,female
61,36900,Europe,89,571,489.1726399,3697.643789,64.39423077,238106.9275,78,49,34,29,15,26,2,male
109,100600,Africa,72,501,372.3949821,3091.132426,68.17647059,210742.4989,101,75,60,26,15,30,4,male
61,39800,Asia,75,464,392.9423377,2890.171872,43.60714286,126032.1377,67,57,55,10,2,28,3,male
436,68500,Asia,71,395,365.6422056,2429.150112,42.68571429,103690.0076,51,46,44,5,2,25,3,male
155,7900,Europe,73,603,378.8670746,3732.464209,91.45945946,341369.159,68,51,48,17,3,30,1,male
249,68100,Asia,62,529,307.2067179,3149.769848,58.66666667,184786.4978,89,81,81,8,0,36,2,male
78,39800,Asia,85,583,464.3440107,3736.674916,68.31481481,255270.2549,81,57,41,24,16,29,4,male
124,99200,Asia,44,487,214.9310205,2658.743198,19,50516.12077,86,80,80,6,0,41,3,male
234,12800,Asia,81,549,432.75063,3480.577652,45.06976744,156868.8253,89,73,72,16,1,34,3,male
156,5600,Asia,80,497,426.079159,3141.998263,60.43243243,189878.5977,72,65,65,7,0,33,3,male
265,15500,Asia,69,614,352.4986422,3750.634016,70,262544.3812,87,81,81,6,0,40,3,female
77,71300,Europe,56,588,271.0812322,3414.724694,131.3636364,448570.653,92,76,67,16,9,37,2,male
249,84600,Asia,64,567,320.7232379,3402,75.85714286,258066,70,63,62,7,1,42,2,male
592,83900,Asia,78,643,413.5983953,4041.513627,49.86666667,201536.8129,94,85,84,9,1,33,2,male
109,98900,Asia,85,632,460.8279746,4050.735072,59.35416667,240428.0046,83,63,59,20,4,36,2,female
452,83900,Asia,78,643,413.5983953,4041.513627,49.86666667,201536.8129,94,85,84,9,1,33,2,male
93,68000,Europe,70,562,359.4212455,3444.657056,70.0625,241341.285,101,85,76,16,9,39,5,male
233,68000,Europe,55,454,263.6191856,2624.73731,62,162733.7132,109,74,64,35,10,25,2,male
109,68100,Europe,63,475,314.9612072,2839.207964,67.59615385,191919.5383,79,58,49,21,9,29,3,male
265,107400,Europe,59,496,290.159225,2917.790952,86.08695652,251183.7429,87,66,56,21,10,27,2,male
77,68100,Asia,46,423,217.5786534,2336.466707,27.04545455,63190.80413,100,81,72,19,9,22,2,male
187,106700,Asia,67,462,339.5249056,2802.533206,52.5,147132.9933,66,54,49,12,5,36,2,male
61,47300,South Africa,68,593,346.1173001,3609.865465,43.3125,156352.2979,84,73,73,11,0,32,4,female
46,5500,Asia,73,469,378.8670746,2903.027718,51.56756757,149702.078,77,63,60,14,3,19,4,male
233,61200,Asia,71,484,365.6422056,2976.477606,59.14285714,176037.3898,65,47,36,18,11,32,2,male
46,9700,Asia,78,597,412.5946318,3752.385125,39,146343.0199,91,80,80,11,0,34,2,female
77,48800,Asia,75,642,392.2479866,3998.901599,76.375,305416.1096,84,78,78,6,0,39,2,male
93,60700,North America,77,540,406.0022373,3384.064732,67.5,228424.3694,76,53,49,23,4,29,2,male
217,33200,Europe,72,517,372.5956925,3189.851226,71.07692308,226724.8102,84,69,62,15,7,33,3,male
77,64600,Asia,68,530,346.6279634,3226.355306,49.4,159381.9521,108,80,68,28,12,39,4,male
77,55500,AsiaEurope,80,425,425.8985773,2686.81944,52.47619048,140994.0487,79,57,45,22,12,24,2,male
93,52500,Asia,68,633,346.1173001,3853.363979,82.22222222,316832.1493,91,80,78,11,2,36,2,male
77,74900,Asia,81,631,433.2506894,4000.445352,56.8,227225.296,86,73,73,13,0,41,4,male
62,5800,Europe,84,604,453.8154506,3860.959723,83.05319149,320665.0272,71,59,55,12,4,31,3,male
264,67100,Europe,52,397,244.6450378,2263.074568,35.58333333,80527.73671,78,74,73,4,1,31,2,male
187,36900,Asia,88,538,480.9553238,3475.174211,50,173758.7105,75,64,63,11,1,37,2,male
78,37800,Asia,77,556,405.551932,3484.333317,79.41025641,276691.8021,95,68,51,27,17,33,3,male
77,83800,Asia,65,601,326.4650059,3619.443056,58.78125,212755.3871,102,95,94,7,1,35,2,male
77,50900,North America,79,491,419.0078103,3095.156347,51.79487179,160313.2262,83,60,57,23,3,24,2,male
61,4600,AsiaEurope,66,502,334.5126491,3034.285848,101.1111111,306800.0135,94,62,52,32,10,23,5,male
46,1900,Asia,50,453,236.9737366,2556.666854,57.375,146688.7607,119,110,106,9,4,36,1,male
109,83700,Asia,86,697,469.3966019,4479.106534,84.67307692,379259.7321,79,45,22,34,23,37,3,male
124,107100,Asia,42,315,204.359415,1698.579988,18.5,31423.72978,70,62,61,8,1,23,2,male
62,37900,Europe,88,524,481.2514689,3384.742168,38.60204082,130657.9553,93,65,56,28,9,19,3,male
218,6200,Asia,80,541,425.8985773,3420.163099,46.5952381,159363.3139,111,96,93,15,3,33,2,male
61,36900,Asia,81,686,433.2506894,4349.137102,94.4,410558.5424,66,56,52,10,4,34,3,male
187,88400,AsiaAfrica,66,554,332.9737366,3348.594342,44.70588235,149701.8647,115,103,99,12,4,39,2,male
124,83900,Asia,65,467,326.7316235,2812.445769,44.33333333,124685.0957,92,87,84,5,3,24,3,male
62,29000,Asia,79,615,419.2271063,3876.82516,50.6547619,196379.6554,93,88,88,5,0,42,5,female
46,29000,Asia,79,615,419.2271063,3876.82516,50.6547619,196379.6554,93,88,88,5,0,42,5,female
202,13500,Asia,77,561,406.6799972,3515.667249,55.875,196437.9076,95,81,75,14,6,32,3,male
171,37800,Asia,65,465,326.5538222,2800.401033,48.25806452,135141.9337,95,74,62,21,12,29,2,male
77,36800,Asia,78,561,412.2983693,3526.110645,76.95,271334.2141,82,69,68,13,1,31,2,male
77,68100,Asia,68,524,346.1173001,3189.830529,56.8125,181222.2469,67,59,56,8,3,34,2,male
92,71800,Asia,67,578,339.5249056,3506.199552,59.0625,207084.911,82,62,60,20,2,37,3,male
93,99000,Asia,89,653,487.7378322,4228.65393,65.77083333,278122.0929,85,64,60,21,4,40,2,female
46,6600,Asia,89,603,489.1726399,3904.867259,66.17307692,258397.0815,71,55,51,16,4,29,2,male
46,24200,AsiaAfrica,98,542,551.3041687,3585.172736,72.70909091,260674.6504,72,46,34,26,12,26,4,male
62,6600,Asia,82,552,439.460071,3509.368707,58.95348837,206889.5272,79,68,66,11,2,31,1,male
202,53400,Asia,49,382,228.6387356,2144.81916,24.11111111,51713.97309,72,60,59,12,1,23,2,male
46,58700,Asia,92,669,510.1851706,4364.262949,71.07407407,310185.9481,75,62,57,13,5,46,3,male
61,13200,North America,65,609,326.7316235,3667.621998,93.33333333,342311.3865,74,67,66,7,1,33,4,male
296,123100,Asia,77,676,407.6639356,4236.347702,67.72826087,286920.4623,77,64,59,13,5,29,2,male
140,27600,Europe,43,491,217.6320113,2664.295995,20,53285.91989,94,56,34,38,22,34,3,male
92,40800,Europe,75,533,392.2479866,3319.960362,57.69230769,191536.1747,95,78,72,17,6,35,3,female
217,5800,Asia,47,491,222.5444556,2727.303126,32.08333333,87500.9753,105,89,89,16,0,37,5,male
140,114900,AsiaEurope,70,560,359.2147805,3432.398489,71.7972973,246436.9348,61,51,47,10,4,41,2,male
171,37000,North America,68,500,346.3298602,3043.731421,53.2027027,161934.7379,90,72,66,18,6,27,2,male
46,36800,Asia,71,486,366.8663501,2988.7771,34.75609756,103878.2285,77,70,70,7,0,37,2,male
77,40800,North America,70,483,359.4212455,2960.443697,81.9375,242571.3554,101,71,53,30,18,27,3,male
155,65000,Asia,72,526,372.5956925,3245.380551,61.76923077,200464.6602,69,58,56,11,2,25,2,male
436,50900,Asia,64,607,320.7232379,3642,32.14285714,117064.2857,72,69,68,3,1,33,1,male
140,53500,AsiaAfrica,68,502,345.9474732,3055.906346,51.5,157379.1768,82,72,71,10,1,36,3,male
77,37800,Asia,92,566,509.2999891,3692.336067,64.23076923,237161.5859,84,57,47,27,10,32,4,male
93,63300,South America,87,612,474.5420279,3943.081419,64.75510204,255334.6397,87,58,41,29,17,24,2,male
61,52800,Asia,87,721,473.9427998,4645.362261,71.91489362,334070.7328,77,63,61,14,2,32,2,female
888,162000,Europe,35,415,164.7548875,2128.652452,16,34058.43923,103,80,78,23,2,15,2,male
46,34100,Europe,77,458,405.6268983,2870.188236,49.72972973,142733.6852,81,62,55,19,7,31,2,male
62,37000,AsiaEurope,92,630,511.3291757,4109.844032,62.67857143,257599.1527,101,68,56,33,12,31,4,male
62,8700,Asia,112,780,654.1624644,5309.736839,81.52941176,432899.7211,63,44,39,19,5,33,5,male
61,36900,Asia,67,440,339.4387425,2669.079244,37.36764706,99737.21115,79,61,61,18,0,26,2,male
93,68100,Europe,64,453,320.1804545,2718,48.73333333,132457.2,122,88,64,34,24,31,2,male
108,98600,South America,54,599,261.1759501,3447.177614,70,241302.433,74,61,53,13,8,44,2,male
1699,4700,Asia,48,492,222.2653679,2747.80155,44.16666667,121361.2351,123,115,113,8,2,37,1,female
46,5500,Asia,66,500,333.6312234,3022.19706,61.87931034,187011.4698,81,75,71,6,4,37,1,male
187,53500,South America,80,634,426.6582949,4008.102412,73.11111111,293036.8208,97,76,63,21,13,33,4,male
139,103700,Asia,85,696,461.7177151,4460.936092,74.2,331001.458,75,65,63,10,2,39,2,male
202,85300,Asia,58,486,283.5668306,2846.978764,73.80434783,210119.4109,104,67,52,37,15,29,2,male
452,91100,South America,80,648,425.7903187,4096.609405,81.32926829,333174.2454,76,48,32,28,16,36,3,male
264,67300,Asia,66,602,333.1049912,3638.72526,67.74193548,246494.2918,91,85,85,6,0,47,3,male
124,107500,Asia,73,591,378.9461511,3658.186314,96.08571429,351499.445,97,79,73,18,6,31,2,male
171,146100,AsiaEurope,66,401,333.1049912,2423.802042,41.62857143,100899.4164,81,68,62,13,6,17,3,male
92,58500,Asia,70,487,359.0498112,2984.960829,70,208947.258,71,49,36,22,13,29,2,female
46,2100,Asia,75,502,392.6333688,3126.866983,77.17647059,241320.5577,76,68,66,8,2,20,2,male
108,82100,Asia,74,556,385.5385456,3452.456071,58.05555556,200434.2552,88,59,57,29,2,33,2,male
264,70400,Europe,55,451,265.2124025,2607.393231,82.57142857,215296.1839,81,61,52,20,9,35,2,male
77,68300,Asia,86,667,468.3101095,4286.318591,72.72,311701.088,88,70,61,18,9,41,3,male
124,81100,Asia,76,517,398.8804611,3230.178524,52.17567568,168536.7471,108,83,71,25,12,31,4,male
124,114900,Asia,40,473,191.1345461,2517.271989,21,52862.71177,116,54,7,62,47,39,2,male
109,77300,AsiaEurope,80,558,425.7903187,3527.635877,68.01219512,239922.2596,78,53,45,25,8,31,3,male
93,68100,Europe,57,448,277.6324012,2613.134726,54.09090909,141346.8329,79,67,61,12,6,30,2,male
108,50800,Europe,65,549,326.4650059,3306.279929,65.484375,216509.6747,89,80,76,9,4,30,2,male
77,26600,Asia,40,466,194.1173001,2480.018492,18,44640.33286,135,127,125,8,2,29,5,male
62,56300,AsiaEurope,80,522,426.079159,3300.046466,70.98837209,234264.9264,74,56,50,18,6,25,3,male
62,56300,AsiaEurope,80,522,426.079159,3300.046466,70.98837209,234264.9264,74,56,50,18,6,25,3,male
202,9700,Asia,71,534,365.8862514,3283.964962,59.87878788,196639.8413,79,62,60,17,2,33,1,male
109,114900,Asia,71,608,366.1306865,3739.046249,51.796875,193670.9112,90,69,69,21,0,35,3,male
77,68300,Asia,82,647,440.20115,4113.336147,75.91304348,312255.8658,69,49,38,20,11,34,2,male
171,6100,Asia,59,433,288.3819626,2547.18444,53.92592593,137359.2795,70,57,49,13,8,17,2,male
171,6100,Asia,59,433,288.3819626,2547.18444,53.92592593,137359.2795,71,57,48,14,9,17,2,male
62,37400,Asia,74,605,385.6555921,3756.719286,89.29487179,335455.767,81,69,69,12,0,36,4,male
78,56400,North America,71,500,365.8862514,3074.87356,74.27272727,228379.2453,86,58,39,28,19,30,2,male
77,53300,AsiaEurope,63,542,314.4992626,3239.685719,80.66666667,261334.648,87,63,46,24,17,38,2,male
78,70100,AsiaAfrica,64,463,320.7232379,2778,41.78571429,116080.7143,98,77,74,21,3,23,2,male
92,74000,Europe,68,499,346.1173001,3037.643958,70.875,215293.0155,76,63,58,13,5,25,2,female
77,40800,Asia,79,527,419.4466845,3322.092454,51.06976744,169658.4891,74,63,62,11,1,39,3,male
233,67000,Asia,53,495,251.6875812,2835.320625,59.88636364,169797.042,100,92,87,8,5,34,2,male
280,131800,Unknown,76,587,398.842491,3667.53345,51,187044.206,82,68,66,14,2,39,3,male
61,42700,Asia,76,563,399.1845378,3517.58319,45.24390244,159149.1907,60,48,48,12,0,34,3,male
217,36800,Asia,80,573,426.6582949,3622.464798,51.72222222,187361.9293,66,53,51,13,2,25,3,male
62,55500,Asia,71,605,365.7235111,3720.597007,82.16176471,305690.8159,84,68,68,16,0,32,2,female
77,39800,AsiaEurope,86,584,468.3101095,3752.938617,48.6,182392.8168,106,78,69,28,9,23,3,male
62,24200,AsiaAfrica,100,567,565.8041153,3767.06646,68.27192982,257184.897,73,46,34,27,12,28,4,male
93,8800,Asia,90,587,494.5555318,3810.717768,63,240075.2194,116,78,47,38,31,38,4,male
233,103600,Asia,36,378,168,1954.231651,20,39084.63301,90,61,43,29,18,32,2,male
78,40800,South America,86,589,466.9609738,3785.069941,66.7,252464.165,70,48,44,22,4,21,3,male
155,137500,Asia,38,523,180.9737366,2744.66609,17,46659.32352,110,88,83,22,5,45,2,male
62,33400,AsiaAfrica,75,517,392.2479866,3220.299263,86.66666667,279092.6028,66,57,57,9,0,32,3,male
124,86700,Asia,75,672,393.7950768,4185.76616,48.96590909,204959.8453,122,106,94,16,12,40,2,male
77,44700,North America,71,621,365.7235111,3818.992961,91.95588235,351178.8674,99,70,53,29,17,29,2,male
186,7800,Asia,56,503,271.0812322,2921.099526,35.54545455,103831.8104,100,91,91,9,0,16,2,male
62,36800,Asia,69,487,352.7497745,2974.85141,56.078125,166824.0893,102,59,42,43,17,27,2,male
77,53500,Asia,83,585,446.3456778,3729.398067,51.40909091,191724.9643,85,49,40,36,9,41,5,male
187,9700,Asia,88,620,480.5611817,4004.847604,52.5,210254.4992,115,87,81,28,6,32,3,male
77,74100,Asia,67,662,339.5249056,4015.751044,54.140625,217415.2714,65,57,57,8,0,54,5,male
46,40000,Asia,80,626,425.7542476,3957.526987,71,280984.4161,97,90,90,7,0,40,3,female
61,4900,Europe,72,480,372.8771238,2961.564001,46.875,138823.3125,76,71,69,5,2,28,1,male
92,71100,AsiaEurope,50,419,234.2907084,2364.775744,48.94736842,115749.5496,95,72,58,23,14,33,2,male
124,11800,Asia,64,689,320.1804545,4134,92.93333333,384186.4,104,95,94,9,1,43,3,male
62,5800,Asia,73,639,379.1044231,3955.297893,78,308513.2357,69,64,64,5,0,38,1,male
61,36900,Asia,68,559,347.0121354,3402.891728,32.27586207,109831.2641,107,92,90,15,2,39,3,female
92,71000,AsiaEurope,67,533,340.3026944,3233.225539,78.62068966,254198.4216,90,62,55,28,7,34,3,male
171,5800,AsiaEurope,52,415,244.6450378,2365.682483,73.5,173877.6625,79,68,65,11,3,25,1,male
62,9500,South America,89,717,488.714938,4643.10087,86.80392157,403039.3638,67,51,51,16,0,37,4,male
202,115200,Asia,68,566,346.3298602,3445.503968,96.08064516,331046.2442,119,88,61,31,27,30,4,male
124,98900,Asia,66,519,333.1049912,3137.040548,70.85714286,222281.7303,75,66,62,9,4,23,2,male
46,37800,Europe,77,458,405.6268983,2870.188236,49.72972973,142733.6852,81,62,55,19,7,31,2,male
62,52500,Asia,67,609,339.4387425,3694.248317,59.24242424,218856.2261,107,79,77,28,2,40,3,male
77,30400,Europe,61,521,301.7363383,3089.914153,57.88461538,178858.4923,69,60,59,9,1,36,1,male
155,146100,Asia,63,568,314.1308434,3395.094997,60.625,205827.6342,86,64,61,22,3,29,2,male
421,86900,Europe,57,543,275.5886804,3167.259278,76.66666667,242823.2113,67,55,48,12,7,40,3,male
62,54400,Europe,83,683,447.1829761,4354.151932,82.72340426,360190.2704,102,83,76,19,7,36,2,male
61,40800,North America,71,501,366.1306865,3081.023307,84.09375,259094.8037,105,71,51,34,20,27,3,male
93,75000,Asia,60,533,295.6213103,3148.372687,32.9,103581.4614,89,56,46,33,10,26,2,female
61,9600,Asia,77,678,405.6268983,4248.881275,104.3243243,443261.6681,82,66,60,16,6,30,3,male
62,53300,Asia,73,439,379.1044231,2717.332981,32.69230769,88835.88593,100,74,57,26,17,34,3,male
61,56700,Asia,74,586,385.5385456,3638.739672,61.22222222,222771.7288,93,80,79,13,1,34,2,female
343,68200,Europe,60,631,295.6213103,3727.247966,114.8,427888.0665,114,86,63,28,23,44,3,male
108,97800,Asia,62,547,308.8461793,3256.945382,57.72,187990.8874,101,85,80,16,5,42,3,male
187,13600,Asia,71,598,366.4572094,3677.548777,81.93548387,301321.7385,131,121,117,10,4,35,4,male
77,36900,Africa,70,637,359.0910367,3904.353282,84.05555556,328182.5842,107,93,93,14,0,35,2,male
46,37300,AsiaEurope,67,416,339.4387425,2523.493103,27.81818182,70198.98996,87,67,60,20,7,27,2,female
140,130100,Asia,64,539,320.7232379,3234,50.78571429,164241,111,95,88,16,7,41,2,male
108,99900,Asia,78,527,412.5946318,3312.406969,70.28571429,232814.8898,82,65,56,17,9,31,3,male
77,36900,Asia,78,527,412.5946318,3312.406969,70.28571429,232814.8898,82,65,56,17,9,31,3,male
873,157700,Asia,62,461,307.3464548,2744.884499,62.5862069,171791.9092,87,72,66,15,6,30,2,male
77,38000,Asia,0,0,0,0,0,0,68,52,49,16,3,28,2,male
62,38000,Asia,0,0,0,0,0,0,68,52,49,16,3,28,2,male
202,2200,Asia,36,355,171.2198934,1835.323376,16.5,30282.8357,110,82,57,28,25,32,1,male
93,83700,Asia,37,420,181.5249056,2187.970414,17.5,38289.48224,91,70,69,21,1,35,2,male
249,68000,Europe,62,661,307.3464548,3935.723761,105.2586207,414268.8545,140,110,85,30,25,45,2,male
62,36900,Asia,89,681,488.323496,4409.974466,65.91,290661.4171,125,107,100,18,7,38,3,male
62,36900,Asia,78,527,412.5946318,3312.406969,70.28571429,232814.8898,82,65,56,17,9,31,3,male
46,4600,Europe,59,424,288.6764386,2494.240653,86.94230769,216855.0383,79,63,51,16,12,36,1,female
234,83700,Asia,37,417,181.5249056,2172.342053,17.5,38015.98594,91,69,68,22,1,35,2,male
327,82200,Asia,77,515,405.7769322,3227.395068,41.26829268,133189.0843,96,64,54,32,10,29,3,male
186,36800,Asia,0,0,0,0,0,0,127,82,61,45,21,20,2,male
62,8800,Asia,94,647,524.6331211,4240.818987,65.48214286,277697.9147,72,59,54,13,5,28,1,male
156,5700,Asia,73,632,378.9461511,3911.969121,75.98684211,297258.1799,73,65,65,8,0,32,1,male
61,37900,Europe,87,592,474.5420279,3814.22255,48.08163265,183394.0475,107,64,49,43,15,15,6,male
93,69000,Asia,66,516,333.3240179,3118.907366,76.8,239532.0857,72,50,39,22,11,24,3,male
109,61300,North America,79,735,419.0808777,4633.27885,99.17073171,459485.6537,70,52,46,18,6,38,2,male
93,71100,Asia,0,0,0,0,0,0,91,54,45,37,9,15,2,female
93,80400,Asia,85,574,460.2145365,3678.990397,66.97826087,246412.3786,101,85,83,16,2,31,4,female
109,118200,Asia,88,469,483.1046897,3029.473429,32.35849057,98029.18738,80,60,58,20,2,10,3,male
93,68000,Asia,56,452,271.0812322,2624.924425,59.5,156183.0033,97,86,82,11,4,30,2,male
124,96800,Asia,73,559,378.9461511,3460.111928,76.54285714,264846.853,100,78,66,22,12,31,2,male
124,13300,Asia,88,810,481.614055,5232.139611,92.34,483135.7717,69,59,59,10,0,46,3,male
77,37200,Asia,71,578,365.7235111,3554.553835,51.69117647,183739.0696,127,95,86,32,9,29,2,male
92,46300,AsiaAfrica,74,593,386.1246381,3682.205846,72.03658537,265253.5357,75,62,62,13,0,31,4,male
93,67100,Asia,71,542,366.1306865,3333.162939,87.75,292485.0479,91,76,74,15,2,33,2,male
249,72600,Europe,50,617,235.05865,3482.259269,125.3333333,436443.1617,141,90,60,51,30,42,6,male
249,71100,Asia,52,427,245.3142135,2434.08776,49.09090909,119491.5809,85,75,75,10,0,35,2,male
124,68100,Europe,54,555,258.1074956,3193.962564,106.1818182,339140.7522,72,62,58,10,4,35,2,male
109,99400,AsiaEurope,62,613,308.8461793,3649.922338,95.46,348421.5864,81,61,57,20,4,38,2,male
46,37800,Asia,84,630,453.092115,4027.159976,62.72727273,252612.7622,113,88,81,25,7,39,4,male
62,17800,Europe,65,513,326.7316235,3089.474688,81.08333333,250504.906,82,74,72,8,2,29,1,male
140,82200,Europe,89,606,487.4132344,3924.294459,39.26086957,154071.2129,79,54,46,25,8,26,5,male
326,84600,Asia,71,507,366.1306865,3117.92179,34.734375,108299.0647,108,86,86,22,0,28,3,male
77,46400,Asia,82,559,439.6362367,3553.871571,60.88636364,216382.3168,89,72,68,17,4,22,3,male
77,46800,Asia,70,558,359.2147805,3420.139923,46.53030303,159140.147,93,58,50,35,8,18,3,male
92,36800,Europe,84,525,454.1955001,3355.966647,64.875,217718.3362,75,52,42,23,10,26,2,female
140,103000,AsiaAfrica,76,634,398.9944238,3961.186044,80.55,319073.5358,101,87,81,14,6,37,2,male
187,115000,Asia,44,516,208.0542306,2817.066715,19.44444444,54776.29724,102,82,81,20,1,25,3,male
108,76000,Asia,44,499,217.740327,2724.256378,23.4,63747.59924,135,110,109,25,1,29,2,male
61,37500,AsiaEurope,81,643,433.6087556,4076.523552,78.36956522,319475.3784,91,74,67,17,7,25,2,male
109,56500,South America,76,695,399.4510684,4342.309622,63,273565.5062,72,42,29,30,13,31,6,male
186,37800,Asia,70,480,359.0910367,2942.055848,32.58333333,95861.98639,69,54,49,15,5,34,3,male
108,71200,South America,91,698,501.8524417,4542.440659,82.82,376204.9354,82,55,47,27,8,30,3,male
61,5800,AsiaEurope,76,550,398.842491,3436.360132,66.5,228517.9488,71,52,46,19,6,33,1,male
62,42800,Europe,78,578,414.08385,3632.962483,62.60869565,227455.0424,86,72,64,14,8,33,2,male
93,74900,Asia,65,499,326.4650059,3005.161539,55.75757576,167560.5222,72,47,45,25,2,33,2,male
264,53400,South America,75,515,392.6333688,3207.841626,44.36585366,142318.6321,85,65,53,20,12,33,2,male
62,41100,North America,72,513,372.8771238,3165.171526,85,269039.5797,106,72,51,34,21,27,3,male
62,19400,Asia,65,513,326.7316235,3089.474688,81.08333333,250504.906,82,74,72,8,2,29,1,male
77,46400,Asia,72,560,372.2746801,3455.158001,44.92857143,155235.313,93,58,51,35,7,18,3,male
109,74000,Asia,66,527,334.5126491,3185.395701,73.66666667,234657.4833,114,79,57,35,22,26,3,male
78,38000,Asia,0,0,0,0,0,0,68,52,49,16,3,28,2,male
77,67200,Asia,61,598,304.2381821,3546.580928,57.61363636,204331.4239,115,102,101,13,1,42,4,male
436,55500,Asia,78,634,412.4094067,3984.945007,34.74390244,138452.5405,97,71,67,26,4,29,6,male
233,36800,Europe,89,610,488.323496,3950.197393,72.54,286547.3189,67,50,40,17,10,28,2,male
109,68700,AsiaEurope,62,513,308.3287327,3054.502707,76.84615385,234726.785,77,66,62,11,4,22,2,male
186,33200,Asia,94,731,525.2245053,4791.404451,70.10526316,335902.6699,86,65,62,21,3,39,3,male
93,66600,Unknown,75,516,392.17102,3214.070444,62.80263158,201852.082,77,70,70,7,0,30,2,male
109,40100,AsiaEurope,100,667,567.9056641,4431.452079,47.63114754,211075.1478,107,59,27,48,32,34,4,male
93,67100,Asia,65,588,328.3421192,3541.152274,67.5,239027.7785,73,61,57,12,4,40,5,male
108,69100,North America,110,747,637.6343112,5065.675706,101.0873016,512075.4878,115,78,59,37,19,43,8,male
249,68000,Asia,59,503,288.6764386,2958.969454,60.92307692,180269.5236,78,64,64,14,0,35,2,male
124,74000,Asia,85,575,459.8067162,3685.399788,56.82142857,209409.6808,106,84,80,22,4,26,3,male
249,201900,Asia,56,621,272.5558619,3606.367407,91.8,331064.5279,74,57,55,17,2,39,3,male
93,68100,Asia,81,581,432.536756,3683.452852,55.12195122,203039.1084,126,85,56,41,29,36,2,male
171,5800,Asia,82,688,440.5905816,4373.995779,78.19148936,342009.2444,80,66,62,14,4,28,1,male
108,87600,AsiaEurope,61,629,305.1157897,3730.433785,130.4761905,486732.7891,106,80,66,26,14,38,3,male
92,69000,Asia,91,607,502.1708162,3950.231347,58.03921569,229268.3291,78,49,45,29,4,28,3,male
77,39800,Europe,75,554,392.17102,3450.765555,87.63157895,302396.0341,92,61,40,31,21,35,3,male
202,94800,Asia,59,774,288.6764386,4553.16572,129.4615385,589459.839,119,75,33,44,42,44,6,male
61,57400,Asia,98,780,556.0935408,5159.473678,63.88888889,329633.0406,97,66,50,31,16,40,2,male
77,67800,Asia,50,418,235.05865,2359.131887,27.55555556,65007.18978,97,82,79,15,3,27,2,male
62,40000,North America,69,525,352.7497745,3206.97534,57.51351351,184444.4195,84,72,65,12,7,36,4,male
108,82300,Europe,64,483,320.7232379,2898,55.92857143,162081,79,68,62,11,6,36,2,female
187,36900,Europe,86,622,467.1963626,3997.136677,88.37234043,353236.3232,109,75,53,34,22,33,5,male
171,48500,AsiaEurope,78,607,412.4094067,3815.239147,64.07317073,244454.4692,89,72,66,17,6,37,3,male
77,59400,Asia,76,680,399.1845378,4248.590709,83.23170732,353617.4584,89,79,79,10,0,40,2,female
62,5800,Asia,82,625,440.20115,3973.470003,66.91304348,265876.9711,78,59,54,19,5,33,3,male
187,180700,Asia,63,644,316.1697866,3849.368271,26,100083.575,99,74,74,25,0,44,2,male
124,99900,Asia,75,597,392.2479866,3718.604758,73.84615385,274604.6591,111,79,70,32,9,33,5,male
109,108400,AsiaEurope,76,541,398.9944238,3380.128785,67.05,226637.635,81,64,57,17,7,27,2,male
218,4600,Europe,51,419,239.4453837,2376.746218,50,118837.3109,83,72,65,11,7,34,1,male
156,200100,Asia,55,473,270.1306865,2734.583144,29.25,79986.55698,72,59,54,13,5,37,3,male
421,51900,Asia,75,547,392.17102,3407.163824,52.09210526,177486.3366,84,63,63,21,0,34,2,male
46,5600,Asia,48,450,234.6600115,2513.233125,36.83333333,92570.75345,137,112,104,25,8,35,2,male
139,40900,Asia,75,543,392.17102,3382.248549,74.97297297,253577.229,88,67,54,21,13,30,3,male
77,55600,South America,82,586,440.20115,3725.525475,42.65217391,158901.7605,88,60,53,28,7,28,2,male
124,108100,Asia,41,449,208.1306865,2405.54085,19.5,46908.04658,133,114,110,19,4,39,3,male
93,72400,North America,74,532,385.8508604,3303.429191,84.11764706,277876.6907,107,74,53,33,21,27,3,male
61,37800,Asia,81,660,433.2506894,4184.301002,74,309638.2741,88,69,64,19,5,28,3,male
108,136500,Asia,51,511,244.720659,2898.60935,34.8,100871.6054,128,91,75,37,16,46,2,male
217,121600,North America,64,543,320.4063545,3258,59.74137931,194637.4138,101,76,69,25,7,41,4,male
77,38800,Asia,77,547,405.551932,3427.932238,39.94871795,136941.4981,83,63,63,20,0,24,2,male
62,18000,Asia,91,610,501.2172393,3969.754731,76.79347826,304851.2736,84,65,58,19,7,33,6,female
61,37000,Asia,87,591,474.2088866,3807.779606,75.15625,286178.436,89,67,55,22,12,31,3,male
93,68100,Asia,37,452,177.7286241,2354.672921,17,40029.43966,87,57,56,30,1,27,2,male
93,72100,South America,94,893,527.3871723,5853.247845,112.2,656734.4082,67,43,34,24,9,37,3,male
561,154800,Asia,42,495,214.8771238,2669.197124,20,53383.94249,117,95,88,22,7,36,2,male
248,71100,Asia,58,636,281.9620482,3725.675913,49.94444444,186076.8136,147,135,132,12,3,49,3,male
764,107400,Asia,60,503,294.4615345,2971.16597,40.0862069,119102.7738,99,83,75,16,8,26,2,male
405,39000,Europe,64,456,320,2736,33,90288,88,65,60,23,5,17,3,male
77,68000,Asia,57,643,275.7915183,3750.548279,67.96153846,254893.0311,136,127,127,9,0,40,2,male
62,51600,Asia,87,628,473.9427998,4046.168515,70.21276596,284092.683,85,63,61,22,2,30,3,male
233,64400,Asia,66,524,334.5126491,3167.262519,37.55555556,118948.3035,104,64,49,40,15,29,4,male
62,5700,Asia,72,583,372.2746801,3597.066276,30.74324324,110585.4835,74,53,42,21,11,21,1,male
140,11300,Unknown,82,640,439.3192644,4068.833283,51,207510.4974,122,92,84,30,8,32,2,male
108,82000,Asia,85,636,461.7177151,4076.372635,66.5,271078.7803,98,81,75,17,6,39,3,male
171,5600,Asia,62,393,307.3464548,2339.99915,25.03448276,58580.66838,108,67,43,41,24,20,1,female
124,115500,Asia,80,691,425.7903187,4368.452314,103.5512821,452358.8376,95,92,91,3,1,41,1,male
93,83300,Europe,65,492,326.5538222,2963.004964,60.87096774,180360.9796,83,59,48,24,11,23,2,male
78,70100,Asia,77,688,405.551932,4311.54914,62.09210526,267713.163,138,109,97,29,12,43,2,male
46,5600,Asia,69,611,353.0013311,3732.308443,98.67741935,368294.5654,127,95,67,32,28,31,4,male
124,99400,Europe,41,482,204.176133,2582.340066,19,49064.46126,86,61,52,25,9,28,2,male
109,67000,AsiaEurope,62,524,307.3464548,3119.998867,81.36206897,253849.563,83,67,62,16,5,27,2,male
77,68000,Asia,60,455,296.7916995,2687.635221,95.7173913,257253.4321,88,78,71,10,7,24,2,male
109,102200,Asia,55,597,265.9634675,3451.471749,54.25,187242.3424,100,75,69,25,6,43,2,female
249,52600,Asia,72,526,372.2746801,3245.380551,63.85135135,207221.9338,80,67,63,13,4,26,3,male
62,53400,Asia,77,603,406.3031211,3778.872284,66.02325581,249493.4515,104,58,43,46,15,34,4,male
62,71000,Asia,58,516,286.8413093,3022.718193,33.86842105,102374.6925,100,65,55,35,10,19,4,male
187,37800,Europe,78,678,412.2613731,4261.502704,54.5,232251.8974,128,87,74,41,13,19,3,male
124,101100,AsiaEurope,82,667,439.8831639,4240.487187,83.04444444,352148.9026,101,70,59,31,11,32,3,male
61,37800,AsiaEurope,91,597,501.8524417,3885.1534,53.3,207078.6762,107,61,40,46,21,21,3,male
93,103500,Asia,82,561,440.5905816,3566.586675,67.76595745,241693.1608,84,62,52,22,10,18,4,male
93,91900,AsiaEurope,79,644,419.0078103,4059.634802,90.76923077,368489.9282,103,75,66,28,9,39,3,male
46,4100,North America,82,456,439.460071,2899.043714,53.05813953,153817.8659,78,62,58,16,4,17,2,male
78,55400,North America,76,614,399.7943904,3836.227493,49.51515152,189951.3856,103,69,58,34,11,31,4,male
93,58400,Asia,85,762,460.2145365,4883.955893,114.4565217,559000.6039,101,80,72,21,8,38,3,male
62,39800,South America,75,530,392.2479866,3301.273906,56.30769231,185887.1153,81,66,59,15,7,34,2,male
46,5800,Asia,84,580,453.2640759,3707.544105,48.96666667,181546.0764,83,70,70,13,0,37,2,male
46,6600,Europe,73,533,379.1044231,3299.17649,69.97058824,230845.3197,85,56,40,29,16,30,2,female
46,4800,Asia,63,456,314.1308434,2725.639645,55,149910.1805,92,85,83,7,2,25,1,male
155,53700,Europe,78,621,412.85429,3903.234778,47.20930233,184268.9907,76,68,68,8,0,37,2,male
77,37800,North America,68,510,346.1173001,3104.606049,75.375,234009.6809,77,61,55,16,6,23,3,male
155,86400,South America,78,616,412.85429,3871.807767,55.75581395,215875.7935,115,84,72,31,12,28,2,male
46,5800,Asia,84,627,452.9890166,4007.983024,38.2804878,153427.5453,95,69,68,26,1,27,1,male
46,8500,Asia,71,591,366.4572094,3634.500548,83.87096774,304829.0782,86,79,78,7,1,41,5,male
140,133300,AsiaEurope,80,709,426.079159,4482.247019,87.3372093,391466.9461,65,59,59,6,0,39,2,male
46,5800,Asia,59,569,292.5692484,3347.223895,67.275,225184.4875,111,96,93,15,3,38,3,male
514,99400,AsiaEurope,73,676,379.3421297,4184.321402,84.24242424,352497.3787,85,79,76,6,3,37,2,male
155,98300,Asia,73,732,378.8670746,4530.951577,104.8333333,474994.757,81,70,65,11,5,39,3,female
186,11700,Asia,75,542,392.6333688,3376.01973,60.95121951,205772.5197,68,53,51,15,2,31,1,male
108,101500,Asia,68,480,346.1173001,2921.982164,52.3125,152856.1919,95,64,51,31,13,32,2,male
46,8800,Africa,79,592,419.4466845,3731.838203,64.88372093,242135.5485,87,68,65,19,3,29,1,male
46,36000,South America,74,536,385.8508604,3328.267004,58.225,193788.3463,110,74,46,36,28,26,2,male
46,51700,Unknown,84,581,453.5050955,3713.936423,69.39130435,257714.8926,91,71,68,20,3,39,2,male
93,69100,Asia,68,644,346.3298602,3920.32607,71.01612903,278406.382,116,89,84,27,5,39,3,male
124,59500,Asia,81,689,432.6080183,4368.156652,77.53571429,338688.1461,82,62,57,20,5,38,4,male
93,68100,Europe,73,658,380.5361023,4072.90456,108.9333333,443675.07,96,76,66,20,10,33,3,male
46,6200,AsiaEurope,73,615,379.1044231,3806.742104,104.3823529,397356.6978,94,88,84,6,4,23,1,male
217,69100,Asia,66,537,333.6312234,3245.839642,58.05172414,188426.5875,97,82,77,15,5,39,2,male
93,67100,Asia,68,597,347.0121354,3634.215316,55.81034483,202826.81,78,65,60,13,5,44,5,male
62,36800,Asia,77,529,405.551932,3315.13008,38.48717949,127590.0064,110,72,66,38,6,23,3,male
62,36800,Asia,77,529,405.551932,3315.13008,38.48717949,127590.0064,110,72,66,38,6,23,3,male
186,42800,Asia,71,440,365.6422056,2705.888733,24.30555556,65768.12892,107,99,98,8,1,33,2,male
77,68200,Asia,69,696,352.7497745,4251.533022,111,471920.1654,125,98,91,27,7,38,2,female
77,36800,Asia,77,533,405.551932,3340.197226,38.48717949,128554.7702,110,72,66,38,6,23,3,male
92,81800,Antarctica,55,465,266.8279228,2688.332267,25.57894737,68764.70956,100,84,79,16,5,31,2,male
124,86600,Asia,69,724,353.0013311,4422.571707,120.7419355,533989.8677,105,84,70,21,14,48,2,male
93,67200,AsiaEurope,61,507,302.7888745,3006.88383,73.22916667,220191.5971,106,88,80,18,8,34,2,male
202,53400,Asia,94,622,525.8801978,4076.954266,67.03448276,273296.5204,90,66,49,24,17,34,6,male
139,115900,Africa,75,523,392.2479866,3257.672175,56.30769231,183432.0025,110,79,59,31,20,33,3,male
61,36900,Asia,74,664,385.6555921,4123.077035,84.80769231,349668.6485,90,71,64,19,7,37,2,male
46,6600,Asia,82,596,440.20115,3789.100995,68.47826087,259471.0464,73,65,65,8,0,36,2,male
61,37800,Unknown,78,685,412.5946318,4305.50052,88.71428571,381959.4033,101,71,60,30,11,40,4,male
124,87200,Asia,56,542,275.6175548,3147.586368,28.67647059,90261.6679,93,59,48,34,11,33,10,male
46,9900,AsiaEurope,80,651,426.079159,4115.57519,74,304552.564,85,77,77,8,0,45,3,male
139,131200,Europe,76,583,398.9944238,3642.54174,51.66666667,188197.9899,96,60,53,36,7,29,3,male
140,55700,Europe,83,578,446.2065082,3684.772791,44.18604651,162815.5419,104,66,50,38,16,25,3,male
296,102800,Asia,63,603,313.5800856,3604.299794,62.96774194,226954.6193,85,60,44,25,16,40,2,male
124,101500,Asia,60,803,294.8469685,4743.233148,94.11111111,446390.9418,135,96,61,39,35,43,2,male
140,83700,AsiaEurope,75,565,392.4020294,3519.28256,46.85714286,164903.5257,89,66,58,23,8,27,4,male
77,67900,Asia,75,536,393.3293845,3338.646818,77.265625,257962.6331,95,55,34,40,21,29,4,male
93,40800,Asia,50,511,244.1844343,2884.010513,33.68181818,97138.71773,112,83,81,29,2,21,3,male
249,83000,Asia,59,669,289.0701413,3935.4882,70.72,278317.7255,135,101,76,34,25,47,2,male
77,68100,Asia,71,454,365.7235111,2791.985192,33.73529412,94188.44163,82,47,40,35,7,13,2,male
124,100200,Unknown,70,649,360.0838417,3977.904678,66,262541.7087,113,88,88,25,0,36,3,male
483,132800,AsiaEurope,64,499,321.6326782,2994,71.61538462,214416.4615,88,78,74,10,4,28,2,male
202,53500,Asia,99,682,558.5412601,4521.221215,65.65178571,296826.2464,82,52,48,30,4,33,4,male
124,91300,Europe,61,525,301.0709438,3113.637102,53.03571429,165133.9677,106,89,82,17,7,31,4,male
1559,215900,Asia,34,536,155.2067179,2726.880083,15,40903.20124,133,123,121,10,2,33,2,male
46,37000,Asia,80,582,427.0575866,3679.362151,55.43478261,203964.641,87,72,66,15,6,32,3,female
46,13500,Asia,81,600,433.6087556,3803.910002,67.7173913,257590.8621,94,75,69,19,6,28,2,male
77,68100,Asia,80,644,425.7542476,4071.321693,58,236136.6582,70,48,47,22,1,38,2,female
92,68100,Asia,80,644,425.7542476,4071.321693,58,236136.6582,70,48,47,22,1,38,2,female
140,12500,Europe,75,708,392.4020294,4410.003633,84.4375,372369.6818,133,99,82,34,17,32,5,male
187,38000,Europe,72,492,372.5956925,3035.603101,26.65384615,80910.49803,90,84,84,6,0,30,2,female
108,68100,Asia,74,584,388.0148382,3626.320766,36.46551724,132235.6624,67,37,34,30,3,21,5,male
77,68300,Asia,67,597,340.7366244,3621.455247,45.96428571,166457.6037,74,59,53,15,6,44,3,female
124,107200,Asia,36,491,174.9737366,2538.433176,17,43153.36399,137,117,117,20,0,38,2,male
1013,52900,Asia,56,633,271.7635715,3676.055666,64.16666667,235880.2385,110,103,103,7,0,45,1,male
61,8800,Asia,91,727,501.4075845,4731.166703,56.88541667,269134.3892,138,115,108,23,7,42,5,male
46,6600,Asia,83,606,447.1829761,3863.273895,68.17021277,263360.2034,74,66,66,8,0,37,2,male
249,67700,Asia,76,688,398.8804611,4298.574129,92.02564103,395579.0397,113,95,88,18,7,37,5,female
92,69100,Asia,68,676,346.3298602,4115.124881,122.3387097,503439.0681,113,96,91,17,5,45,3,female
61,22200,AsiaAfrica,84,676,453.5050955,4321.206578,90.04347826,389096.4705,79,68,68,11,0,35,3,male
77,12700,AsiaEurope,81,682,433.2506894,4323.777702,60.8,262885.6843,108,80,71,28,9,40,5,male
202,71900,Asia,61,484,302.2137048,2870.476871,69.84,200474.1047,103,78,58,25,20,33,2,male
77,68100,Asia,58,449,283.0128366,2630.233467,41.08333333,108058.7583,110,82,62,28,20,34,2,male
46,8800,Asia,94,718,522.2541717,4706.194796,52.80612245,248515.8986,88,70,70,18,0,37,10,male
264,74100,Europe,62,506,307.3464548,3012.823333,82.5,248557.925,93,80,76,13,4,37,2,male
77,36800,Europe,75,528,392.9423377,3288.816269,65.21428571,214477.8038,104,79,63,25,16,26,3,male
186,36800,Asia,65,532,326.4650059,3203.899677,65.484375,209805.3679,87,78,76,9,2,36,2,male
202,5800,Asia,65,507,328.3421192,3053.340481,33,100760.2359,84,64,61,20,3,33,2,male
124,99600,Asia,74,555,385.6555921,3446.246618,35.44871795,122165.0243,119,97,92,22,5,20,3,male
124,103900,Asia,81,624,432.75063,3956.066402,82.03947368,324553.6055,92,77,72,15,5,42,3,male
92,71100,Europe,73,556,378.9461511,3441.542455,66.77142857,229796.7062,99,90,88,9,2,36,3,male
61,35900,Europe,76,588,400.713475,3673.781378,69.92222222,256878.9579,84,70,63,14,7,33,2,male
187,40800,Asia,72,437,372.2346001,2696.257226,45,121331.5752,100,80,71,20,9,30,2,female
77,68600,Asia,65,443,326.9987489,2667.908941,52.75862069,140755.1959,110,90,90,20,0,15,4,male
218,87600,Asia,75,733,392.9423377,4565.7241,53.42857143,243940.1162,111,95,94,16,1,44,2,male
124,98100,Asia,67,494,339.6973857,2996.64806,73.74193548,220978.6279,91,78,74,13,4,35,2,male
264,150300,AsiaEurope,55,665,265.2124025,3844.604209,116.5714286,448171.005,110,89,81,21,8,39,2,male
77,56700,Asia,75,629,392.2479866,3917.926956,60.125,235565.3582,76,39,33,37,6,27,3,male
78,17800,Europe,75,664,392.4020294,4135.93561,102.8571429,425410.5199,91,74,62,17,12,29,2,male
140,9000,Asia,68,589,347.0121354,3585.515613,94.81034483,339943.9717,97,83,77,14,6,24,1,male
77,35900,AsiaAfrica,76,575,399.4510684,3592.55832,42.9047619,154137.8594,100,64,63,36,1,34,4,male
46,5800,Asia,80,526,426.3322913,3325.334178,42.95454545,142838.2181,95,70,70,25,0,28,2,female
109,84600,Asia,77,612,406.3031211,3835.273363,38.57352941,147940.0299,107,61,42,46,19,27,2,male
77,83500,Asia,54,437,257.6220106,2514.885838,76.82608696,193208.8381,97,72,52,25,20,27,2,male
93,76000,Asia,81,520,432.6080183,3296.722002,49.21428571,162245.8185,104,83,76,21,7,30,2,male
249,69100,Asia,90,664,494.5555318,4310.590456,61.25,264023.6654,93,66,66,27,0,38,4,female
93,68100,AsiaAfrica,55,445,268.9081138,2572.705073,22.35294118,57507.52515,91,51,37,40,14,23,3,male
61,46500,North America,80,675,426.079159,4267.301464,83.03488372,354334.8809,115,68,42,47,26,34,3,male
46,5800,Asia,80,772,426.079159,4880.528489,91.63953488,447249.3607,111,93,83,18,10,43,3,male
46,5400,Europe,85,681,461.2380824,4364.795228,71.26530612,311058.4681,83,66,58,17,8,37,2,male
155,67800,Asia,61,586,304.2381821,3475.41208,82.43181818,286484.5367,123,87,67,36,20,26,4,male
108,100600,Asia,78,400,412.2613731,2514.160888,34.5,86738.55062,84,51,47,33,4,18,3,male
93,100800,Asia,83,572,447.6031056,3646.522555,60.88541667,222020.0451,83,62,51,21,11,28,2,male
374,117500,Asia,67,674,339.6973857,4088.544114,70.25806452,287253.1962,133,88,66,45,22,34,6,male
46,18000,Europe,67,569,339.4387425,3451.604749,41.25,142378.6959,85,70,66,15,4,34,1,female
140,111300,South America,49,430,239.3499675,2414.325233,52.65,127114.2235,101,69,56,32,13,17,2,male
140,99900,North America,71,521,365.7235111,3204.018249,66.92647059,214433.6331,85,53,50,32,3,34,2,male
78,68100,Asia,66,505,333.6312234,3052.41903,94.4137931,288190.4588,89,64,47,25,17,30,3,male
218,7900,Asia,57,435,275.5886804,2537.307156,35,88805.75047,87,80,75,7,5,28,1,male
1279,5800,South America,69,775,352.7497745,4734.106454,57.234375,270953.6241,95,73,71,22,2,38,1,male
108,83700,AsiaEurope,61,578,300.8814489,3427.966181,81.10344828,278019.8779,86,73,68,13,5,41,3,male
77,69100,Europe,51,603,240.7106228,3420.472481,22.73684211,77770.74273,87,82,82,5,0,47,2,male
109,71100,Asia,71,611,366.4572094,3757.49549,55.48387097,208480.3949,80,68,65,12,3,44,5,male
62,4100,South America,71,648,365.8862514,3985.036133,82.33333333,328101.3083,127,87,65,40,22,28,3,male
93,68400,Asia,65,546,328.9735285,3288.212826,55.2,181509.348,131,107,106,24,1,35,4,male
374,110200,AsiaEurope,60,603,302.8162528,3561.855029,137.8529412,491012.1918,121,83,67,38,16,36,6,male
93,72000,North America,62,537,307.9068682,3197.403419,94.62962963,302569.1013,95,71,62,24,9,33,3,male
77,52500,Europe,78,558,412.5946318,3507.254438,62.57142857,219453.9206,99,73,67,26,6,32,3,male
108,91500,Asia,75,540,392.2479866,3363.562093,48.20833333,162151.7226,124,88,70,36,18,35,4,male
93,12600,Asia,75,600,392.6333688,3737.291214,41.60294118,155482.3065,81,33,29,48,4,17,2,male
77,37800,Asia,64,649,321.1317371,3894,58.92592593,229457.5556,171,144,128,27,16,41,2,male
202,73700,Asia,59,729,290.159225,4288.446783,82.17391304,352398.453,143,124,124,19,0,46,2,male
202,73500,Europe,73,748,378.8670746,4629.98877,106.0540541,491029.0793,111,87,72,24,15,44,3,male
171,145600,AsiaEurope,54,552,258.7036718,3176.697901,87.21428571,277053.4384,87,75,71,12,4,34,2,male
280,74000,Europe,46,440,211.2067179,2430.367261,25.3125,61518.67129,123,105,96,18,9,36,2,male
265,75400,South America,79,659,419.0808777,4154.191513,77.68421053,322715.0881,126,88,70,38,18,34,2,male
77,76900,Asia,70,870,359.4212455,5332.476225,112.4210526,599482.5903,120,82,57,38,25,51,2,male
62,23100,Asia,57,513,277.0156616,2992.272577,74.65217391,223379.6528,77,62,61,15,1,39,2,male
77,21600,North America,70,698,359.4212455,4278.239546,97.375,416593.5758,132,82,44,50,38,34,5,female
264,80000,Asia,50,493,238.1282645,2782.421102,25.66666667,71415.47494,116,81,75,35,6,26,3,male
93,68100,Asia,70,532,360.0838417,3260.778565,35.33333333,115214.176,86,50,36,36,14,28,3,male
46,36000,Asia,94,643,522.16205,4214.600632,52.22916667,220125.0788,106,82,77,24,5,28,4,male
140,78200,Asia,87,760,474.2088866,4896.637057,96.28125,471454.3366,131,83,61,48,22,38,4,male
187,63600,Asia,63,513,314.1308434,3066.344601,43.125,132236.1109,112,93,83,19,10,43,3,male
77,36800,AsiaEurope,86,626,466.9609738,4022.841736,69.13043478,278100.7983,128,71,47,57,24,30,2,male
62,35900,North America,44,111,196.8070275,605.9969097,19.73684211,11960.46532,118,89,71,29,18,37,4,male
62,9200,South America,83,743,446.1369639,4736.654297,85.9047619,406901.1597,116,73,49,43,24,31,3,male
733,165300,AsiaEurope,78,909,412.5946318,5713.430617,86.14285714,492171.2374,71,60,60,11,0,58,3,male
62,67500,Asia,57,519,277.6324012,3027.269917,97.84090909,296190.8408,108,93,86,15,7,33,2,male
171,56500,Asia,74,539,385.6555921,3346.895364,48.91025641,163697.5104,105,96,94,9,2,30,2,male
155,114700,Asia,105,768,603.0459669,5156.540558,80.33333333,414242.0915,62,46,44,16,2,30,4,male
77,68100,Asia,91,670,503.0010296,4360.222409,58.79245283,256348.1703,90,60,51,30,9,34,3,male
77,70100,North America,77,616,405.6268983,3860.340509,55.9625,216034.3057,110,76,67,34,9,27,3,male
77,67700,Asia,58,610,290.4773318,3573.368407,56.4375,201671.9795,103,52,26,51,26,28,7,female
155,122800,Asia,57,515,276.504106,3003.938357,66.6875,200325.1392,87,73,65,14,8,29,2,male
108,36900,Europe,84,681,453.5050955,4353.168165,53.69565217,233746.2036,135,108,101,27,7,44,3,male
62,52500,Asia,85,666,460.4869215,4268.654363,51.34042553,219154.5315,134,88,66,46,22,30,2,male
93,68900,Asia,56,472,273.4603973,2741.071523,60.36842105,165474.1598,118,83,66,35,17,34,3,male
280,84600,Asia,82,779,439.6362367,4952.533012,88.09090909,436273.1353,124,97,75,27,22,50,2,female
124,37000,AsiaEurope,79,674,419.0078103,4248.748224,94.575,401825.3633,94,67,51,27,16,40,3,male
77,68100,Asia,55,208,263.0928815,1202.52282,27.32692308,32861.24861,83,64,64,19,0,48,8,male
156,152900,Asia,39,505,187.5249056,2669.128121,17.5,46709.74211,112,97,89,15,8,49,2,male
46,11700,Asia,89,637,488.323496,4125.042196,68.25,281534.1298,96,82,75,14,7,30,5,female
124,103300,Asia,83,734,446.2065082,4679.278943,110.6976744,517985.2969,111,94,94,17,0,27,2,male
499,181900,Asia,96,738,537.6344164,4859.702326,54.41818182,264456.1647,86,58,50,28,8,20,5,male
186,176600,Asia,79,649,419.0078103,4091.153706,46.15384615,188822.4787,97,73,70,24,3,40,3,male
233,55400,Asia,72,603,372.5956925,3720.464776,71.92307692,267587.2743,90,71,59,19,12,31,2,male
124,104000,Asia,63,492,314.9612072,2940.821722,42.69230769,125550.4658,98,75,70,23,5,23,3,male
46,5000,Europe,76,514,398.842491,3211.434742,54,173417.4761,119,75,59,44,16,26,4,male
545,68500,AsiaAfrica,52,604,248.0323866,3443.06559,92.55555556,318674.8485,89,77,72,12,5,39,2,male
124,82200,AsiaEurope,48,427,229.1368501,2384.778988,27,64389.03267,107,77,63,30,14,32,6,male
779,37200,Asia,73,809,379.1044231,5007.568068,95.20588235,476749.9364,91,77,72,14,5,48,3,male
46,8700,Europe,92,635,509.7104706,4142.461842,66.22641509,274340.3975,122,91,81,31,10,33,2,male
109,99500,Asia,41,429,197.7269405,2298.38981,21.6,49645.2199,92,79,76,13,3,28,2,male
202,63100,AsiaEurope,89,758,489.1726399,4908.605941,74.71153846,366729.5015,110,79,66,31,13,36,2,male
171,11700,Asia,72,486,372.2346001,2998.583551,25,74964.58877,116,108,107,8,1,34,2,male
249,103100,Europe,73,750,379.3421297,4642.368419,91.575,425124.888,107,75,51,32,24,46,2,male
62,64400,Europe,81,626,432.536756,3968.746102,68.29268293,271036.3191,112,72,54,40,18,34,5,male
61,70400,North America,93,569,516.8946117,3720.781364,57.77777778,214978.4788,111,61,43,50,18,39,3,male
233,72300,Asia,53,586,256.7497745,3356.561386,135.28125,454079.8201,91,84,83,7,1,47,2,male
62,16300,Asia,92,685,508.4501668,4468.63994,71.52040816,319598.9524,116,76,56,40,20,32,1,male
686,107400,Asia,71,676,365.8862514,4157.229053,82.90909091,344672.0815,98,76,73,22,3,36,3,male
140,104300,South America,67,560,339.5249056,3397.009947,84.11428571,285737.0652,112,92,79,20,13,21,3,male
62,38800,Asia,83,584,446.5546348,3723.023028,79.37777778,295525.2946,88,77,76,11,1,32,3,female
187,67100,Asia,51,521,240.0186475,2955.333603,50.375,148874.9303,132,124,120,8,4,43,2,male
93,67600,Unknown,71,478,365.7235111,2939.579123,58.76470588,172743.5026,79,58,46,21,12,26,2,male
124,133600,Europe,74,618,385.4995491,3837.44218,83.5,320426.422,94,66,47,28,19,52,2,male
109,98300,Asia,57,594,279.1883364,3464.736668,70.3,243570.9878,126,111,103,15,8,42,4,male
77,53500,Europe,121,851,724.4760109,5887.952615,67.25316456,395983.4461,109,79,73,30,6,34,10,male
421,5400,Europe,80,648,425.7903187,4096.609405,67.06097561,274722.6234,109,100,99,9,1,38,5,male
124,107200,Asia,62,504,307.3464548,3000.91494,39.82758621,119519.1985,139,86,50,53,36,28,4,male
77,52900,Asia,85,594,460.2145365,3807.178216,78.42391304,298573.8134,83,79,78,4,1,33,1,male
171,4600,Asia,71,557,365.7235111,3425.409146,66.92647059,229250.5444,112,84,76,28,8,26,2,female
61,51900,South America,88,727,480.9553238,4696.006787,91.66666667,430467.2888,120,82,65,38,17,32,3,male
264,67400,South America,60,560,294.4615345,3307.858734,27.25862069,90167.66651,88,72,72,16,0,18,2,male
77,52500,Unknown,90,715,497.4996898,4641.674964,74.77272727,347070.6962,91,68,61,23,7,42,5,male
140,5800,Europe,95,756,531.8959763,4966.81084,72.33333333,359265.9841,101,78,75,23,3,31,3,male
93,71000,Europe,69,601,352.7497745,3671.223199,74,271670.5167,111,87,81,24,6,38,2,male
218,86600,Asia,58,647,282.5614107,3790.113704,64.68,245144.5544,97,91,91,6,0,48,2,male
78,42800,Asia,72,511,373.2397178,3152.831676,42.98387097,135520.9099,108,81,73,27,8,28,2,male
46,5200,Asia,69,536,352.7497745,3274.169109,67.640625,221466.8449,99,81,69,18,12,33,3,male
61,36900,South America,77,592,405.7769322,3709.937632,74.19512195,275259.275,95,53,39,42,14,34,3,male
62,36900,Europe,87,593,474.2088866,3820.665493,69.875,266969.0013,90,59,46,31,13,33,3,male
108,82500,Asia,76,556,399.4510684,3473.847697,48.17647059,167357.7214,86,67,63,19,4,28,4,male
171,38800,Asia,80,647,426.6582949,4090.287477,64.94444444,265641.4478,102,63,57,39,6,31,3,male
78,36900,Europe,83,614,446.5546348,3914.274211,77.26666667,302442.9207,89,72,68,17,4,27,2,male
217,69000,South America,55,496,264.5725015,2867.554418,86.25,247326.5685,85,58,36,27,22,33,2,male
77,38800,Asia,77,569,405.6268983,3565.801542,79.0875,282010.3294,131,79,61,52,18,25,3,male
46,5800,Asia,84,669,453.5050955,4276.460356,71.45652174,305580.9824,131,110,103,21,7,26,2,male
139,26500,South America,88,759,481.614055,4902.708599,75.24,368879.795,106,68,47,38,21,24,3,male
265,131400,Asia,39,489,187.5249056,2584.561685,17.5,45229.82949,99,82,75,17,7,42,2,male
1091,52900,Asia,57,675,278.3559659,3937.20076,66,259855.2501,122,115,115,7,0,49,1,male
61,6200,North America,86,559,466.7930215,3592.281998,51.02222222,183286.2104,84,74,74,10,0,32,2,male
93,4600,AsiaEurope,76,510,398.8804611,3186.443032,62.61538462,199520.356,104,55,45,49,10,22,1,male
77,54700,Asia,77,560,406.3031211,3509.400463,49.32352941,173096.0169,86,67,63,19,4,30,4,male
249,82200,Asia,78,583,412.2613731,3664.389494,47.5,174058.5009,109,88,75,21,13,29,4,male
62,4600,Europe,66,699,334.0271833,4225.031489,105.1785714,444382.7763,98,79,76,19,3,50,1,female
109,97600,Europe,38,437,188.1173001,2293.344323,18,41280.19782,111,90,90,21,0,35,2,male
202,107200,Asia,97,714,543.5562547,4712.337769,65.76923077,309926.8302,107,65,52,42,13,45,6,female
62,5200,AsiaEurope,95,707,531.3425622,4644.887915,73.125,339657.4288,127,84,70,43,14,27,6,male
77,51100,Asia,76,560,399.4510684,3498.839408,48.17647059,168561.7338,86,67,63,19,4,28,4,male
78,24000,Asia,66,732,332.9737366,4424.496495,70.125,310267.8167,140,116,106,24,10,35,2,male
93,68100,Asia,76,675,401.2905678,4217.351072,96.6,407396.1135,103,69,51,34,18,43,8,male
155,68300,Asia,83,605,446.1369639,3856.898856,66.07317073,254837.5366,127,91,75,36,16,30,4,male
46,38600,Asia,78,720,412.4094067,4525.489598,41.55405405,188052.4394,90,60,55,30,5,21,2,male
46,9600,AsiaEurope,82,664,440.20115,4221.414531,66.13043478,279163.9783,121,80,72,41,8,30,2,male
46,9900,North America,85,687,460.2145365,4403.251573,89.05128205,392115.1978,101,76,65,25,11,27,4,male
61,52400,AsiaEurope,60,511,295.1851693,3018.421094,79.11538462,238803.5458,91,62,55,29,7,33,2,male
93,55900,Europe,57,580,277.6324012,3383.076208,85.11363636,287945.9182,118,99,85,19,14,30,2,male
124,83300,Asia,94,686,523.2394163,4496.447952,50.66981132,227834.1694,122,85,84,37,1,39,4,male
93,69100,Asia,90,779,495.424379,5057.153562,90.23529412,456333.7391,102,71,58,31,13,29,3,male
436,4100,South America,72,673,372.3949821,4152.359526,82.14705882,341104.1222,134,94,72,40,22,30,3,male
78,9200,South America,81,775,432.536756,4913.383752,83.41463415,409848.1081,117,78,56,39,22,33,3,male
62,51700,Asia,78,607,412.2613731,3815.239147,57.5,219376.2509,144,99,80,45,19,39,4,male
218,8700,Asia,58,641,282.2114327,3754.965818,76.30769231,286532.7763,88,66,49,22,17,34,1,male
61,10600,South America,75,541,393.7950768,3369.790912,51.80645161,174576.9098,83,49,43,34,6,32,9,male
186,42900,Asia,61,504,300.7868035,2989.091618,23.76666667,71040.74412,89,79,76,10,3,25,2,male
109,75100,AsiaAfrica,58,561,282.5614107,3286.327338,67.32,221235.5564,95,86,86,9,0,37,4,male
62,10600,South America,75,546,393.7950768,3400.935005,51.80645161,176190.3748,83,49,43,34,6,32,9,male
93,79800,Unknown,63,672,314.1308434,4016.732109,48.125,193305.2327,116,88,87,28,1,37,2,male
811,37200,Asia,73,809,379.1044231,5007.568068,95.20588235,476749.9364,91,77,72,14,5,48,3,male
62,39800,Europe,78,541,412.5946318,3400.4026,69.85714286,237542.4102,102,85,76,17,9,29,3,male
46,5800,Asia,81,806,432.6080183,5109.919102,101.6785714,519569.2744,118,95,90,23,5,41,4,male
202,51800,Asia,73,615,379.1044231,3806.742104,56.23076923,214056.0368,127,107,92,20,15,40,3,male
62,42900,Asia,106,678,609.3751625,4561.530068,42.93548387,195851.5007,129,93,76,36,17,28,5,male
93,71100,Asia,67,745,339.5249056,4519.236447,118.125,533834.8053,122,101,91,21,10,47,3,male
92,66800,Asia,73,518,380.0574174,3206.329121,45.38709677,145525.9701,86,56,42,30,14,18,2,male
77,40700,AsiaEurope,81,804,433.6087556,5097.239402,83.31521739,424677.6089,112,90,80,22,10,53,4,male
264,72000,AsiaAfrica,76,676,398.8804611,4223.598999,74.94871795,316553.3301,71,53,50,18,3,33,2,female
62,35900,Europe,89,533,490.2888307,3451.565919,38.88888889,134227.5635,105,73,63,32,10,24,3,male
109,98400,Asia,61,573,301.3556992,3398.312494,59.18518519,201129.7543,108,79,68,29,11,37,3,male
109,84600,Asia,59,663,289.0701413,3900.192342,68,265213.0792,130,99,86,31,13,49,2,male
109,84600,Asia,59,663,289.0701413,3900.192342,68,265213.0792,130,99,86,31,13,49,2,male
202,38800,AsiaEurope,61,537,300.8814489,3184.80595,78.89655172,251270.2074,112,94,84,18,10,34,2,male
93,69100,Asia,50,631,240.8554909,3561.273256,32.73076923,116563.2131,133,81,65,52,16,17,4,male
77,40800,Asia,100,798,566.7355721,5301.797239,91.72881356,486327.5705,70,52,50,18,2,46,3,male
108,87900,Europe,56,682,270.0391,3960.616057,130,514880.0874,114,71,43,43,28,34,4,male
108,83800,Asia,75,622,392.2479866,3874.325225,77.45833333,300098.7748,96,86,83,10,3,32,1,male
46,5600,Asia,75,537,392.17102,3344.875637,33.10526316,110732.9882,105,71,59,34,12,29,2,female
46,5900,Antarctica,86,589,466.692323,3785.069941,35.31818182,133681.7884,106,66,58,40,8,26,3,male
140,93800,Asia,56,579,278.2629911,3362.4585,25.96666667,87311.83905,92,60,53,32,7,27,3,male
139,4800,Asia,80,652,425.7903187,4121.897118,85.67948718,353162.0313,122,108,107,14,1,26,1,male
343,90800,Asia,40,711,191.1345461,3783.890875,21,79461.70838,207,158,117,49,41,61,2,male
233,163800,Asia,50,563,240.8554909,3177.491035,21.34615385,67827.21247,102,81,78,21,3,48,4,male
421,40000,Asia,83,590,446.3456778,3761.273264,54.15384615,203687.4137,118,92,91,26,1,42,4,male
202,4600,Europe,59,505,288.0881667,2970.73474,67.24137931,199756.3015,126,99,76,27,23,26,1,male
202,8900,Asia,57,651,276.0964047,3797.211399,78.08,296486.2661,87,67,51,20,16,34,1,male
249,119500,Asia,62,736,307.3464548,4382.288484,97.86206897,428859.8179,86,60,41,26,19,62,4,male
78,68000,Europe,58,616,282.5614107,3608.516293,56.1,202437.764,93,88,87,5,1,47,2,male
140,103400,Asia,66,742,334.0271833,4484.940437,126.8928571,569106.9061,147,126,114,21,12,41,3,male
139,131200,AsiaEurope,64,698,320.4063545,4188,93.53448276,391722.4138,130,98,91,32,7,43,3,male
218,8800,Asia,56,651,269.6764904,3780.588054,75.64,285963.6804,87,68,52,19,16,34,1,female
77,36900,Europe,80,733,426.6582949,4633.973294,87.5,405472.6632,116,90,72,26,18,38,2,male
77,56700,Asia,88,648,480.7253082,4185.711689,60.62765957,253769.9034,118,72,39,46,33,29,5,male
171,8700,Asia,97,649,545.8935843,4283.343435,47.74137931,204492.7236,84,72,72,12,0,40,3,male
77,69400,Asia,88,737,482.5401654,4760.601103,76.84615385,365833.8848,93,63,46,30,17,37,3,male
93,13500,Asia,55,589,264.5725015,3405.220871,25.5,86833.13222,110,88,86,22,2,23,4,male
62,55700,Europe,85,623,461.7177151,3993.050553,69.3,276718.4033,101,83,76,18,7,32,4,male
93,58300,AsiaEurope,73,721,379.3421297,4462.863507,112.1212121,500381.6659,99,66,63,33,3,39,2,male
93,74600,AsiaEurope,64,553,320.7232379,3318,59.14285714,196236,85,53,49,32,4,35,3,male
124,115800,Asia,44,579,217.740327,3161.010907,19.5,61639.71269,90,57,47,33,10,37,3,male
249,131200,Europe,72,635,372.5956925,3917.902376,45.5,178264.5581,143,106,90,37,16,31,3,male
264,130600,Asia,45,625,209.4845559,3432.408185,111.375,382284.4616,162,126,105,36,21,44,2,female
187,43700,Asia,8,12,24,36,0,0,105,65,60,40,5,36,3,male
93,71100,Unknown,72,734,372.2746801,4528.724951,102.0142857,461994.6411,107,75,75,32,0,37,2,male
109,122800,Asia,69,579,353.3374044,3536.83566,51.35,181616.5112,162,106,77,56,29,34,3,male
171,36900,South America,82,658,439.460071,4183.269219,69.8372093,292147.848,127,84,70,43,14,33,2,male
77,37600,Asia,65,610,326.4650059,3673.644366,56.203125,206470.2935,108,92,92,16,0,39,2,male
156,43700,Asia,0,0,0,0,0,0,106,90,84,16,6,48,3,male
62,9500,Asia,88,829,481.2514689,5354.868812,97.89795918,524230.7284,110,91,87,19,4,45,1,male
77,36900,Asia,87,637,474.2088866,4104.155007,67.84375,278441.2662,133,87,64,46,23,32,3,male
248,67600,Asia,100,742,565.4268669,4929.741293,88.39285714,435753.9178,110,67,52,43,15,33,5,male
77,9400,Asia,90,655,495.424379,4252.163778,55.82352941,237370.7897,88,65,61,23,4,30,3,male
77,55400,Asia,69,598,353.3374044,3652.897625,56.55,206571.3607,101,72,66,29,6,34,2,male
327,86000,Europe,78,504,413.1887278,3167.842718,44,139385.0796,107,69,52,38,17,26,3,male
46,13400,North America,73,597,379.6596322,3695.325262,85.84375,317220.5779,86,58,48,28,10,31,1,male
93,83500,South America,65,526,328.9735285,3167.76547,117.6,372529.2192,97,74,62,23,12,28,2,male
670,71400,Asia,57,565,277.0156616,3295.582858,57.65217391,189997.5161,98,94,94,4,0,37,2,male
156,5800,Asia,82,688,440.5905816,4373.995779,70,306179.7045,85,76,76,9,0,31,2,female
124,114200,Unknown,39,409,179.6514845,2161.729508,18.28571429,39528.76814,108,87,79,21,8,38,3,male
93,59700,North America,87,664,474.2088866,4278.114481,61.75,264173.5692,91,61,60,30,1,15,3,male
155,130600,AsiaEurope,91,672,502.5535519,4373.237998,62.25,272234.0654,111,54,33,57,21,33,2,male
124,68300,Asia,82,816,439.8831639,5187.762436,72.76666667,377496.1799,106,86,77,20,9,50,4,male
46,6600,Asia,74,714,385.8508604,4433.549703,75.88235294,336428.1833,172,157,157,15,0,41,2,male
61,80000,Asia,87,793,474.5420279,5109.254192,77.16326531,394246.7367,135,119,119,16,0,34,5,male
77,56500,AsiaEurope,76,779,398.8804611,4867.135533,87.75641026,427122.3426,100,79,73,21,6,35,2,male
46,33300,Asia,80,611,426.6582949,3862.698066,50.94444444,196783.007,100,65,64,35,1,33,2,male
78,12600,Asia,89,858,487.7378322,5556.179284,102.0729167,567135.425,147,125,118,22,7,46,9,male
124,102900,AsiaEurope,73,498,378.8670746,3082.53263,51.08108108,157459.0992,106,58,50,48,8,19,3,female
93,69000,Asia,70,667,360.541081,4088.231772,93.31034483,381474.3164,111,93,91,18,2,39,2,male
62,33200,Asia,84,583,453.8154506,3726.721057,73.21276596,272843.5566,96,54,47,42,7,29,2,male
78,51800,North America,78,673,412.2983693,4230.075693,76.475,323495.0386,124,89,74,35,15,37,2,male
61,13300,AsiaEurope,76,651,400.713475,4067.400811,99.43548387,404443.9678,121,97,84,24,13,33,3,male
77,68200,Asia,57,780,277.6324012,4549.654211,86.70454545,394475.7003,147,124,107,23,17,54,2,male
124,122900,Asia,66,615,333.3240179,3717.302383,52.8,196273.5658,106,83,76,23,7,45,2,male
109,105200,Asia,48,631,244.9390249,3524.111338,21.5,75768.39377,147,130,130,17,0,31,4,male
186,154000,Asia,89,656,489.6970841,4248.081131,48.56603774,206312.4685,103,74,69,29,5,31,4,male
62,39800,South America,93,662,516.4569079,4328.923133,55.09433962,238499.1613,97,76,75,21,1,26,3,male
77,53400,Asia,75,601,392.17102,3743.520033,88.11842105,329873.0745,97,79,73,18,6,31,3,male
202,20000,AsiaEurope,74,726,385.5385456,4508.063143,85.73684211,386507.0979,116,91,88,25,3,36,2,male
46,4100,Asia,70,706,359.0910367,4327.27381,112.2352941,485672.8488,85,77,75,8,2,42,2,male
62,5800,South America,83,573,447.1829761,3652.897594,37.91489362,138499.2237,112,86,79,26,7,19,5,male
171,146300,Asia,63,670,315.5176503,4004.777549,50.92,203923.2728,97,75,73,22,2,27,5,male
234,15400,Australia,87,661,473.9427998,4258.785651,62.9787234,268212.8835,139,101,83,38,18,29,3,male
140,128600,Asia,38,498,184.2797931,2613.467902,17.5,45735.68828,106,98,96,8,2,47,2,male
93,83800,Asia,51,515,243.5249056,2921.299051,26.25,76684.10009,112,89,83,23,6,34,2,male
233,51700,Asia,86,787,468.3101095,5057.470362,116.64,589903.343,69,55,52,14,3,40,3,male
77,5800,Asia,58,529,289.1465005,3098.871946,24.11764706,74737.49988,115,67,40,48,27,33,1,male
93,50800,Europe,75,576,392.6333688,3587.799566,76.29268293,273722.8547,91,72,63,19,9,34,3,male
108,72000,Unknown,62,667,307.5796744,3971.448939,51,202543.8959,105,77,67,28,10,35,2,female
264,66600,Unknown,75,688,392.4020294,4285.427259,68.6875,294355.2849,124,101,86,23,15,44,2,male
140,145300,Europe,69,590,352.582306,3604.029429,55,198221.6186,141,106,79,35,27,39,2,male
62,7900,AsiaEurope,88,610,480.9553238,3940.253287,73.33333333,288951.9077,97,63,51,34,12,34,1,male
93,72000,AsiaEurope,59,603,289.0701413,3547.233759,110.16,390763.2709,113,79,57,34,22,39,4,female
77,12100,Asia,78,723,412.2983693,4544.345804,72.2,328101.7671,140,103,81,37,22,38,1,male
93,71500,Asia,86,688,466.7930215,4421.270151,87.01111111,384699.6284,94,55,53,39,2,25,2,male
202,19700,Asia,84,682,453.5050955,4359.560482,62.7826087,273704.5798,103,94,94,9,0,40,3,male
93,36400,Asia,45,505,227.6596322,2773.385814,25.625,71068.01147,92,65,56,27,9,33,4,male
62,10300,Asia,86,641,466.9609738,4119.235708,63.91304348,263272.8909,110,75,68,35,7,29,1,female
124,37600,Asia,76,845,399.1845378,5279.498749,108.8414634,574628.3699,129,101,87,28,14,42,2,male
140,131300,Asia,44,508,217.740327,2773.391262,23.4,64897.35554,135,101,90,34,11,44,3,male
202,53400,Asia,79,629,419.7398968,3965.078091,75.56818182,299633.7421,101,80,68,21,12,30,3,male
62,27800,Europe,84,716,452.9890166,4576.899275,39.85365854,182406.1809,116,74,65,42,9,21,4,male
92,68400,Asia,83,565,446.1369639,3601.897279,53.26829268,191866.9185,111,80,65,31,15,24,3,male
108,95700,Unknown,91,786,502.5535519,5115.126587,87.75,448852.358,114,85,81,29,4,39,3,male
109,54700,Asia,54,527,262.2366428,3032.825714,69.64705882,211227.3909,115,71,63,44,8,32,3,male
124,103800,South America,86,701,468.818598,4504.811593,63.1372549,284421.4378,117,64,37,53,27,37,9,male
327,91500,AsiaEurope,92,704,508.2931913,4592.587617,77.91666667,357839.1185,104,81,71,23,10,33,5,male
62,42100,Asia,81,700,432.536756,4437.895002,49.26829268,218647.5099,82,59,54,23,5,30,2,female
108,75000,Asia,91,669,501.8524417,4353.714614,49.2,214202.759,112,72,58,40,14,24,2,male
62,4900,Asia,74,569,387.4217091,3533.178965,43.26666667,152868.8766,91,68,59,23,9,26,1,male
139,129900,Asia,69,694,353.3374044,4239.315973,57.2,242488.8737,135,102,96,33,6,49,3,male
46,8800,Asia,114,789,672.3766729,5391.150221,38.91891892,209817.7383,109,17,10,92,7,11,2,male
327,113300,Asia,85,577,460.4869215,3698.21857,52.55319149,194353.1887,122,102,94,20,8,35,5,male
249,71600,AsiaEurope,59,561,288.3819626,3300.162751,69.92592593,230766.936,91,60,51,31,9,37,2,male
62,52600,Asia,110,1024,640.424805,6944.112347,129.7058824,900692.2191,103,81,79,22,2,47,10,male
78,84500,Asia,61,572,304.2381821,3392.381757,62.04545455,210481.8681,135,101,90,34,11,44,3,male
124,115000,Europe,71,533,365.6422056,3277.815215,52.97142857,173630.5545,112,84,77,28,7,37,2,female
77,52400,AsiaEurope,76,736,398.9944238,4598.47465,123.8888889,569699.915,125,116,112,9,4,39,2,male
327,103400,Asia,64,734,321.1317371,4404,73.31481481,322878.4444,131,115,115,16,0,43,2,male
93,68400,AsiaEurope,67,621,339.4387425,3767.041387,91.18181818,343485.6829,93,84,80,9,4,34,2,male
186,55600,Asia,103,681,588.8198034,4553.506859,56.20967742,255951.1517,99,86,86,13,0,43,5,male
187,55600,Asia,103,681,588.8198034,4553.506859,56.20967742,255951.1517,99,86,86,13,0,43,5,male
124,99400,AsiaEurope,69,491,353.3374044,2999.285508,71.5,214448.9138,121,89,71,32,18,33,3,male
312,88700,Asia,66,580,333.3240179,3505.748589,39,136724.195,130,83,54,47,29,30,3,male
140,122500,Asia,70,589,359.2147805,3610.147697,72.31818182,261079.3175,91,74,72,17,2,42,2,male
92,68100,North America,76,533,399.1845378,3330.145365,43.92857143,146288.5285,98,64,58,34,6,20,2,male
124,40800,South America,76,604,398.8804611,3773.748218,66.41025641,250615.5868,91,79,74,12,5,47,3,male
124,115000,Asia,52,503,259.6966127,2867.321178,31.5,90320.61711,100,82,75,18,7,37,5,male
358,90800,Asia,48,519,239.3111166,2898.595538,23.42857143,67909.9526,128,108,102,20,6,45,5,male
93,56400,Asia,76,629,399.1845378,3929.946406,91.76829268,360644.472,104,91,87,13,4,33,3,male
46,8700,Africa,78,875,413.1887278,5499.726942,97.75,537598.3085,117,104,100,13,4,52,2,male
155,52800,Europe,80,628,428.700868,3970.170844,65.79591837,261221.0367,112,82,63,30,19,32,3,male
109,95600,Europe,62,639,307.5796744,3804.731442,99.57142857,378842.545,107,89,83,18,6,41,2,male
156,56900,South America,108,689,624.2149912,4654.117489,63.59375,295972.7841,112,77,64,35,13,38,5,male
61,40400,Asia,79,627,419.4466845,3952.470529,67.81395349,268032.6526,96,86,83,10,3,36,2,female
311,69600,South America,60,564,301.5359818,3331.486296,49,163242.8285,128,102,88,26,14,39,5,male
342,69600,South America,60,564,301.5359818,3331.486296,49,163242.8285,128,102,88,26,14,39,5,male
420,43700,Asia,0,0,0,0,0,0,112,94,88,18,6,48,3,male
217,69000,Asia,55,492,265.9634675,2844.428979,33.25,94577.26355,120,112,110,8,2,38,2,male
46,6000,Asia,98,870,552.6400215,5754.797564,111.3793103,640965.3839,100,92,91,8,1,49,7,male
108,84500,AsiaEurope,71,723,365.8862514,4446.267167,65.06060606,289276.8366,149,83,46,66,37,43,2,male
249,71100,Asia,61,568,302.2137048,3368.658808,83.52,281350.3836,90,57,41,33,16,38,3,male
46,6400,Asia,70,535,359.0498112,3279.166414,50.5,165597.9039,89,75,73,14,2,30,1,male
108,91800,Asia,54,747,261.1759501,4298.900964,112,481476.908,149,124,113,25,11,50,2,male
358,154800,Asia,94,685,522.6230769,4489.893363,52.69607843,236599.7728,108,72,69,36,3,39,4,male
93,84600,Asia,59,617,289.5640056,3629.590761,52.5,190553.515,101,77,76,24,1,44,3,male
93,130100,Asia,87,729,473.7434822,4696.905808,41.89130435,196759.5107,89,67,67,22,0,35,3,male
77,59400,Europe,72,615,372.3949821,3794.503876,53.68421053,203704.9449,130,102,82,28,20,39,2,male
171,147200,Asia,81,710,432.6080183,4501.293502,48.75,219438.0582,123,92,85,31,7,35,3,male
140,114800,AsiaEurope,62,635,307.9068682,3780.914657,84.25925926,318577.0683,146,104,88,42,16,37,2,male
888,208200,Asia,97,780,546.4971854,5147.932017,84.05084746,432688.0487,90,69,61,21,8,29,3,male
77,68200,Europe,83,533,446.2065082,3397.896017,52.1375,177157.8036,87,75,69,12,6,32,4,female
62,46600,AsiaEurope,107,689,617.3293845,4644.870754,61.140625,283990.3009,82,50,43,32,7,29,6,male
46,5800,Asia,93,640,517.3960298,4185.061639,61.83636364,258788.9934,103,56,30,47,26,25,1,male
140,60800,Asia,79,608,419.2271063,3832.698695,44.92857143,172197.6771,108,97,97,11,0,33,2,male
186,152400,Asia,49,536,234.2230164,3009.484476,42.92307692,129176.3337,91,80,77,11,3,40,2,male
108,69100,Asia,50,631,240.8554909,3561.273256,32.73076923,116563.2131,133,81,65,52,16,17,4,male
78,16500,AsiaAfrica,77,646,406.0022373,4048.344105,91.8,371637.9889,83,73,73,10,0,34,4,male
109,83800,Asia,57,706,285.0806907,4118.02035,40.6,167191.6262,128,96,93,32,3,27,3,male
171,181500,Europe,53,616,252.9035678,3528.399,45.375,160101.1046,122,110,105,12,5,46,2,male
155,60700,Asia,79,608,419.2271063,3832.698695,44.92857143,172197.6771,110,97,95,13,2,33,2,male
61,33200,Asia,23,46,88.71062276,208.08385,11.875,2470.995718,123,75,52,48,23,49,3,male
233,91500,Asia,63,622,313.6717238,3717.868112,73.7,274006.8799,105,98,97,7,1,41,2,male
93,2200,Asia,96,842,536.1864584,5544.538426,98.31632653,545118.6503,113,86,85,27,1,49,5,male
140,68100,Europe,81,618,433.2506894,3918.027302,71.6,280530.7548,107,67,56,40,11,31,3,male
62,5800,Asia,47,507,227.9505705,2816.176548,29.55555556,83233.66241,100,75,72,25,3,24,3,male
93,71000,Antarctica,76,735,398.8804611,4592.226722,119.1081081,546971.4369,104,89,83,15,6,44,3,male
62,36800,Asia,99,766,558.5412601,5078.087171,74.48214286,378226.8141,109,80,75,29,5,30,10,male
108,90600,Asia,65,495,327.3557123,2981.072067,45.58928571,135904.9462,117,79,60,38,19,28,2,male
46,13700,South America,98,828,552.134363,5476.979751,90.63157895,496387.3227,114,63,25,51,38,41,3,male
264,99300,Asia,44,502,214.9310205,2740.634673,19,52072.05878,119,104,103,15,1,38,2,male
249,82000,Asia,62,692,309.4603455,4120.303847,50.66666667,208762.0616,131,105,96,26,9,45,4,female
233,68000,Europe,57,583,276.0964047,3400.574878,64.64,219813.1601,106,88,83,18,5,45,2,male
187,100400,Asia,71,624,365.8862514,3837.442203,63.90909091,245247.4426,149,121,109,28,12,39,2,male
62,37900,AsiaEurope,95,746,530.851908,4901.112284,84.36363636,413475.6545,105,83,76,22,7,36,4,female
140,102900,Asia,93,784,516.0824975,5126.700508,66.23076923,339545.3183,108,76,76,32,0,33,4,female
233,115300,Asia,68,680,346.3298602,4139.474732,97.27419355,402664.0663,113,89,74,24,15,37,2,male
311,97800,AsiaEurope,52,606,245.3142135,3454.466469,79.09090909,273216.8935,114,88,71,26,17,45,2,male
187,37800,Asia,85,605,460.0105131,3877.681516,46.22222222,179235.0568,124,84,72,40,12,28,4,male
373,103500,AsiaEurope,69,672,352.7497745,4104.928435,92.5,379705.8802,95,84,79,11,5,38,2,male
140,137700,AsiaEurope,99,615,558.9520626,4077.054321,50.84210526,207286.025,100,76,68,24,8,27,3,male
171,7500,Asia,78,735,412.85429,4619.770631,54.67142857,252569.4601,110,67,67,43,0,41,4,male
46,5800,Asia,74,531,385.6555921,3297.219737,30.08571429,99199.21095,137,105,85,32,20,36,2,female
78,46100,Europe,108,772,621.9557072,5214.773152,71.55172414,373126.01,108,2,-5,106,7,2,2,male
280,78300,AsiaEurope,70,759,359.2147805,4652.12581,122.7727273,571154.1733,139,105,97,34,8,34,3,male
140,53600,Asia,74,654,385.6555921,4060.982501,43.97435897,178579.1023,121,82,72,39,10,29,3,female
62,44700,Africa,88,856,480.7253082,5529.273466,65.86170213,364167.362,97,64,64,33,0,37,2,male
77,49800,Europe,61,567,304.2381821,3362.72807,117,393439.1842,102,84,77,18,7,36,2,male
46,7800,AsiaEurope,88,610,480.9553238,3940.253287,73.33333333,288951.9077,97,63,51,34,12,34,1,male
109,94600,AsiaEurope,68,552,345.9899115,3360.279488,76.89393939,258385.1273,118,95,81,23,14,32,2,male
124,91500,Asia,80,671,425.8985773,4242.013752,56.0952381,237956.7714,104,67,61,37,6,42,4,male
62,17300,North America,79,861,419.2271063,5427.555224,79.28571429,430327.5928,138,96,62,42,34,32,1,male
93,68100,Asia,78,728,412.2983693,4575.772815,56.31578947,257688.2585,107,95,90,12,5,58,3,male
46,8100,AsiaEurope,85,632,460.8279746,4050.735072,46.63541667,188907.7179,126,110,104,16,6,32,2,female
62,37800,Asia,74,704,386.4773318,4371.455169,41.34375,180732.3497,120,80,73,40,7,36,4,male
77,68300,Asia,47,536,241.3293845,2977.259624,21.5,64011.08193,132,82,72,50,10,27,3,male
171,7800,AsiaEurope,62,719,308.3287327,4281.067147,114.2307692,489029.5933,151,142,140,9,2,44,1,female
46,5800,Asia,78,808,412.5946318,5078.604993,83.57142857,424426.2744,133,100,91,33,9,43,3,female
140,60500,Asia,84,737,453.092115,4711.137941,75,353335.3455,134,83,66,51,17,39,4,male
140,121900,Asia,47,459,227.9505705,2549.556283,25.33333333,64588.75917,110,93,88,17,5,42,3,male
109,99900,AsiaEurope,83,630,446.5546348,4016.274842,73.46666667,295062.325,106,68,62,38,6,29,3,male
202,52600,Europe,74,688,385.8508604,4272.103916,85.425,364944.477,110,87,79,23,8,32,2,male
186,37800,Asia,72,614,372.2346001,3788.333951,59,223511.7031,99,92,92,7,0,37,2,male
77,68100,Asia,71,671,365.6422056,4126.480317,57.08571429,235563.0764,137,101,92,36,9,37,4,male
109,114900,Asia,59,701,290.159225,4123.732778,65.73913043,271090.6069,178,154,150,24,4,45,2,male
46,8600,North America,69,728,352.582306,4447.005805,78,346866.4528,128,105,94,23,11,48,5,male
77,16000,Asia,56,639,278.2629911,3710.899795,127.1,471655.364,118,92,86,26,6,37,5,male
327,78200,Asia,63,580,315.5176503,3466.822356,35.72,123834.8945,114,93,91,21,2,35,4,male
139,48600,Asia,90,711,495.0699333,4615.707551,47.6,219707.6795,116,80,75,36,5,28,2,male
108,68100,Asia,93,815,515.5221939,5329.414431,65.36,348330.5272,122,89,89,33,0,43,6,female
171,62500,Asia,49,158,226.2533577,887.1241554,18.08695652,16045.37603,105,78,72,27,6,51,2,male
46,51700,Asia,131,959,799.7921582,6745.052658,82.15116279,554113.919,90,57,54,33,3,30,5,male
109,5700,Europe,62,527,309.4603455,3137.861456,79.16666667,248414.0319,89,76,74,13,2,28,1,male
171,5900,Europe,55,639,265.9634675,3694.288857,69.125,255367.7172,115,106,102,9,4,42,1,male
61,36900,Unknown,99,764,559.4225299,5064.828458,72.81034483,368771.9065,125,67,58,58,9,29,4,male
140,99500,Europe,45,538,216.7497745,2954.616966,25.4375,75158.06907,104,73,70,31,3,41,4,male
218,146500,Asia,53,735,256.7497745,4210.021534,37,155770.7968,143,123,122,20,1,51,4,male
77,75900,Asia,0,0,0,0,0,0,118,83,76,35,7,53,5,male
218,16100,Asia,58,730,284.2247957,4276.326126,45,192434.6757,231,205,186,26,19,57,1,male
140,122000,AsiaEurope,77,648,405.6268983,4060.877678,80,324870.2143,88,60,57,28,3,38,2,male
61,68600,Asia,107,837,614.8836801,5642.607868,71.81034483,405197.6167,126,93,85,33,8,47,5,female
202,71000,North America,48,556,225.0683649,3105.23915,42.9,133214.7596,138,114,104,24,10,37,2,male
93,67700,Unknown,66,724,332.9300119,4376.141342,107.5,470435.1943,109,92,91,17,1,36,6,male
109,99800,Asia,66,791,335.7560369,4781.115748,133.66,639043.9309,95,79,78,16,1,41,7,male
249,75800,AsiaEurope,82,807,439.6362367,5130.544468,98.45454545,505125.4235,138,98,87,40,11,37,3,male
171,115500,Europe,79,588,419.0808777,3706.62308,76.06578947,281947.2109,107,71,61,36,10,36,3,male
327,71000,South America,83,748,446.8336245,4768.529495,76.01086957,362460.0734,132,92,60,40,32,41,2,male
124,37200,AsiaEurope,68,768,348.0415947,4675.171462,132.1111111,617642.0965,146,93,73,53,20,38,3,male
93,8700,Asia,120,981,711.7528278,6775.659674,109.0422535,738833.2,104,80,72,24,8,49,5,female
77,67700,Unknown,66,724,332.9300119,4376.141342,107.5,470435.1943,110,92,91,18,1,36,6,male
234,99700,Europe,71,662,367.9353223,4071.132593,53.75,218823.3769,101,55,51,46,4,26,3,male
186,47500,AsiaEurope,51,525,259.8664757,2978.023305,25.14285714,74876.01451,140,91,77,49,14,38,2,male
124,5800,Asia,81,613,432.6080183,3886.328052,73.23076923,284598.7927,110,79,76,31,3,30,2,male
249,82100,AsiaEurope,71,511,366.1306865,3142.520778,76.171875,239371.6999,88,68,56,20,12,29,2,male
124,114400,Asia,42,598,201.6270751,3224.605819,21,67716.7222,121,98,88,23,10,20,2,male
62,5800,AsiaAfrica,73,695,378.8670746,4301.928068,89.93055556,386874.7812,97,73,69,24,4,38,3,male
46,35900,Europe,85,667,462.267429,4275.063754,75.33333333,322054.8028,103,86,76,17,10,34,3,male
93,84300,Asia,67,486,339.6973857,2948.119347,25.5483871,75319.69427,118,55,40,63,15,26,2,male
61,21200,AsiaAfrica,87,639,473.5443757,4117.040894,64.46511628,265405.5199,116,67,50,49,17,24,5,male
342,172900,Asia,60,641,295.6213103,3786.316872,28.7,108667.2942,102,75,69,27,6,33,2,male
186,34400,Asia,79,726,419.0078103,4576.544823,70.6875,323504.5122,143,95,78,48,17,40,4,male
171,178100,Asia,54,608,261.1759501,3498.971601,44,153954.7505,136,98,97,38,1,44,2,male
62,6500,North America,80,731,425.8985773,4621.329437,91.73684211,423946.1689,109,77,56,32,21,45,3,male
139,119700,Asia,71,588,370.1802547,3616.051306,55.2,199606.0321,100,75,69,25,6,32,3,female
139,131200,Asia,64,795,321.1317371,4770,126.7592593,604641.6667,140,111,99,29,12,47,2,male
124,100900,Europe,90,672,495.0699333,4362.525281,71.6,312356.8101,117,96,88,21,8,31,3,male
62,37800,Europe,100,774,564.8477751,5142.344691,58.77777778,302255.5935,114,61,37,53,24,32,7,male
342,180400,AsiaEurope,44,615,210.1173001,3357.550445,72,241743.6321,93,78,73,15,5,57,3,female
109,84300,AsiaEurope,59,611,290.8572701,3594.294903,122.7727273,441281.3879,114,88,76,26,12,30,3,male
46,37000,Asia,76,612,398.8804611,3823.731638,59.55405405,227718.7207,111,91,87,20,4,47,2,male
93,56300,Unknown,77,573,405.551932,3590.868688,45.15789474,162156.0702,149,97,75,52,22,34,3,male
93,83200,Asia,55,667,285.065676,3856.166929,32.3125,124602.3939,133,99,93,34,6,47,7,male
93,12500,AsiaEurope,81,715,432.536756,4532.992752,91.70731707,415708.6036,122,92,86,30,6,35,1,male
77,13400,Asia,77,592,405.551932,3709.937632,55.93421053,207512.4326,92,73,70,19,3,40,1,male
62,67200,Asia,80,768,425.7903187,4855.240777,122.474359,594642.5018,97,91,91,6,0,39,3,male
187,175900,Asia,66,672,335.0885565,4061.832848,65.38461538,265581.3785,126,90,78,36,12,40,3,male
93,53600,AsiaEurope,78,603,412.2613731,3790.097538,55,208455.3646,118,82,75,36,7,40,3,male
109,99900,Europe,95,698,529.5086837,4585.759215,74.62745098,342223.521,103,75,59,28,16,32,6,male
93,55500,AsiaEurope,86,639,467.8705569,4106.383178,51.34693878,210850.2056,118,74,64,44,10,25,2,female
296,72400,South America,79,729,419.0808777,4595.456165,60.24390244,276848.2129,139,118,116,21,2,34,5,male
155,129800,Europe,57,631,280.1318683,3680.553599,107,393819.2351,124,94,78,30,16,35,3,male
93,66600,Unknown,71,730,365.8862514,4489.315397,102.0394737,458087.3803,100,93,92,7,1,42,2,male
61,6600,Asia,83,736,446.5546348,4692.029021,92.04444444,431875.2046,99,78,68,21,10,34,3,male
62,11700,Europe,94,865,524.1054708,5669.719357,95.01818182,538726.4247,132,101,94,31,7,44,5,male
155,36900,Asia,87,748,474.2088866,4819.321735,84.90625,409190.5361,117,88,77,29,11,37,3,male
249,68300,AsiaEurope,76,816,398.9944238,5098.308851,117.7777778,600467.4869,122,93,81,29,12,47,3,male
46,6300,Asia,0,0,0,0,0,0,101,74,65,27,9,40,3,male
467,118200,Asia,68,814,346.6279634,4955.194753,86.13333333,426807.4414,174,141,120,33,21,50,4,male
233,74100,AsiaEurope,62,592,307.1601712,3524.884216,91,320764.4636,121,86,73,35,13,35,2,male
46,16400,Asia,86,695,468.3101095,4466.254005,40.68,181687.2129,132,109,109,23,0,41,2,male
140,114000,Asia,58,679,287.9357738,3977.569096,27.77777778,110488.0304,121,81,71,40,10,28,3,male
139,68300,Asia,83,672,446.3456778,4284.026498,42.10227273,180367.252,115,70,52,45,18,14,7,male
436,94200,Asia,115,894,675.5720375,6119.868106,65.33333333,399831.3829,110,51,33,59,18,46,9,male
124,99300,Asia,71,572,370.1802547,3517.655352,60.72,213592.033,95,85,85,10,0,45,5,male
155,77300,Asia,75,641,393.3293845,3992.672781,49.046875,195828.1228,124,91,79,33,12,29,5,male
436,94200,Asia,115,894,675.5720375,6119.868106,65.33333333,399831.3829,110,51,33,59,18,46,9,male
342,88700,Asia,83,727,446.5546348,4634.653667,87.03947368,403397.8158,84,63,59,21,4,41,5,male
108,86700,Europe,68,679,347.0121354,4133.387269,131.1206897,541972.5894,117,100,90,17,10,40,3,male
46,5900,Antarctica,83,681,446.2065082,4341.401853,97.825,424697.6362,111,69,51,42,18,33,5,male
108,87500,Asia,80,725,425.7542476,4583.397869,54,247503.4849,125,98,89,27,9,42,4,male
62,48800,Europe,92,644,508.6701412,4201.1739,45.36,190565.2481,105,65,55,40,10,25,2,male
202,68300,Asia,73,752,378.9461511,4654.748068,109.1142857,507899.5107,120,88,87,32,1,35,2,male
202,67300,Unknown,63,590,314.1308434,3526.595155,69.375,244657.5389,117,92,77,25,15,42,5,male
109,83500,Asia,81,817,432.6080183,5179.657452,62.46153846,323529.3732,157,116,108,41,8,36,2,male
109,83000,AsiaEurope,64,693,321.6326782,4158,124.9615385,519590.0769,104,94,89,10,5,48,2,male
140,5800,Asia,67,768,339.9564924,4658.756498,54.26666667,252815.186,163,126,118,37,8,33,4,male
326,79100,North America,72,726,372.5956925,4479.365551,105.7727273,473794.7108,111,94,83,17,11,47,3,male
62,8200,Asia,77,632,405.551932,3960.609094,84.76923077,335737.7863,95,73,70,22,3,33,3,male
62,6000,Europe,72,649,374.2108333,4004.281326,58.56896552,234526.6149,128,104,89,24,15,26,1,male
186,13600,AsiaEurope,106,939,611.8071357,6317.517307,94.54545455,597292.5454,120,77,61,43,16,39,6,male
77,61000,North America,103,867,587.2909311,5797.195957,54.44067797,315603.2782,137,91,75,46,16,40,11,female
265,79600,Asia,74,816,385.5385456,5066.913946,82.33333333,417175.9149,98,62,55,36,7,33,2,male
234,16500,AsiaEurope,90,703,494.3950605,4563.772727,73.64893617,336117.0062,166,123,99,43,24,37,5,male
436,132600,AsiaEurope,60,830,297.5287411,4902.719194,123.5,605485.8205,120,106,106,14,0,51,2,female
77,55500,Asia,82,750,439.460071,4768.164003,115.1860465,549225.9607,109,89,80,20,9,37,3,male
109,106200,Asia,52,653,255.8966738,3722.387136,23.33333333,86855.69984,135,112,98,23,14,61,9,male
77,45900,Asia,90,753,497.4996898,4888.365382,61.72727273,301745.4631,112,82,63,30,19,36,3,male
155,130700,Asia,47,442,238.0869722,2455.128272,25.2,61869.23247,109,91,88,18,3,32,2,male
62,8200,South America,85,835,460.8279746,5351.841432,85.94791667,459979.6214,139,94,68,45,26,38,8,male
109,83700,Asia,49,554,234.2230164,3110.549254,45.69230769,142128.1736,172,70,-14,102,84,49,2,male
61,6200,Asia,74,582,385.4995491,3613.901859,71,256587.032,83,76,76,7,0,33,1,female
187,37200,AsiaEurope,98,736,553.8346812,4868.426445,68.71666667,334542.0372,119,64,41,55,23,33,4,male
78,5800,Asia,74,582,385.4995491,3613.901859,71,256587.032,83,76,76,7,0,33,1,female
405,36200,Asia,83,812,448.094519,5176.532018,97.83673469,506454.9897,89,73,69,16,4,43,3,male
93,54200,Unknown,93,1000,516.8946117,6539.158811,91.36111111,597424.8147,87,72,67,15,5,56,3,male
187,35900,Asia,78,651,412.4094067,4091.796844,90.24390244,369259.7152,112,90,81,22,9,31,3,male
264,68100,AsiaAfrica,90,742,495.8441109,4816.954997,68.69230769,330887.7548,104,61,61,43,0,24,3,male
124,91600,North America,61,590,306.0981941,3499.135029,39.975,139877.9228,142,90,64,52,26,35,5,male
46,5500,AsiaEurope,73,681,379.3421297,4215.270525,43.63636364,183939.0774,136,99,92,37,7,28,4,male
187,39800,Asia,73,600,378.8670746,3713.894735,60.63888889,225206.4502,130,111,111,19,0,42,3,male
92,72800,Asia,71,632,367.3587806,3886.64018,101.3793103,394024.901,134,104,99,30,5,41,5,male
46,36900,Asia,99,764,559.4225299,5064.828458,72.81034483,368771.9065,125,67,58,58,9,29,4,male
436,80900,Unknown,79,722,419.0808777,4551.3297,91.17105263,414949.5196,111,76,73,35,3,31,2,male
124,51700,Asia,60,674,295.6213103,3981.244261,100.8,401309.4216,122,109,109,13,0,45,5,male
140,115000,Asia,60,593,296.7916995,3502.786123,59.52173913,208491.9219,170,133,118,37,15,35,3,male
93,54400,AsiaEurope,61,963,302.2137048,5711.300056,183.6,1048594.69,149,118,99,31,19,53,3,male
374,101700,Asia,54,568,258.7036718,3268.776101,87.21428571,285083.9728,105,81,62,24,19,43,2,male
109,91700,Asia,92,657,508.6701412,4285.980205,72.24,309619.21,150,117,111,33,6,37,3,male
295,193100,Asia,63,664,318.7159976,3968.913869,38,150818.727,155,102,102,53,0,39,2,male
374,73700,Europe,80,699,425.7903187,4419.027738,71.34146341,315259.9057,126,85,72,41,13,27,8,male
62,16700,Asia,75,667,392.4020294,4154.622067,73.14285714,303880.9283,87,68,61,19,7,32,2,male
61,8800,South America,93,879,517.3960298,5747.920595,85.67272727,492440.0335,142,113,102,29,11,43,8,male
93,67100,AsiaEurope,51,649,241.523656,3681.404047,154.9166667,570310.8436,117,85,68,32,17,37,2,male
202,68000,Asia,72,572,372.3949821,3529.197101,57.71052632,203671.8222,95,55,43,40,12,37,2,male
140,129500,Asia,44,593,210.1173001,3237.44295,20.25,65558.21973,134,96,79,38,17,32,4,male
62,2900,North America,73,615,381.7393272,3806.742104,70.71428571,269191.0488,91,75,69,16,6,35,5,male
77,55500,Unknown,92,869,508.1990654,5668.97534,103.9222222,589132.515,137,95,81,42,14,47,6,male
93,261800,Europe,75,626,392.17102,3899.2405,72.91891892,284328.4019,131,95,90,36,5,39,2,male
93,75100,Asia,70,751,359.4212455,4603.091546,114,524752.4362,104,88,85,16,3,44,3,male
140,114500,Asia,81,634,432.75063,4019.464902,62.74418605,252198.0536,109,82,73,27,9,35,3,male
46,6600,Asia,52,494,255.8966738,2816.017221,36.66666667,103253.9648,124,99,88,25,11,23,1,male
187,83900,Europe,88,750,483.1046897,4844.573714,75.94339623,367913.3811,119,79,54,40,25,40,2,male
358,91600,Asia,73,611,378.9461511,3781.982805,57,215573.0199,102,52,30,50,22,34,3,male
139,82100,AsiaEurope,60,539,295.1851693,3183.814031,94.15384615,299768.3365,112,60,44,52,16,23,2,male
140,148400,Asia,38,733,178.0746464,3846.730867,16.5,63471.05931,144,123,123,21,0,56,2,male
155,105800,Asia,69,688,352.7497745,4202.664826,62.4375,262403.8851,169,159,154,10,5,42,2,male
109,20100,North America,74,681,386.9094701,4228.637742,125.5322581,530830.4443,114,89,74,25,15,32,4,male
62,8200,South America,87,650,473.7434822,4187.913272,46.79347826,195967.0287,126,75,51,51,24,32,2,male
61,27400,AsiaEurope,57,690,277.0156616,4024.69411,48.04347826,193360.304,115,103,99,12,4,51,5,male
140,107600,Asia,9,9,28.52932501,28.52932501,0,0,115,84,73,31,11,37,16,male
93,68100,Europe,58,518,287.9357738,3034.434155,33.33333333,101147.8052,124,105,105,19,0,38,3,male
280,86700,AsiaEurope,58,614,282.2114327,3596.800331,95.38461538,343079.4162,111,97,92,14,5,35,2,male
77,36900,North America,89,725,487.9979062,4694.906737,46.93877551,220373.1734,113,88,88,25,0,29,3,male
92,68100,North America,91,836,501.4075845,5440.516319,107.5,584855.5043,152,114,91,38,23,45,5,male
218,74600,South America,88,672,480.4627738,4340.738048,108.8372093,472433.8154,96,75,71,21,4,27,6,male
140,115700,Europe,87,594,473.6107211,3827.108437,53.57142857,205023.6662,128,96,89,32,7,21,4,male
233,68100,Asia,65,612,327.3557123,3685.689102,59.46428571,219166.8698,138,130,128,8,2,44,2,female
218,70300,Asia,60,722,294.8469685,4264.77501,108.1666667,461306.4969,113,106,102,7,4,44,2,male
171,35900,Asia,83,641,446.3456778,4086.400275,85.53409091,349526.5327,117,92,81,25,11,31,3,male
124,100300,Asia,62,689,309.4603455,4102.441258,118.75,487164.8994,116,96,87,20,9,46,3,male
62,5800,Asia,50,584,244.1844343,3296.012015,24.81818182,81801.02546,141,95,70,46,25,36,2,male
93,68100,Asia,55,588,268.9081138,3399.439512,58.11764706,197567.4257,124,95,80,29,15,35,2,male
202,52800,Unknown,78,592,412.4094067,3720.958114,59.56097561,221623.8954,118,100,88,18,12,41,3,female
46,36000,Asia,72,550,372.2346001,3393.458751,45.5,154402.3732,136,124,118,12,6,40,2,male
77,54900,Asia,26,54,100.3621072,253.8237448,10.85714286,2755.800658,147,118,111,29,7,36,3,male
702,46100,Europe,90,846,495.8441109,5492.107719,60.65384615,333117.4567,125,101,97,24,4,43,5,male
93,71100,North America,66,616,333.3240179,3723.346778,94.2,350739.2664,114,71,54,43,17,23,2,male
218,74000,AsiaEurope,79,700,420.5488559,4412.646524,66.35869565,292817.4677,114,68,52,46,16,38,3,male
46,36800,Asia,90,812,494.5555318,5271.384714,91.4375,482002.2398,161,100,64,61,36,43,5,male
93,68100,Asia,68,764,347.4830616,4650.821611,68.57142857,318913.4819,165,138,138,27,0,50,2,male
139,83700,Unknown,63,618,313.8551855,3693.958993,89.10344828,329144.484,128,88,77,40,11,33,3,male
62,11600,Europe,93,901,516.8946117,5891.782089,98.94444444,582959.1056,138,107,100,31,7,46,5,male
124,82400,Asia,57,623,288.3207076,3633.890479,37.23076923,135292.5378,179,9,-10,170,19,2,1,male
140,113300,Asia,58,729,290.4773318,4270.468145,44.625,190569.641,202,173,170,29,3,52,3,male
108,84600,Asia,45,467,224.4867643,2564.695396,20,51293.90792,116,86,77,30,9,27,3,male
109,48700,Asia,33,90,140.0964047,453.9954707,15.625,7093.67923,103,76,68,27,8,25,4,female
202,71900,Asia,46,494,217.5786534,2728.639606,41.36363636,112866.4564,135,117,116,18,1,41,2,male
46,16500,AsiaEurope,78,662,412.4094067,4160.936269,85.87837838,357334.4593,111,87,82,24,5,37,4,male
61,11800,Europe,89,899,488.323496,5821.684354,104.91,610752.9056,138,107,100,31,7,46,5,male
124,56300,Asia,81,523,432.6080183,3315.741552,60.35714286,200128.6865,108,60,47,48,13,25,4,male
93,51800,Asia,92,698,508.2931913,4553.446245,62.72727273,285625.2645,128,91,70,37,21,32,8,male
93,69100,AsiaEurope,68,597,345.9899115,3634.215316,71.06060606,258249.5429,118,77,77,41,0,31,2,female
296,93900,Asia,76,691,399.4510684,4317.317912,71.64705882,309323.1304,125,110,106,15,4,40,4,male
46,13400,Asia,65,668,327.3557123,4022.941699,52.19642857,209983.189,123,105,102,18,3,32,2,male
46,37800,Asia,79,551,419.2271063,3473.383192,40.52380952,140754.7189,125,88,79,37,9,21,2,female
233,115100,Asia,74,697,385.5385456,4327.988996,55.94444444,242126.9399,164,131,126,33,5,39,3,male
186,83900,Asia,74,697,385.5385456,4327.988996,55.94444444,242126.9399,164,131,126,33,5,39,3,male
46,4800,Asia,109,831,633.6071054,5624.361174,66.625,374723.0632,111,76,70,35,6,36,7,male
62,18400,Asia,99,828,560.5441223,5489.107281,75.075,412094.7292,82,71,71,11,0,26,3,female
62,18400,Asia,99,828,560.5441223,5489.107281,75.075,412094.7292,82,71,71,11,0,26,3,female
78,6200,South America,90,735,494.5555318,4771.512026,51.1875,244241.7718,144,82,54,62,28,29,3,male
202,105800,Asia,46,612,223.4212455,3380.419917,47.5,160569.9461,149,104,96,45,8,36,6,male
124,83800,Asia,88,691,480.7253082,4463.467248,93.34042553,416621.9323,116,91,75,25,16,36,1,male
93,76000,Asia,117,764,689.0682556,5248.958646,47.19852941,247743.129,143,96,93,47,3,27,6,male
156,162000,Asia,0,0,0,0,0,0,113,89,89,24,0,32,2,male
124,119200,Asia,67,567,341.2590864,3439.472571,34.07407407,117196.8432,141,97,72,44,25,21,3,male
46,7800,Asia,90,685,496.8812252,4446.919371,77.66666667,345377.4045,125,75,39,50,36,33,2,male
62,11800,Asia,80,545,425.7903187,3445.450812,54.2195122,186810.6623,93,80,73,13,7,31,1,male
62,9100,Asia,79,577,419.2271063,3637.281492,82.2972973,299338.4363,121,110,110,11,0,33,4,male
93,34200,Asia,14,38,53.30296891,144.679487,0,0,105,60,54,45,6,31,3,male
140,166000,Asia,46,576,231.2692727,3181.571687,20.5,65222.21958,115,77,65,38,12,32,8,male
234,146500,Asia,87,730,473.6107211,4703.348752,93.33333333,438979.2169,120,86,75,34,11,31,8,male
46,5500,North America,83,518,446.1369639,3302.270425,43.02439024,142078.1715,95,58,47,37,11,20,1,female
233,4800,Unknown,53,520,253.6843594,2978.518636,54.57894737,162564.4119,113,102,95,11,7,30,1,female
93,64800,Asia,58,605,284.2247957,3544.078502,121.9090909,432055.3883,134,117,105,17,12,37,4,male
124,19500,Asia,52,672,276.0782,3830.695491,24,91936.69177,163,117,101,46,16,31,3,male
170,137500,Asia,67,679,339.5249056,4118.87456,62.890625,259038.5954,101,60,52,41,8,48,5,male
280,67500,AsiaEurope,67,722,339.9564924,4379.716396,107.9166667,472644.3943,132,77,64,55,13,33,4,male
46,7900,AsiaEurope,87,821,474.2088866,5289.65661,88.5625,468465.2135,140,0,-13,140,13,0,4,male
233,11500,Asia,44,523,220.8771238,2855.282737,20,57105.65473,92,67,61,25,6,35,3,male
873,194400,Asia,40,585,201.4212455,3113.327936,19,59153.23077,120,78,75,42,3,22,2,male
108,99300,Asia,69,825,353.0013311,5039.532677,63.12903226,318140.8209,99,75,75,24,0,51,2,male
93,70000,AsiaEurope,62,635,307.9068682,3780.914657,117.962963,446007.8957,113,104,99,9,5,39,2,male
217,208700,Asia,42,679,201.6270751,3661.38353,42,153778.1083,97,67,58,30,9,25,3,male
217,125300,Asia,43,479,205.7687845,2599.180818,20.57142857,53468.86253,107,84,84,23,0,28,5,male
46,5500,Europe,96,805,536.1564001,5300.894813,82.5,437323.8221,146,114,105,32,9,43,5,male
374,36500,South America,92,680,509.2999891,4436.02213,71.92307692,319052.3609,127,91,76,36,15,33,9,male
280,101900,AsiaEurope,64,654,320.7232379,3924,90,353160,103,96,92,7,4,48,2,male
108,87900,Asia,79,646,419.2271063,4072.242363,51.64864865,210325.815,118,102,99,16,3,37,3,male
436,91800,Asia,89,939,487.5430078,6080.713692,89.52380952,544368.6543,118,98,95,20,3,44,5,male
202,116900,Europe,62,682,307.9068682,4060.761884,117.962963,479019.5037,113,108,108,5,0,46,2,male
62,5300,Europe,53,734,253.6843594,4204.293614,125.2631579,526643.0948,103,85,80,18,5,41,1,male
77,52500,Asia,83,781,446.3456778,4978.905796,80.65909091,401594.0152,175,102,68,73,34,43,3,male
77,52500,Asia,83,781,446.3456778,4978.905796,80.65909091,401594.0152,175,102,68,73,34,43,3,male
124,82000,Asia,80,691,426.079159,4368.452314,63.24418605,276279.2109,172,113,90,59,23,39,3,male
62,45700,Asia,97,805,545.8935843,5312.929838,60.51724138,321523.8574,99,54,46,45,8,39,2,male
108,72000,South America,75,757,392.2479866,4715.215749,50.91666667,240083.0685,160,119,100,41,19,30,2,male
140,114200,AsiaEurope,58,639,283.5668306,3743.249856,103.4782609,387344.9851,117,90,81,27,9,38,2,male
108,42900,Europe,83,890,446.3456778,5673.785094,111.6818182,633658.6353,157,112,90,45,22,45,4,male
124,91400,North America,66,673,334.0271833,4067.877242,73.96428571,300877.6346,117,98,92,19,6,42,3,male
140,155400,Asia,43,479,201.5030616,2599.180818,18.88888889,49095.63766,147,125,114,22,11,37,4,male
93,72000,North America,67,824,341.2590864,4998.457493,65.92592593,329527.9384,135,99,95,36,4,41,3,male
61,7600,Europe,86,863,466.7930215,5545.866483,111.1555556,616453.87,120,80,77,40,3,38,1,male
140,5800,North America,66,725,334.0271833,4382.185737,43.42857143,190312.0663,155,102,81,53,21,27,3,male
93,68900,Europe,95,697,529.2046323,4579.189359,48.34693878,221389.7876,133,87,76,46,11,28,9,male
77,52100,AsiaEurope,72,816,372.2346001,5034.658801,97.5,490879.2331,147,94,71,53,23,50,2,male
77,36800,AsiaEurope,91,774,501.5981141,5037.033052,95.14285714,479237.716,129,99,88,30,11,42,6,male
265,13700,AsiaEurope,41,561,195.0346806,3005.586675,17.5,52597.76681,114,104,99,10,5,49,4,male
46,5800,AsiaEurope,95,679,530.4235573,4460.931958,90.35185185,403053.4634,118,91,85,27,6,33,4,male
77,84700,Asia,72,802,374.820929,4948.279851,122.5714286,606517.7303,123,84,62,39,22,52,8,male
62,13800,Europe,63,669,323.5707183,3998.800269,52.76470588,210995.5201,126,82,72,44,10,17,5,female
93,68000,Europe,90,792,494.2667787,5141.547652,52.5,269931.2517,143,79,43,64,36,38,9,male
389,201400,Asia,80,796,426.079159,5032.254764,92.97297297,467863.6861,121,96,94,25,2,40,7,male
92,68100,AsiaAfrica,67,785,340.7366244,4761.880015,106.5535714,507395.3223,177,120,99,57,21,50,8,male
202,4100,Europe,63,602,313.8551855,3598.322514,62.72413793,225701.6777,137,117,103,20,14,40,2,male
92,55400,Asia,87,626,474.5420279,4033.282628,50.02040816,201746.4433,129,90,74,39,16,34,3,male
139,121800,Asia,43,591,208.2595495,3206.92247,18.5,59328.0657,107,77,75,30,2,53,2,male
327,194900,Asia,92,765,508.1677,4990.524896,81,404232.5166,175,150,130,25,20,43,4,male
46,6600,South America,82,611,440.5905816,3884.464275,64.04255319,248771.0099,116,82,67,34,15,25,2,male
61,6500,South America,67,641,339.9564924,3888.363171,30.21666667,117493.3738,104,83,79,21,4,39,7,male
124,8800,Unknown,102,680,580.4053244,4537.249233,50.28813559,228169.8046,106,81,75,25,6,21,3,male
62,42700,AsiaEurope,114,943,667.4936518,6443.415283,89.79104478,578560.9902,114,93,90,21,3,54,6,male
202,57800,Europe,79,700,419.0808777,4412.646524,43.69736842,192821.0409,123,74,52,49,22,30,3,male
108,82500,Europe,94,749,522.1313521,4909.38705,54,265106.9007,117,99,93,18,6,20,8,male
77,37900,AsiaAfrica,70,729,359.2147805,4468.247319,90.52702703,404497.1458,120,96,82,24,14,43,5,male
77,39100,Asia,87,564,473.9427998,3633.820132,41.27659574,149991.7246,108,78,78,30,0,20,2,male
124,37100,Asia,94,704,522.6230769,4614.430552,69.1372549,319029.0613,111,64,47,47,17,31,3,male
77,52500,Asia,69,592,355.5408171,3616.246478,35.55769231,128585.3796,146,72,55,74,17,17,3,male
77,52500,Asia,69,592,355.5408171,3616.246478,35.55769231,128585.3796,146,72,55,74,17,17,3,male
265,91400,Asia,103,860,586.8962871,5750.390453,80.30172414,461766.2679,142,96,79,46,17,29,4,male
249,73900,Asia,77,584,405.551932,3659.80334,62.35897436,228221.5826,127,66,54,61,12,30,4,male
124,97600,Asia,60,621,294.8469685,3668.17906,103.8888889,381083.0468,110,105,105,5,0,43,2,male
61,6600,North America,89,753,489.1726399,4876.227274,80.40384615,392067.4275,117,101,93,16,8,32,3,male
77,55500,Unknown,92,869,508.1990654,5668.97534,103.9222222,589132.515,137,95,81,42,14,47,6,male
61,12800,Asia,82,699,439.3192644,4443.928851,100.5,446614.8495,100,85,78,15,7,36,2,male
218,104100,AsiaEurope,61,699,301.7363383,4145.585399,102.9807692,426915.5733,130,90,77,40,13,46,3,male
78,69000,Asia,24,140,96.99355338,641.8947501,14,8986.526501,110,81,75,29,6,41,3,male
108,84600,Asia,67,679,339.5249056,4118.87456,86.953125,358149.0145,117,82,61,35,21,28,2,male
108,84600,Asia,67,679,339.5249056,4118.87456,86.953125,358149.0145,117,82,61,35,21,28,2,male
124,114100,Europe,59,697,290.8572701,4100.202205,105.1136364,430987.1636,153,118,118,35,0,49,4,male
93,56300,Asia,96,830,537.6344164,5465.518876,43.98181818,240383.4575,130,88,80,42,8,37,5,male
77,8200,South America,87,650,473.7434822,4187.913272,46.79347826,195967.0287,126,75,51,51,24,32,2,male
171,66500,AsiaEurope,91,605,501.5981141,3937.215757,56.14285714,221046.5418,119,73,59,46,14,25,2,male
139,114900,Asia,53,660,256.7497745,3780.4275,33.53125,126762.4596,119,74,63,45,11,40,2,female
139,114900,Asia,53,660,256.7497745,3780.4275,33.53125,126762.4596,119,74,63,45,11,40,2,female
124,114900,Asia,50,567,255.7247662,3200.06646,22,70401.46211,161,131,125,30,6,30,3,male
124,85100,AsiaEurope,42,642,204.359415,3461.867785,37,128089.1081,162,84,47,78,37,36,3,male
187,133200,Asia,81,652,432.75063,4133.582202,64.5,266616.052,111,73,56,38,17,36,2,male
249,178600,Asia,56,647,281.4351008,3757.358635,29.76923077,111853.6763,159,118,107,41,11,29,2,male
265,107600,Unknown,50,524,238.1282645,2957.380643,36.16666667,106958.5999,137,106,105,31,1,30,3,male
108,100600,Asia,83,842,446.3456778,5367.783201,67.36363636,361593.3956,105,83,75,22,8,45,3,male
92,75300,Asia,91,883,501.8524417,5746.382667,50.43,289790.0779,107,65,48,42,17,41,3,male
109,12700,Asia,76,800,399.4510684,4998.342011,93.5,467344.978,105,82,70,23,12,42,2,male
390,148600,Asia,53,597,260.9828401,3419.568511,46.15384615,157826.239,141,118,114,23,4,42,2,male
46,6600,Asia,88,738,480.9553238,4767.060535,89.16666667,425062.8977,111,94,89,17,5,29,2,male
249,124800,Asia,66,703,334.0271833,4249.209066,101.7857143,432508.7799,130,81,59,49,22,34,2,male
155,145100,Asia,92,776,508.1990654,5062.284078,78.5106383,397443.1542,156,92,66,64,26,36,7,male
61,11800,Asia,116,842,683.7654348,5774.419998,55.77464789,322066.2421,126,82,64,44,18,47,9,male
249,124800,Asia,66,703,334.0271833,4249.209066,101.7857143,432508.7799,131,80,57,51,23,34,2,male
62,9500,Asia,90,1013,495.0699333,6576.247187,114.4,752322.6781,132,91,87,41,4,45,1,male
93,55600,Asia,130,1028,792.8737601,7218.994112,83.65116279,603877.2516,137,94,82,43,12,38,7,male
202,37100,Asia,92,665,508.9533246,4338.168701,75.97058824,329573.2281,125,83,67,42,16,30,2,male
62,9500,Europe,73,798,378.8670746,4939.479998,104.3194444,515283.8092,97,84,84,13,0,43,3,male
93,68100,Antarctica,63,543,314.1308434,3245.662998,90.625,294138.2092,130,86,74,44,12,39,4,male
77,71900,Asia,60,538,295.6213103,3177.90714,61.6,195759.0799,106,68,64,38,4,34,2,male
77,65400,Asia,73,675,379.1044231,4178.131577,48.75,203683.9144,132,88,72,44,16,40,2,male
62,13400,Asia,71,640,365.7235111,3935.838156,94.67647059,372631.2655,95,77,64,18,13,33,1,male
93,71000,AsiaAfrica,68,680,346.6279634,4139.474732,102.6,424710.1075,114,91,84,23,7,39,4,male
109,99400,Asia,81,744,432.536756,4716.848402,41.46341463,195576.6411,121,91,91,30,0,36,3,male
46,5600,Asia,69,571,352.582306,3487.967465,68.72727273,239718.4912,118,81,67,37,14,26,2,female
140,64500,Asia,66,559,335.0885565,3378.816313,63.07692308,213125.3366,188,122,85,66,37,31,5,male
233,51700,Asia,81,856,434.0394126,5426.911602,117.5531915,637950.7788,89,73,69,16,4,43,3,male
62,37800,Asia,83,627,446.3456778,3997.149723,67.36363636,269262.5405,118,58,44,60,14,26,2,male
62,5500,North America,84,584,453.092115,3733.113375,68.63636364,256227.3271,142,96,72,46,24,30,1,male
61,67200,Asia,80,768,425.7903187,4855.240777,122.474359,594642.5018,104,91,91,13,0,39,3,male
249,162100,Asia,64,537,321.6326782,3222,89.15384615,287253.6923,132,90,73,42,17,29,3,male
233,39800,Asia,134,1097,819.147473,7751.499842,108.6309524,842052.8102,150,127,125,23,2,56,12,male
233,39800,Asia,134,1097,819.147473,7751.499842,108.6309524,842052.8102,150,127,125,23,2,56,12,male
61,13900,AsiaEurope,67,682,340.7366244,4137.072828,90.53571429,374552.8435,141,100,65,41,35,37,4,male
77,37800,AsiaAfrica,80,861,425.8985773,5443.18009,115.3571429,627909.7032,93,85,85,8,0,60,2,male
124,183600,Unknown,37,297,171.6096405,1547.20765,22.4,34657.45135,111,73,66,38,7,37,2,male
93,71900,Asia,81,687,434.0394126,4355.476952,78.79411765,343185.9634,123,98,96,25,2,47,8,male
124,90600,Asia,43,625,211.030886,3391.415472,30.4,103099.0303,143,102,83,41,19,44,2,male
62,36800,North America,92,753,509.2999891,4912.242153,55.38461538,272062.6423,148,89,83,59,6,28,2,male
390,101200,Asia,72,904,372.2746801,5577.612201,112.5857143,627959.4537,87,76,76,11,0,38,2,male
124,113800,Europe,62,536,310.1726115,3191.449222,28.82608696,91996.9928,121,85,76,36,9,44,2,male
61,6600,Asia,32,194,145.6363364,970,14.5,14065,103,67,63,36,4,22,4,male
61,9800,Europe,77,688,405.6268983,4311.54914,93.8875,404800.5699,113,95,83,18,12,40,2,male
265,61700,AsiaAfrica,89,755,487.3483806,4889.17874,57.68888889,282051.2891,126,68,50,58,18,23,4,male
62,31300,Europe,42,520,201.6270751,2804.00506,18,50472.09108,158,76,28,82,48,30,3,female
62,9500,Asia,80,834,425.7903187,5272.488031,53.26829268,280856.4356,118,71,51,47,20,35,2,male
124,91500,Asia,49,475,251.8246317,2666.987176,26.4,70408.46145,174,117,84,57,33,23,3,male
61,37800,AsiaEurope,87,694,473.9427998,4471.402786,76.59574468,342490.4262,126,71,43,55,28,30,4,male
93,69100,Asia,89,681,487.5430078,4409.974466,61.21276596,269946.7349,140,80,64,60,16,28,5,male
62,21100,Asia,99,1007,557.6636341,6675.762116,60.75471698,405584.038,96,77,75,19,2,62,9,female
62,18000,Unknown,65,919,331.4368801,5534.55602,199.3636364,1103389.214,142,108,87,34,21,33,6,male
108,88000,Europe,77,597,405.551932,3741.271565,37.51282051,140345.6487,130,73,51,57,22,34,5,male
156,121300,Europe,49,728,234.2230164,4087.508767,36,147150.3156,104,73,71,31,2,39,3,male
93,91500,Asia,44,556,220.8771238,3035.44398,20,60708.8796,116,93,91,23,2,25,2,male
249,67400,Europe,84,629,453.092115,4020.767659,48.63636364,195555.518,137,86,74,51,12,25,3,female
140,121800,Asia,105,890,601.1597899,5975.678511,77.96610169,465900.3585,112,83,83,29,0,37,10,female
187,13600,Asia,99,804,558.1897755,5330.002723,94.4,503152.257,113,92,85,21,7,44,4,male
295,177500,Asia,78,585,412.2613731,3676.960298,48.5,178332.5745,121,101,92,20,9,39,4,male
109,94800,Asia,103,711,591.6797864,4754.101875,46.81060606,222542.39,157,97,65,60,32,24,5,male
202,53400,Asia,77,550,405.7769322,3446.732597,48.40277778,166831.432,149,107,96,42,11,38,4,male
592,40800,Asia,81,706,432.6080183,4475.934102,47.82142857,214045.563,106,70,65,36,5,35,2,male
467,113600,AsiaEurope,84,857,453.092115,5478.216031,108.1818182,592643.3707,154,104,81,50,23,45,4,male
61,18000,Unknown,66,925,337.3713094,5591.06456,194.4347826,1087097.422,143,109,88,34,21,33,6,male
124,88400,Asia,79,795,419.0078103,5011.505695,132.8205128,665630.7564,110,90,84,20,6,35,5,male
93,69600,AsiaEurope,115,1468,676.8470367,10049.17939,236.4225352,2375852.469,98,70,66,28,4,57,12,male
61,5700,Europe,68,607,348.6887644,3695.089945,45.23076923,167131.7606,99,70,66,29,4,26,1,male
46,5600,Asia,67,556,340.7366244,3372.74559,96.80357143,326493.8186,119,57,46,62,11,25,2,male
62,48900,Asia,97,745,544.8715078,4916.935067,83.46428571,410388.4733,115,86,78,29,8,35,2,male
46,13600,AsiaEurope,65,759,326.9987489,4570.97717,114.2068966,522037.1168,104,97,93,7,4,46,2,male
186,154000,Asia,58,696,284.2247957,4077.154773,67.90909091,276875.8741,152,123,118,29,5,53,2,male
171,154000,Asia,58,696,284.2247957,4077.154773,67.90909091,276875.8741,152,123,118,29,5,53,2,male
592,114300,North America,85,663,459.8067162,4249.426191,60.55813953,257337.3442,145,79,51,66,28,41,6,male
234,4900,North America,68,550,346.1173001,3348.104563,38.25,128064.9995,101,77,72,24,5,33,1,male
46,6200,Unknown,85,841,460.2145365,5390.297777,107.673913,580394.4542,125,111,106,14,5,45,4,male
62,5800,Asia,92,793,509.7104706,5173.184631,68.80188679,355924.8633,130,85,72,45,13,41,2,male
78,48900,Europe,94,773,523.6410489,5066.697182,85.92592593,435360.6468,157,88,49,69,39,41,3,male
46,19500,Europe,62,638,308.8461793,3798.777246,100.64,382308.942,94,80,73,14,7,33,2,male
77,18400,Asia,103,1177,586.8962871,7870.01112,198.2327586,1560094.015,100,71,62,29,9,49,10,male
265,83900,Asia,65,617,327.8032081,3715.800941,71.77777778,266711.9342,158,149,146,9,3,37,2,female
77,52500,Asia,69,555,353.3374044,3390.231074,65,220365.0198,134,101,94,33,7,29,2,male
234,138800,Asia,80,799,426.3322913,5051.220548,56.22222222,283990.8441,117,81,70,36,11,43,5,male
77,23800,Asia,57,705,288.3207076,4112.18746,25.38461538,104386.2971,154,90,71,64,19,30,5,male
109,70700,AsiaEurope,65,698,326.7316235,4203.612733,85.16666667,358007.6845,143,109,100,34,9,42,2,male
46,4100,Europe,71,636,365.7235111,3911.239168,85.97058824,336251.532,117,99,90,18,9,39,3,female
46,5800,Unknown,81,666,433.2506894,4222.340102,60,253340.4061,101,65,58,36,7,37,5,male
140,6300,Asia,65,609,330.5192567,3667.621998,35.60869565,130599.2355,199,115,59,84,56,37,5,male
77,38800,Asia,75,707,392.17102,4403.774814,90.89189189,400267.4243,135,108,99,27,9,43,2,male
61,5900,Asia,33,147,134.0135917,741.5259355,21.03571429,15598.52772,86,66,64,20,2,40,1,female
468,162100,Asia,97,1125,547.1632103,7424.901947,81.70833333,606676.3633,85,77,73,8,4,59,2,male
77,28500,Asia,47,694,232.5286082,3854.884663,28.57142857,110139.5618,100,87,81,13,6,49,3,male
218,80300,Asia,54,540,278.08385,3107.639251,46,142951.4056,129,83,66,46,17,34,6,male
62,8700,North America,79,758,419.4466845,4778.265807,71.58139535,342034.9338,124,80,60,44,20,50,6,male
77,15400,Asia,0,0,0,0,0,0,187,154,145,33,9,50,4,female
77,52600,Asia,100,1243,565.1081736,8258.313244,138.2727273,1141899.495,114,99,93,15,6,60,2,male
140,129700,Asia,46,544,221.2790995,3004.817704,24.66666667,74118.8367,117,86,76,31,10,32,2,male
61,13600,Asia,97,967,543.7947753,6382.115718,106.2641509,678190.108,150,128,121,22,7,62,8,male
46,13600,Asia,97,967,543.7947753,6382.115718,106.2641509,678190.108,150,128,121,22,7,62,8,male
93,99500,Europe,61,673,302.2137048,3991.386228,70.56,281632.2123,121,90,80,31,10,41,2,male
124,97600,Asia,73,665,385.1598824,4116.233332,44.91666667,184887.4805,143,114,114,29,0,40,7,male
93,68100,Asia,76,610,398.842491,3811.235783,39,148638.1955,124,98,92,26,6,22,2,male
327,75200,AsiaEurope,73,676,379.1044231,4184.321402,92.33823529,386372.8541,113,98,95,15,3,46,2,male
171,9200,Asia,71,712,366.1306865,4378.619949,83.69230769,366456.808,110,108,108,2,0,36,1,male
234,13200,Asia,60,529,295.1851693,3124.745125,28.76923077,89896.5136,140,112,86,28,26,39,1,male
62,37300,Asia,120,1035,715.8719481,7148.631766,77.06493506,550908.8429,117,86,76,31,10,47,5,male
623,153500,Asia,82,584,439.460071,3712.810371,35.83333333,133042.3716,119,77,75,42,2,29,3,male
78,5800,Asia,51,674,255.0066568,3823.21468,32.66666667,124891.6796,181,124,97,57,27,25,2,male
140,99900,Asia,68,570,352.1913456,3469.85382,36.59090909,126965.1057,133,83,66,50,17,26,4,male
46,13500,Asia,92,691,508.9533246,4507.781312,42.20588235,190254.8877,158,119,109,39,10,30,3,female
77,68200,Asia,65,557,331.4368801,3354.458872,73.29545455,245866.5878,147,109,91,38,18,36,3,male
62,42900,Europe,117,932,693.6387335,6403.179919,75.88,485873.2922,116,70,65,46,5,38,3,male
1387,95800,Asia,49,502,239.3499675,2818.584342,23.4,65954.8736,147,125,122,22,3,31,2,male
139,36900,Asia,18,56,75.05865003,233.5158001,0,0,144,126,125,18,1,40,4,male
483,134800,AsiaEurope,71,676,366.1306865,4157.229053,46.3125,192531.6705,126,108,107,18,1,39,3,male
62,9900,Australia,72,726,372.8771238,4479.365551,88.125,394744.0892,134,105,83,29,22,40,3,male
93,42800,North America,76,1009,398.842491,6304.158861,123,775411.5399,134,99,95,35,4,49,2,male
62,36900,Asia,19,40,63.61549134,169.9171005,10.83333333,1840.768589,128,98,89,30,9,32,3,male
93,74000,Asia,58,719,285.8598074,4211.888335,34.2,144046.5811,119,99,97,20,2,48,2,male
124,103200,Asia,89,914,487.4132344,5918.820356,119.1847826,705433.3174,147,104,93,43,11,44,5,male
77,59400,Asia,92,680,508.2931913,4436.02213,50.41666667,223649.4491,141,72,41,69,31,30,5,female
62,47500,Asia,82,859,439.6362367,5461.137172,111.8409091,610778.546,107,75,67,32,8,53,3,male
967,161800,Asia,47,728,238.0869722,4043.740684,21,84918.55436,160,136,131,24,5,44,6,male
156,122600,Asia,93,805,515.5221939,5264.022843,77.4,407435.368,131,115,115,16,0,42,7,male
108,84600,Asia,60,704,305.7367483,4158.450979,39,162179.5882,125,82,78,43,4,35,4,male
46,7800,Asia,76,796,401.9471249,4973.350301,49.43103448,245837.8502,204,167,158,37,9,39,3,male
140,25700,Asia,75,890,392.2479866,5543.648635,70.61538462,391466.8805,118,78,78,40,0,45,5,male
187,70200,Asia,71,831,365.6422056,5110.439856,137.0833333,700556.1303,136,95,76,41,19,45,7,male
202,34200,Asia,84,688,454.1955001,4397.914387,64.125,282016.2601,118,100,93,18,7,45,3,male
155,116000,Asia,86,859,466.9609738,5520.161424,55.2,304712.9106,111,58,51,53,7,44,7,male
46,13000,Europe,92,812,508.4501668,5297.132308,96.09183673,509011.1729,152,96,85,56,11,37,3,male
217,88200,Asia,82,745,440.5905816,4736.376243,75.21276596,356235.9579,105,93,90,12,3,44,2,male
62,36000,Asia,85,750,459.8746234,4807.043202,71.90243902,345638.1307,112,53,52,59,1,31,7,male
451,119900,Asia,67,779,341.2590864,4725.483479,78.51851852,371037.9621,185,163,154,22,9,42,4,male
108,94400,AsiaAfrica,74,824,385.5385456,5116.589573,94.26315789,482305.8908,146,130,130,16,0,51,6,male
61,12100,AsiaEurope,84,792,453.092115,5062.715399,70.90909091,358992.5465,138,100,90,38,10,42,3,male
218,17700,Asia,84,1003,453.092115,6411.494375,129.5454545,830579.9531,154,127,111,27,16,50,4,male
124,119200,Asia,87,665,474.2088866,4284.557425,57.84615385,247845.168,173,98,46,75,52,48,8,male
140,33200,Asia,88,736,482.043467,4754.141671,73.6372549,350081.9421,132,95,71,37,24,40,6,male
77,39800,Asia,80,732,426.3322913,4627.651365,63,291542.036,141,91,70,50,21,46,3,male
280,40500,AsiaEurope,66,815,335.0885565,4926.181207,140,689665.369,132,110,103,22,7,51,3,male
77,9500,Asia,68,822,351.1753143,5003.894456,45.97826087,230070.3646,170,131,120,39,11,33,2,male
62,9200,North America,71,678,365.6422056,4169.528547,85.55555556,356726.3312,127,94,79,33,15,35,4,male
155,11800,Asia,67,722,340.3026944,4379.716396,29.48275862,129126.1213,162,96,70,66,26,31,1,male
46,6800,Europe,74,616,385.5385456,3825.023273,59.11111111,226101.3757,118,103,95,15,8,39,1,male
77,69000,AsiaEurope,89,882,487.4132344,5711.596886,57.95652174,331024.2891,132,89,88,43,1,33,2,male
124,116500,Europe,102,908,581.4346098,6058.562211,83.00819672,502910.3238,197,88,17,109,71,48,3,male
124,72100,Asia,68,795,346.6279634,4839.532959,91.2,441365.4058,151,100,74,51,26,35,6,male
109,68100,Asia,56,624,275.6175548,3623.789471,30.97058824,112230.8916,155,96,93,59,3,28,5,male
109,68100,Asia,56,624,275.6175548,3623.789471,30.97058824,112230.8916,155,96,93,59,3,28,5,male
327,106400,Europe,50,536,250.4773318,3025.106918,21,63527.24527,136,82,60,54,22,24,4,male
124,4500,Europe,71,757,366.8663501,4655.358569,49.2,229043.6416,112,89,86,23,3,42,5,male
109,71100,Europe,56,700,273.4603973,4065.148445,49.65789474,201866.7136,126,89,76,37,13,31,4,female
93,67500,Europe,53,534,254.5835556,3058.709523,22.36111111,68396.14349,157,70,26,87,44,37,2,male
265,87600,Asia,51,680,242.4606049,3857.249233,38,146575.4708,154,117,115,37,2,37,2,male
202,4600,Asia,52,440,245.3142135,2508.193476,53.86363636,135100.4213,109,103,99,6,4,34,1,male
139,77400,North America,58,625,303.6501074,3661.238122,32.66666667,119600.4453,131,90,89,41,1,31,4,male
62,6600,Europe,53,740,271.1333893,4238.661136,39.375,166897.2822,106,77,70,29,7,47,7,male
124,106900,Asia,76,590,399.1845378,3686.277233,49.51219512,182515.6776,113,60,43,53,17,32,3,male
77,36900,Asia,90,756,496.8812252,4907.840941,78.33333333,384447.5404,115,44,37,71,7,21,4,female
93,68000,Asia,83,486,446.1369639,3098.269164,43.92857143,136102.5383,88,68,66,20,2,40,13,male
171,37000,North America,78,725,412.85429,4556.916609,87.5,398730.2033,121,98,88,23,10,34,5,male
342,85300,Europe,102,878,579.2957256,5858.38945,56.26785714,329639.0207,153,104,88,49,16,31,8,male
109,74900,Asia,67,640,340.3026944,3882.297082,65.51724138,254357.395,159,132,130,27,2,44,2,male
405,37000,Asia,81,655,432.9647657,4152.601752,42.88636364,178089.9888,152,123,115,29,8,23,3,male
233,72200,Asia,80,694,426.079159,4387.418098,90.06756757,395164.076,120,85,73,35,12,41,2,male
779,99700,Asia,47,519,235.1694072,2882.831614,37.58333333,108346.4215,135,105,105,30,0,36,2,male
311,115000,Asia,71,710,369.344822,4366.320455,38.07692308,166256.0481,139,112,112,27,0,44,5,male
93,79000,Asia,89,656,487.7378322,4248.081131,53.8125,228599.8658,141,117,117,24,0,35,3,male
78,6600,AsiaEurope,70,862,359.0910367,5283.441961,131.8235294,696481.9667,150,122,113,28,9,43,3,male
358,155000,Asia,0,0,0,0,0,0,224,173,148,51,25,51,4,male
77,55400,Asia,92,1002,508.6701412,6536.60908,72.66,474950.0158,136,91,90,45,1,42,3,male
93,99800,AsiaEurope,77,714,406.0022373,4474.48559,96.6,432235.308,133,93,74,40,19,41,3,male
186,122700,Asia,0,0,0,0,0,0,142,125,119,17,6,71,3,male
46,25500,Asia,95,859,532.5126722,5643.505968,84.20689655,475222.1232,141,98,88,43,10,44,5,male
421,177800,Asia,77,962,406.0022373,6028.648652,108.6,654711.2436,211,168,149,43,19,58,7,male
404,14500,Asia,49,532,234.2230164,2987.025637,23.53846154,70309.98807,141,83,34,58,49,30,2,male
451,166200,Asia,84,798,453.2640759,5101.069303,87.69230769,447324.5389,161,127,113,34,14,42,7,male
46,6200,North America,88,697,480.5611817,4502.223838,81.5952381,367360.026,122,86,78,36,8,33,1,male
108,36100,Asia,100,881,565.8041153,5853.237303,77.3245614,452599.0073,133,112,107,21,5,52,8,female
78,4000,Europe,79,679,419.4466845,4280.267128,45.98611111,196832.8397,124,44,31,80,13,22,1,male
62,37300,Asia,120,1035,715.8719481,7148.631766,77.06493506,550908.8429,117,86,76,31,10,47,5,male
93,29600,Asia,80,803,428.0782,5076.50826,110.25,559685.0357,107,80,80,27,0,37,6,male
62,8100,AsiaEurope,84,704,452.9546635,4500.191466,59.5,267761.3922,124,80,64,44,16,42,7,male
139,130400,AsiaEurope,83,822,446.3456778,5240.282413,92.625,485381.1585,130,100,90,30,10,45,3,male
93,75000,Asia,85,671,460.4869215,4300.701318,53.76595745,231231.3241,144,83,65,61,18,40,2,male
249,61400,Asia,45,778,224.4867643,4272.661709,20,85453.23418,123,81,72,42,9,25,2,male
140,122700,Asia,48,580,239.3111166,3239.27825,29.28571429,94864.57733,159,122,109,37,13,59,8,male
140,97500,Asia,81,783,432.6080183,4964.102552,73.76923077,366198.0267,165,107,92,58,15,39,5,male
46,6100,Asia,40,571,197.504662,3038.820942,18.5,56218.18743,135,102,92,33,10,32,3,male
187,14000,Asia,73,842,379.6596322,5211.832279,151.1875,787963.8926,118,106,100,12,6,51,4,male
217,71000,Asia,97,909,544.452116,5999.320774,65.67272727,393991.757,146,85,73,61,12,40,4,male
951,152500,Asia,80,783,425.8985773,4950.069698,74.60526316,369301.2525,164,107,93,57,14,39,5,male
108,98900,AsiaEurope,72,721,372.3949821,4448.515926,79.91176471,355488.758,134,81,73,53,8,42,2,female
109,86700,Asia,81,957,432.536756,6067.236453,62.43902439,378832.3249,167,109,99,58,10,52,5,male
46,5800,Asia,82,806,439.6362367,5124.186916,92.05263158,471694.8903,171,138,121,33,17,44,5,male
109,87500,South America,94,982,524.6331211,6436.606252,71.92857143,462975.8926,227,167,133,60,34,62,6,male
311,101900,AsiaEurope,74,815,385.5385456,5060.704493,111.3611111,563565.6753,116,100,93,16,7,48,3,female
46,5800,AsiaEurope,68,758,346.6279634,4614.296834,96.9,447125.3632,125,108,102,17,6,42,2,male
93,76000,Asia,76,988,399.7943904,6172.952383,68.68604651,423995.6945,90,72,62,18,10,54,2,male
62,9500,Asia,72,1008,372.5956925,6219.284401,177.2727273,1102509.508,157,136,121,21,15,56,4,male
108,84600,Europe,71,778,365.7235111,4784.503259,114.2647059,546699.8577,116,96,91,20,5,51,3,male
171,138500,Asia,57,616,280.1318683,3593.060249,49,176059.9522,169,101,95,68,6,26,3,male
93,92500,Asia,59,647,293.5877466,3806.070053,72.63157895,276440.8775,171,106,68,65,38,33,3,male
93,67100,Asia,72,566,378.1173001,3492.177551,34,118734.0367,147,97,80,50,17,36,4,male
93,87700,Asia,85,806,460.0105131,5165.969095,76.44444444,394909.6374,143,93,61,50,32,40,7,male
109,42900,AsiaEurope,70,642,361.0832696,3934.999697,77.25,303978.7266,134,90,72,44,18,33,4,male
108,99900,Asia,111,828,646.642967,5625.776337,71.25373134,400857.5557,134,60,50,74,10,33,3,male
109,84300,Europe,74,549,385.5385456,3408.989898,37.89473684,129182.7751,131,92,91,39,1,32,4,male
93,37200,AsiaEurope,81,752,432.75063,4767.567202,94.11627907,448705.6853,144,86,57,58,29,39,5,male
171,10100,Australia,78,621,412.5946318,3903.234778,53.14285714,207429.0482,131,102,93,29,9,22,2,male
93,52500,AsiaEurope,63,587,313.6717238,3508.663315,53.9,189116.9527,146,117,116,29,1,39,2,male
77,64800,AsiaEurope,73,721,378.8670746,4462.863507,89.51351351,399486.5928,123,88,82,35,6,36,3,male
46,19400,AsiaEurope,84,563,452.9546635,3598.874709,49.5,178144.2981,149,85,64,64,21,21,3,male
46,5800,Asia,79,916,419.4466845,5774.263165,94.95833333,548314.4064,162,133,116,29,17,43,3,male
108,98400,Asia,74,728,386.1246381,4520.48205,84.48484848,381912.2411,130,73,47,57,26,34,4,male
46,7900,Asia,66,561,335.0885565,3390.905101,51.53846154,174762.0321,127,104,102,23,2,36,2,male
93,52500,Africa,86,678,467.4994455,4357.007504,59.77083333,260421.9693,142,106,97,36,9,34,3,male
763,193000,Asia,73,759,379.6596322,4698.07684,41,192621.1504,129,79,70,50,9,37,3,male
108,85300,Asia,87,931,473.5443757,5998.380395,122.7906977,736545.3136,123,93,89,30,4,31,3,male
202,6700,Asia,57,663,282.3639921,3867.206079,29.41176471,113741.3553,127,81,79,46,2,25,1,male
186,13500,Asia,58,624,283.0128366,3655.380141,50.29166667,183835.1596,94,92,92,2,0,45,1,male
124,103700,Unknown,87,848,473.5443757,5463.616084,74.27272727,405797.6674,117,91,85,26,6,33,4,male
358,126400,Asia,85,827,459.8746234,5300.566304,53.65853659,284420.631,178,93,57,85,36,27,3,male
77,57400,Europe,111,883,643.2386559,5999.46921,61.22222222,367300.8372,148,2,-3,146,5,2,2,male
77,57400,Europe,111,883,643.2386559,5999.46921,61.22222222,367300.8372,148,2,-3,146,5,2,2,male
93,8700,Asia,60,685,295.6213103,4046.220058,83.3,337050.1308,110,103,100,7,3,35,1,male
62,6600,Europe,78,794,412.2983693,4990.609362,105.925,528630.2966,129,102,88,27,14,41,5,male
46,15600,AsiaEurope,84,751,453.8154506,4800.630385,84.23404255,404376.5041,129,95,78,34,17,29,5,male
202,19500,Europe,75,859,392.17102,5350.555255,86.17105263,461062.9785,120,116,116,4,0,50,2,male
93,68000,Europe,85,787,460.4869215,5044.190667,104.2978723,526098.3542,109,81,74,28,7,45,3,male
358,102700,Asia,47,655,232.5286082,3638.255698,25.71428571,93555.14652,173,129,118,44,11,33,2,male
311,121900,Asia,78,799,412.4094067,5022.036373,36.54878049,183549.305,184,147,141,37,6,56,6,male
93,72100,Antarctica,89,792,487.7378322,5128.780877,87.97916667,451225.8676,117,102,94,15,8,48,6,male
109,86700,Asia,64,968,321.6326782,5808,145.4230769,844617.2308,135,113,110,22,3,42,6,male
109,5200,Europe,67,723,339.6973857,4385.782485,72.58064516,318322.9223,132,109,92,23,17,38,2,male
108,68000,AsiaEurope,67,584,339.6973857,3542.596087,91.16129032,322947.6304,122,75,57,47,18,36,5,male
109,4400,North America,67,681,339.6973857,4131.006739,95.22580645,393378.4481,101,93,89,8,4,37,2,male
109,76600,Asia,0,0,0,0,0,0,126,90,87,36,3,29,7,male
436,120000,Asia,66,599,340.5224119,3620.592077,36.8,133237.7885,143,110,95,33,15,41,5,male
124,99400,Asia,61,881,309.7018595,5224.979594,130.7058824,682935.5682,178,124,120,54,4,48,4,male
327,81700,Asia,88,641,480.4299824,4140.495668,70,289834.6967,134,88,65,46,23,25,4,male
248,98400,Asia,85,827,460.0105131,5300.566304,103.5,548608.6125,129,77,61,52,16,30,6,male
171,150700,Europe,81,925,433.6087556,5864.361253,118.9428571,697523.8827,166,147,146,19,1,51,11,male
1872,193700,Asia,70,642,366.1856956,3934.999697,49.09090909,193172.7124,173,131,107,42,24,38,6,male
93,72300,Asia,94,589,522.9001971,3860.652834,64.21153846,247898.4579,84,58,58,26,0,49,10,male
46,9400,AsiaEurope,110,845,640.424805,5730.248958,71.95588235,412325.1199,137,101,92,36,9,37,4,male
77,88000,Asia,63,683,314.9612072,4082.482188,78.26923077,319532.7405,130,104,93,26,11,46,2,female
109,115400,Europe,93,868,515.7710242,5675.989848,51.47058824,292146.5363,161,95,83,66,12,38,2,male
171,84800,Asia,56,673,285.1871371,3908.349863,32.72727273,127909.6319,141,105,97,36,8,40,7,male
156,106200,Asia,48,530,232.6405265,2960.030125,28.5,84360.85857,183,132,103,51,29,42,5,male
61,10300,Asia,71,673,371.104776,4138.779811,42.10416667,174259.875,124,81,68,43,13,32,6,male
1060,44900,Asia,85,770,459.8067162,4935.231021,54.77380952,270321.4039,126,84,71,42,13,39,4,male
249,185100,South America,72,986,372.8771238,6083.546051,73.6,447748.9894,197,150,130,47,20,45,2,male
46,21300,Asia,91,823,501.4075845,5355.914989,101.6770833,544573.8147,130,104,95,26,9,39,9,male
1216,161900,Asia,85,902,460.8279746,5781.270624,86.27027027,498751.7793,156,117,112,39,5,54,7,male
249,13700,Asia,80,867,425.8985773,5481.111658,120.7857143,662039.9867,142,114,97,28,17,48,7,male
108,61300,Asia,95,791,533.19324,5196.755786,69.25423729,359897.3583,141,98,84,43,14,41,3,male
93,20200,Europe,57,708,277.6324012,4129.68613,84.31818182,348207.626,121,89,64,32,25,37,2,male
77,42700,AsiaEurope,109,1082,631.1333893,7323.175439,112.8515625,826431.7908,192,131,117,61,14,49,5,male
93,13400,Asia,106,940,608.9083669,6324.245227,69.71311475,440882.8333,146,120,114,26,6,41,5,male
78,12700,Asia,27,278,118.0964047,1321.858726,12.5,16523.23407,130,93,93,37,0,16,3,male
124,9800,Asia,75,994,392.9423377,6191.445778,147,910142.5294,145,112,107,33,5,44,4,male
61,6800,Europe,69,980,353.0013311,5986.353968,144.6451613,865897.1352,148,127,121,21,6,45,1,male
124,75900,Asia,95,857,529.7522498,5630.366256,61.60576923,346863.0443,145,84,72,61,12,43,8,male
124,105700,Asia,63,625,314.9612072,3735.799952,83.25,311005.346,153,113,91,40,22,33,3,male
140,111100,Asia,87,677,473.6107211,4361.872747,54.64285714,238345.1894,131,71,37,60,34,31,4,male
77,55500,Asia,96,854,536.9091685,5623.557976,108.3113208,609094.9917,144,100,88,44,12,44,5,male
249,117500,Asia,63,845,320.925614,5050.801535,41.68421053,210538.6745,126,66,55,60,11,17,4,male
139,134800,Asia,87,673,473.6107211,4336.100973,45.53571429,197447.455,142,100,81,42,19,35,7,male
155,98500,AsiaEurope,82,673,439.6362367,4278.632499,66.93181818,286376.6525,143,86,71,57,15,36,3,male
62,37100,AsiaAfrica,92,763,510.1851706,4977.477772,71.07407407,353769.6239,139,112,108,27,4,43,3,male
202,120300,Europe,89,874,489.1726399,5659.791019,68.86486486,389760.7437,128,79,70,49,9,45,9,male
46,5600,Asia,77,598,406.0022373,3747.538351,64.8,242840.4852,141,115,113,26,2,37,2,male
124,114900,AsiaEurope,67,696,344.2569162,4221.998077,50.69565217,214036.946,141,107,88,34,19,51,4,male
265,86600,Asia,60,625,297.5287411,3691.806622,34.54545455,127535.1379,131,89,87,42,2,16,3,male
62,53200,Asia,91,700,501.4075845,4555.456248,57.78125,263219.9563,148,113,106,35,7,37,7,male
343,215000,Asia,58,530,287.9357738,3104.729927,41.11111111,127638.897,136,89,69,47,20,38,3,male
93,53800,Europe,58,678,290.4773318,3971.711115,42,166811.8668,139,81,63,58,18,41,6,female
109,91500,Asia,48,546,248.2149912,3049.389525,27.5,83858.21195,163,89,67,74,22,37,9,male
124,115000,Asia,90,977,495.424379,6342.540475,96.73529412,613547.5183,134,109,109,25,0,39,7,male
467,206000,AsiaEurope,63,756,315.5176503,4518.823622,129.96,587266.3179,118,110,106,8,4,39,2,male
62,8800,Unknown,95,775,529.2046323,5091.638096,104.923913,534234.5929,139,109,96,30,13,45,5,male
234,4800,Unknown,68,685,346.3298602,4169.912046,96.67741935,403136.3356,138,102,99,36,3,35,1,male
93,68200,North America,71,646,365.7235111,3972.736639,66.92647059,265881.2418,139,112,94,27,18,45,2,male
62,12700,Asia,41,658,197.7269405,3525.269219,18,63454.84594,142,104,80,38,24,38,5,male
61,15500,Unknown,72,662,372.2346001,4084.490351,22,89858.78772,131,83,61,48,22,55,2,male
140,138500,Asia,73,566,379.6596322,3503.4407,38.4375,134663.5019,131,100,95,31,5,30,2,male
77,39800,Africa,131,1078,795.04794,7582.029996,80.00625,606609.7873,127,89,75,38,14,49,15,male
389,184900,Antarctica,62,729,312.9158937,4340.60911,50.4,218766.6992,177,115,96,62,19,47,15,male
155,54700,Asia,78,768,412.5946318,4827.188904,67.28571429,324800.8534,200,147,122,53,25,50,7,male
171,169200,Asia,68,972,348.0415947,5917.013882,92.62962963,548090.8044,161,113,89,48,24,54,6,male
124,9200,Asia,97,1015,543.1989824,6698.911535,65.14285714,436386.2371,114,65,56,49,9,35,6,male
109,83900,AsiaEurope,98,931,550.9789163,6158.294865,131.1851852,807877.0523,139,117,108,22,9,46,7,female
93,84000,Asia,68,873,348.6887644,5314.35506,34.73076923,184571.6392,131,90,88,41,2,23,3,male
140,130800,Asia,113,915,661.0808625,6240.463751,71.80147059,448074.4744,170,124,101,46,23,36,7,male
156,9800,Asia,91,1040,502.5535519,6768.106426,54.75,370553.8268,188,143,131,45,12,34,2,male
109,67100,AsiaEurope,101,884,572.345265,5885.858951,65.89285714,387836.063,144,118,114,26,4,44,20,male
155,107900,Europe,43,612,199.6842869,3320.87403,16.5,54794.42149,148,118,100,30,18,51,2,male
62,8800,Asia,77,671,405.6268983,4205.013769,45.40540541,190930.3549,161,98,90,63,8,29,3,female
140,4800,Asia,44,576,220.8771238,3144.632612,20,62892.65225,166,149,142,17,7,50,2,male
46,2100,Asia,90,1014,494.5555318,6582.73904,48.5625,319674.2646,192,157,151,35,6,45,6,male
109,83800,AsiaEurope,86,777,466.7930215,4993.207714,80.67073171,402805.7199,112,78,78,34,0,37,9,male
46,41800,Asia,110,792,639.1450031,5370.836893,66.33333333,356265.5139,116,73,73,43,0,30,5,male
202,6100,Asia,100,1017,565.4268669,6756.801745,108.4285714,732630.3606,153,105,96,48,9,37,3,male
92,66800,AsiaEurope,106,759,607.5955132,5106.491625,83.81578947,428004.627,150,94,69,56,25,34,4,male
389,178600,Asia,100,926,565.4268669,6152.210832,72.67857143,447133.8944,156,112,98,44,14,43,8,male
248,187200,AsiaEurope,84,901,452.9546635,5759.477998,91,524112.4978,144,69,43,75,26,33,4,male
62,33500,North America,93,803,515.149526,5250.944525,92.4673913,485541.1421,184,103,85,81,18,24,6,male
233,36900,Asia,115,970,676.1832005,6640.125349,75.21428571,499432.2852,139,81,74,58,7,25,2,male
108,76900,Europe,73,815,379.3421297,5044.707015,113.9393939,574790.8599,121,91,69,30,22,44,5,male
78,35900,Europe,113,937,658.4538637,6390.507688,128.733871,822674.7921,119,61,45,58,16,35,11,male
170,111300,North America,104,771,595.637503,5166.039023,85.69354839,442696.215,137,83,67,54,16,37,12,male
171,20100,Asia,73,698,378.9461511,4320.497542,100.4285714,433901.396,132,108,101,24,7,30,1,male
78,39900,Asia,102,1013,581.4346098,6759.166871,98.13114754,663284.8015,117,102,101,15,1,52,3,male
811,162000,Asia,47,631,235.1694072,3504.945565,37.58333333,131727.5375,147,102,93,45,9,46,7,male
296,75600,Asia,92,794,508.1990654,5179.708193,57.44680851,297557.7047,151,119,117,32,2,38,8,male
296,75600,Asia,92,794,508.1990654,5179.708193,57.44680851,297557.7047,151,119,117,32,2,38,8,male
77,52500,Unknown,92,870,508.2931913,5675.498902,111.2727273,631528.2414,125,86,82,39,4,39,6,male
46,8800,Asia,82,818,440.20115,5200.47754,84.91304348,441588.3754,125,102,99,23,3,50,2,male
61,9400,North America,83,639,446.2065082,4073.650197,62.3255814,253892.6169,133,89,69,44,20,33,1,male
296,44700,Asia,64,691,322.2270913,4146,63.96,265178.16,155,117,115,38,2,48,4,male
77,53500,AsiaEurope,108,801,626.087608,5410.664889,48.95522388,264880.311,120,53,39,67,14,15,3,male
140,115000,Asia,107,840,616.2935606,5662.832269,56.25,318534.3151,139,106,102,33,4,41,6,male
187,13500,Asia,58,624,283.0128366,3655.380141,50.29166667,183835.1596,97,92,92,5,0,45,1,male
187,13500,Asia,58,624,283.0128366,3655.380141,50.29166667,183835.1596,97,92,92,5,0,45,1,male
46,7900,Asia,88,883,480.4627738,5703.678119,69.06976744,393951.7213,194,159,159,35,0,36,10,male
78,55500,Asia,94,793,522.9001971,5197.788959,88.44230769,459704.4505,127,92,80,35,12,37,3,male
62,12700,Europe,96,898,536.4270818,5913.296326,64.85294118,383494.6588,152,106,94,46,12,37,5,male
218,193100,Asia,46,763,228.3868988,4214.477772,20,84289.55545,184,126,101,58,25,47,3,male
62,40000,Asia,86,685,467.8705569,4401.991357,75.51020408,332395.2657,148,112,88,36,24,40,3,male
62,9900,Asia,70,747,359.7107722,4578.574414,76.74193548,351368.6623,145,103,83,42,20,45,2,male
92,78100,Asia,96,946,536.1564001,6229.374526,75.5,470317.7767,168,109,97,59,12,42,6,male
124,98800,AsiaEurope,71,872,365.8862514,5362.579488,142.7878788,765711.35,150,131,121,19,10,48,7,male
93,70000,Europe,80,970,426.3322913,6132.270252,157.0555556,963107.1113,195,151,120,44,31,52,6,female
139,67500,Europe,95,748,531.3425622,4914.251995,52.23214286,256681.9122,173,112,76,61,36,34,8,male
93,45900,Europe,75,934,392.17102,5817.716657,118.6216216,690106.984,153,119,100,34,19,49,5,male
77,36900,AsiaEurope,100,793,566.2402295,5268.577958,84.72413793,446375.7257,142,88,78,54,10,29,3,male
139,71000,Europe,107,1152,619.3050996,7766.169968,135.8208955,1054808.16,105,86,75,19,11,53,21,male
61,33500,Europe,98,904,550.2415647,5979.697699,74,442497.6297,161,2,-14,159,16,2,2,male
124,131300,AsiaEurope,54,501,266.1800927,2883.198639,28.57142857,82377.10396,146,109,97,37,12,34,3,male
93,75900,Asia,63,696,326.681559,4160.186827,38.4,159751.1741,140,107,102,33,5,33,6,male
717,145700,Europe,84,1277,452.9546635,8162.989349,104,848950.8923,147,121,113,26,8,62,4,male
93,67100,AsiaEurope,104,908,593.5404068,6083.999264,67.61403509,411363.7397,144,118,114,26,4,44,20,male
92,63500,Asia,92,811,508.1677,5290.608746,62,328017.7423,149,109,89,40,20,55,7,male
218,194500,Europe,90,822,494.2667787,5336.303245,53.5,285492.2236,107,83,76,24,7,34,13,male
140,115100,Asia,38,542,188.1173001,2844.376712,18,51198.78082,160,126,121,34,5,34,2,male
108,83700,Asia,50,562,242.4407955,3171.847179,25.33333333,80353.46186,176,115,89,61,26,27,4,male
93,61300,Asia,101,901,571.4865019,5999.048546,65.79,394677.4038,126,2,-2,124,4,2,2,male
108,84100,AsiaEurope,97,781,543.5562547,5154.53193,83.50961538,430452.9789,128,95,81,33,14,29,5,male
249,141100,Asia,60,814,296.1564001,4808.208945,87.75,421920.3349,143,139,139,4,0,62,2,male
124,95000,Asia,109,818,632.2593963,5536.374778,64.5,357096.1732,141,77,71,64,6,27,5,male
405,97700,Asia,70,896,359.0910367,5491.837583,109.0588235,598933.3458,157,150,150,7,0,57,5,male
62,18000,Europe,111,741,645.5377578,5034.662157,53.07692308,267224.376,128,86,69,42,17,28,7,male
124,84100,AsiaEurope,97,781,543.5562547,5154.53193,83.50961538,430452.9789,128,95,81,33,14,29,5,male
93,37900,Asia,76,685,398.8804611,4279.830347,101.9871795,436487.8257,117,93,85,24,8,34,2,male
171,177100,Asia,53,661,260.9828401,3786.15542,36.92307692,139796.5078,145,119,110,26,9,31,3,female
358,79300,Asia,96,849,537.6344164,5590.633163,68.58181818,383415.7871,170,117,88,53,29,43,2,male
46,39200,North America,85,761,459.8067162,4877.546502,48.34883721,235823.7018,125,72,61,53,11,37,2,male
124,95700,Asia,87,869,473.7434822,5598.917898,50.35869565,281954.2024,156,90,67,66,23,27,7,male
61,20900,Europe,107,922,615.4791118,6215.632561,71.675,445505.4638,143,112,101,31,11,48,10,male
358,51100,Asia,80,724,428.0782,4577.075941,122.25,559547.5338,127,94,87,33,7,39,6,male
46,9500,Asia,52,723,248.0323866,4121.417916,28.33333333,116773.5076,132,117,117,15,0,47,1,male
46,5800,Asia,60,944,305.7367483,5576.104722,36,200739.77,212,168,157,44,11,31,4,male
62,5800,Asia,60,943,305.7367483,5570.197832,36,200527.1219,212,168,157,44,11,31,4,male
639,213900,Asia,49,841,239.3499675,4721.970979,27.3,128909.8077,199,166,163,33,3,45,6,male
92,68100,Asia,54,634,266.1800927,3648.598676,28.57142857,104245.6765,167,107,82,60,25,13,3,male
93,16100,Asia,44,790,220.8771238,4312.950979,20,86259.01957,190,111,59,79,52,28,3,male
140,137000,AsiaEurope,85,851,459.8746234,5454.391687,54.51136364,297326.3286,172,124,109,48,15,35,8,male
265,69200,Asia,95,927,529.3261988,6090.256149,94.5,575529.2061,139,94,82,45,12,35,2,male
62,8800,Asia,122,1090,724.7113983,7554.503698,73.45588235,554922.7349,149,124,118,25,6,56,12,female
46,23300,South America,94,1047,522.6230769,6862.654528,105.8137255,726163.0423,171,134,121,37,13,40,8,male
139,127700,Asia,43,600,214.1306865,3255.758853,19.5,63487.29763,177,131,124,46,7,31,3,male
93,70400,Asia,43,501,203.5249056,2718.558642,50.3125,136777.4817,113,95,86,18,9,43,2,male
139,115900,Asia,57,648,285.0806907,3779.712729,35,132289.9455,202,137,101,65,36,33,3,male
342,53500,Unknown,65,712,328.9735285,4287.925883,113.6,487108.3803,140,95,89,45,6,38,2,male
499,162200,Asia,63,1024,320.925614,6120.734642,54.42105263,333096.8221,167,146,145,21,1,71,2,male
46,7500,Asia,80,650,425.8985773,4109.253262,87.31578947,358802.6927,174,137,118,37,19,38,4,male
124,98900,Asia,75,776,392.17102,4833.563304,81.78947368,395334.5986,134,88,72,46,16,37,3,male
124,91600,Africa,66,982,338.3224868,5935.595025,30,178067.8508,158,124,122,34,2,70,5,male
202,100400,Asia,80,858,425.8985773,5424.214305,110.5263158,599518.4232,142,133,132,9,1,47,2,male
93,68000,Europe,68,627,345.9899115,3816.839201,93.33333333,356238.3255,162,130,107,32,23,41,3,male
62,9300,North America,92,865,508.1677,5642.881092,128,722288.7798,135,102,93,33,9,39,5,male
61,5500,AsiaAfrica,131,1070,791.9742799,7525.762612,103.2162162,776780.7409,148,2,-18,146,20,2,2,male
982,44300,Asia,61,703,303.4631705,4169.308348,55.34782609,230762.1534,117,85,81,32,4,42,2,male
46,8600,AsiaEurope,60,643,299.3156857,3798.130653,114,432986.8944,137,94,75,43,19,39,1,male
93,9800,AsiaEurope,83,1016,446.1369639,6477.040062,94.20238095,610152.5954,186,145,133,41,12,53,2,female
545,107300,Asia,74,759,385.4995491,4712.975105,100.5,473653.998,147,117,105,30,12,38,4,male
62,33200,Asia,104,820,594.628427,5494.360569,56.1,308233.6279,149,96,84,53,12,33,3,female
124,115000,Asia,68,677,347.0121354,4121.212344,120.362069,496037.6443,149,119,111,30,8,38,3,male
93,11500,AsiaEurope,70,884,359.4212455,5418.286187,154.375,836447.9301,155,147,144,8,3,49,2,male
46,36000,Europe,92,775,509.2999891,5055.760516,66.15384615,334458.0034,157,70,49,87,21,25,3,male
124,86200,Asia,85,898,459.8067162,5755.633061,133.3255814,767373.1241,128,105,89,23,16,51,2,male
108,72100,Europe,79,823,419.4466845,5188.011556,79.53488372,412627.8958,145,78,52,67,26,33,3,male
92,54900,Asia,111,947,643.4988053,6434.311825,110.6101695,711700.3216,169,136,118,33,18,51,9,male
93,20400,Asia,81,996,432.75063,6314.490603,92.22368421,582345.5873,143,109,105,34,4,52,10,male
62,6600,Asia,52,568,254.2364029,3237.84976,36,116562.5914,136,119,114,17,5,42,2,male
109,37100,Asia,63,817,314.9612072,4883.437697,36.28846154,177212.4411,131,120,120,11,0,63,2,male
77,54500,AsiaEurope,103,1014,588.2523093,6780.111535,64.03278689,434149.437,142,91,79,51,12,32,3,male
93,73900,Europe,66,566,333.3240179,3421.127072,47.4,162161.4232,180,130,103,50,27,34,3,male
92,69400,Asia,112,1008,654.817572,6861.813761,95.03623188,652120.9238,132,111,110,21,1,45,11,male
234,5800,Europe,60,526,298.3693524,3107.024453,39.92857143,124059.0478,126,102,93,24,9,25,1,male
139,107200,Asia,56,800,273.4603973,4645.883938,88.60526316,411649.7689,162,130,119,32,11,43,2,male
78,12600,Asia,63,684,316.9190488,4088.459468,94.7826087,387514.8539,149,101,76,48,25,35,1,male
155,58700,Asia,112,1175,658.9207946,7998.642033,77.54054054,620219.0269,150,108,96,42,12,54,5,female
373,118300,AsiaEurope,69,722,353.0013311,4410.354658,105.4193548,464936.7426,168,154,147,14,7,44,2,male
62,7100,Asia,73,753,385.1598824,4660.937893,40.83333333,190321.6306,95,71,65,24,6,31,7,male
92,69000,Asia,68,839,346.3298602,5107.381324,103.8387097,530343.8865,153,133,133,20,0,36,7,male
61,40800,Asia,71,1079,366.4572094,6635.577142,164.516129,1091659.465,222,165,134,57,31,53,5,male
77,57400,Asia,76,600,399.4510684,3748.756508,54.35294118,203755.942,163,109,88,54,21,45,5,male
46,5600,Asia,80,777,425.8985773,4912.13813,90.02380952,442209.3873,147,96,86,51,10,30,2,male
140,3200,Europe,95,750,529.5086837,4927.391706,53.49019608,263567.1485,132,81,68,51,13,28,3,male
62,37500,Asia,84,925,452.9890166,5912.893616,47.7195122,282160.399,162,102,87,60,15,26,6,male
77,37700,Asia,98,940,552.6400215,6217.827253,82.75862069,514578.8072,163,77,62,86,15,25,4,male
62,24900,North America,101,932,571.6579841,6205.453102,98.26415094,609773.5803,119,96,85,23,11,45,8,male
280,42900,Asia,125,1106,748.7932415,7704.157419,110.9594595,854849.1428,156,102,68,54,34,69,21,male
109,89800,Asia,113,789,661.0808625,5381.121201,41.36029412,222564.7556,162,93,78,69,15,21,4,male
280,90800,Asia,93,988,516.0824975,6460.688905,87.91346154,567981.5256,148,87,65,61,22,39,6,male
140,104600,Asia,68,692,347.0121354,4212.524286,30.25862069,127465.1745,131,85,85,46,0,23,3,male
77,21300,Asia,59,892,297.3293845,5247.3176,36.28125,190379.2417,215,140,100,75,40,46,11,male
92,71300,Unknown,86,938,466.9609738,6027.83634,124.7826087,752169.1433,146,81,71,65,10,38,4,male
202,196800,Asia,78,967,412.85429,6077.983946,68.8,418165.2955,152,89,80,63,9,42,2,male
124,25500,Asia,66,796,335.0885565,4811.337719,60,288680.2631,138,92,90,46,2,39,5,male
93,83700,Europe,116,858,680.1484193,5884.147694,74.45238095,438088.8057,151,2,-18,149,20,2,2,male
62,8700,Europe,74,835,385.5385456,5184.89356,74.41666667,385842.4958,130,97,91,33,6,43,3,male
108,141600,Asia,82,667,439.8831639,4240.487187,51.08108108,216608.6698,197,145,127,52,18,29,3,male
187,15400,Asia,58,532,283.0128366,3116.445889,35.41666667,110374.1252,130,108,105,22,3,30,1,female
61,6500,Asia,89,884,487.7378322,5724.548353,102.4390244,586417.1484,142,83,63,59,20,33,2,female
62,22600,Unknown,92,953,508.2931913,6216.954544,61.875,384674.0624,159,106,83,53,23,51,7,female
61,12200,Asia,92,809,508.1677,5277.561622,68.5,361512.9711,163,113,90,50,23,43,10,female
108,69200,Europe,81,830,432.9647657,5262.075502,76.10810811,400486.6112,181,122,91,59,31,43,5,female
78,59400,Asia,93,861,515.2115894,5630.215736,52.5,295586.3262,190,109,64,81,45,32,5,female
93,69000,Europe,83,1154,446.3456778,7356.795504,166.974359,1228396.213,224,177,143,47,34,68,6,female
124,9100,AsiaEurope,105,857,603.0459669,5754.108409,75.33333333,433476.1668,145,89,83,56,6,42,9,female
234,131700,AsiaEurope,93,1191,515.5221939,7788.138144,124.27,967831.9272,182,139,125,43,14,43,8,female
577,99900,Unknown,88,807,480.4299824,5212.761316,48,250212.5432,181,105,71,76,34,37,3,female
545,99900,Unknown,88,807,480.4299824,5212.761316,48,250212.5432,184,105,69,79,36,37,3,female
77,59500,Asia,121,1100,719.3553825,7610.749561,82.34722222,626724.0854,159,88,62,71,26,32,12,female
62,8700,Asia,105,864,600.8285737,5801.108127,90.75862069,526500.5721,149,116,107,33,9,46,3,female
234,12700,Asia,62,800,308.3287327,4763.357048,42.23076923,201160.2323,190,130,111,60,19,42,2,female
46,5700,Asia,88,1077,480.5611817,6956.807853,94.73809524,659074.725,194,127,91,67,36,44,2,female
264,119500,Asia,82,935,439.460071,5944.311124,44.89534884,266871.9215,172,133,130,39,3,42,3,female
77,13800,AsiaEurope,82,985,439.3544556,6262.188725,83.475,522736.2038,194,149,144,45,5,56,4,female
109,115000,Asia,74,731,388.0148382,4539.11041,60.51724138,274694.4403,218,154,140,64,14,40,6,female
311,241100,Asia,0,0,0,0,0,0,186,128,113,58,15,30,5,female
124,108500,Asia,105,1012,603.0459669,6794.816464,125.6666667,853881.9356,140,98,96,42,2,46,9,female
264,66300,Asia,88,846,481.614055,5464.679149,51.97368421,284019.5084,184,127,117,57,10,38,5,female
405,178400,AsiaEurope,95,1083,530.851908,7115.153624,98.90909091,703753.3766,170,99,74,71,25,61,3,female
421,120200,Asia,139,1341,857.7236749,9546.499979,70.99431818,677747.257,281,170,122,111,48,39,8,female
78,14700,Asia,98,1782,550.7131734,11787.41294,156.2264151,1841505.267,259,191,171,68,20,98,2,female
77,42800,Asia,132,937,805.0328635,6600.59729,51.14285714,337573.4043,172,75,69,97,6,59,4,female
545,142700,AsiaEurope,145,2131,902.2415629,15300.38627,163.7777778,2505863.263,263,193,183,70,10,92,22,female
62,4800,Asia,143,1642,881.7152809,11756.50873,98.33333333,1156056.692,233,130,88,103,42,61,35,female
77,33000,Asia,113,1214,658.4538637,8279.69726,81.43548387,674261.1527,256,136,127,120,9,56,11,female
62,12600,Asia,122,1298,728.2270778,8996.097064,205.5466667,1849117.765,255,200,196,55,4,68,16,female
62,55800,Asia,6,14,15.509775,36.18947501,0,0,167,87,87,80,0,89,39,female
124,17400,Europe,113,1962,658.1978429,13381.19112,97.18032787,1300388.541,278,144,82,134,62,101,35,female
62,28300,Asia,131,1711,795.7206597,12034.18676,84.25925926,1013991.662,401,326,301,75,25,81,14,female
108,68100,Asia,88,1527,483.7376617,9863.552082,55.58823529,548297.454,453,335,290,118,45,80,22,female
77,55500,Asia,210,4356,1452.042082,33603.25347,161.9811321,5443093.039,523,265,197,258,68,221,148,female
46,0,Asia,45,140,204.8814489,768.8594335,29,22296.92357,26,23,23,3,0,6,2,female
31,0,Europe,36,133,174.9737366,687.6000252,17,11689.20043,27,19,16,8,3,6,2,female
31,300,Asia,57,217,275.5886804,1265.737133,40,50629.48532,33,25,21,8,4,9,2,female
31,0,Asia,42,172,186.9853215,927.4785967,15.3,14190.42253,31,27,27,4,0,8,2,female
31,0,Asia,29,126,130.3819626,612.1056054,13.5,8263.425673,31,22,19,9,3,7,2,female
46,3900,Asia,36,183,153.05865,946.0962753,14,13245.34785,31,22,17,9,5,7,2,female
31,0,Asia,52,158,246.4385619,900.6694755,27.2,24498.20973,30,18,14,12,4,6,2,female
31,0,Asia,42,175,191.6338334,943.655549,28.18181818,26593.92911,40,22,16,18,6,6,2,female
31,200,Asia,29,160,126.9663202,777.2769592,13,10104.60047,42,20,18,22,2,6,2,female
31,0,Asia,35,160,179.5249056,820.6852827,0,0,35,25,20,10,5,11,4,female
31,0,Asia,48,211,224,1178.427088,23,27103.82302,33,29,28,4,1,7,2,female
46,0,Asia,33,147,155.5800856,741.5259355,15.5,11493.652,43,36,34,7,2,7,2,female
31,0,Asia,72,292,372.3949821,1801.6181,35.20588235,63427.55489,39,30,29,9,1,14,3,female
31,0,Asia,39,169,181.9747809,893.232975,19.25,17194.73477,30,22,22,8,0,8,2,female
30,0,Asia,60,285,294.4134357,1683.46382,34,57237.76987,46,40,40,6,0,10,4,female
31,0,AsiaEurope,34,134,162,681.7200207,16,10907.52033,47,31,20,16,11,6,2,female
31,0,Asia,76,306,399.4510684,1911.865819,31.97619048,61134.1856,34,15,15,19,0,7,2,female
31,0,Asia,49,212,231.5770955,1190.318487,39.66666667,47215.96665,34,27,27,7,0,8,4,female
30,0,Asia,47,214,227.9505705,1188.682014,31.66666667,37641.59712,31,13,12,18,1,6,2,female
31,0,Asia,49,214,231.5770955,1201.547907,26.06666667,31320.34877,36,24,24,12,0,8,3,female
31,0,Europe,37,308,169.0898606,1604.511637,20.66666667,33159.90716,38,30,30,8,0,7,3,female
31,0,Asia,52,256,248.0323866,1459.312568,45.33333333,66155.50308,38,20,13,18,7,5,2,female
31,0,Europe,58,284,284.2247957,1663.666603,49.09090909,81670.90595,46,29,26,17,3,13,2,female
31,0,Asia,64,177,320,1062,27.5,29205,33,22,22,11,0,13,6,female
31,0,Unknown,111,568,655.5163002,3859.228212,49.8961039,192560.4518,19,17,17,2,0,16,6,female
31,0,Europe,58,290,284.2247957,1698.814489,49.09090909,83396.34762,49,32,29,17,3,15,2,female
31,0,Asia,35,156,156.3912239,800.1681506,19.33333333,15469.91758,46,26,20,20,6,7,2,female
31,0,Europe,42,197,194.994331,1062.286532,22,23370.30371,66,45,30,21,15,9,4,female
31,0,AsiaEurope,52,206,244.4783673,1174.290582,31.32,36778.78103,53,36,30,17,6,8,3,female
46,0,Asia,61,253,302.2137048,1500.476546,28.8,43213.72454,47,26,26,21,0,7,2,female
31,15800,Asia,101,524,575.9898807,3488.902817,56.3968254,196763.043,45,39,39,6,0,24,8,female
31,0,Asia,28,169,124.2114327,812.4429818,13,10561.75876,49,26,19,23,7,6,2,female
31,0,Asia,43,264,203.5249056,1432.533895,19.6875,28203.01106,50,24,18,26,6,6,3,female
31,0,Asia,53,291,252.2386659,1666.824852,32,53338.39527,71,28,18,43,10,6,3,female
31,100,Asia,79,410,419.0078103,2584.550107,47.17948718,121937.7486,54,44,44,10,0,25,8,female
31,200,Asia,52,341,247.1756287,1943.849944,29.52631579,57394.72729,55,31,18,24,13,9,3,female
31,0,AsiaEurope,69,388,352.4986422,2370.107489,65.88235294,156148.2581,66,46,38,20,8,11,5,female
31,0,Asia,49,253,228.6387356,1420.521591,27.55555556,39143.26161,54,33,28,21,5,7,3,female
31,0,Europe,38,171,173.2315701,897.3956048,19.92857143,17883.81241,57,29,20,28,9,8,2,female
31,0,Unknown,74,372,386.1246381,2309.916652,40.37878788,93271.63451,56,38,34,18,4,13,5,female
31,0,Unknown,35,271,168.4650059,1390.035698,16.5,22935.58901,77,43,28,34,15,11,4,female
31,0,Europe,45,347,212.7441865,1905.673024,35,66698.55585,67,47,32,20,15,9,2,female
31,0,Asia,69,393,352.4986422,2400.650112,39.11764706,93907.78377,81,53,41,28,12,11,5,female
46,35200,AsiaEurope,61,367,300.7868035,2176.580603,44.03225806,95839.7588,87,49,49,38,0,7,2,female
31,0,Asia,81,395,435.1207824,2504.240751,38.28125,95865.46625,54,33,30,21,3,17,6,female
31,300,Asia,15,40,50.10571634,156.2756238,6.5,1015.791555,68,45,42,23,3,22,10,female
31,200,North America,92,532,511.3291757,3470.534961,52.07142857,180715.7133,88,49,25,39,24,11,5,female
31,200,Europe,56,364,271.0812322,2113.877192,30.13636364,63704.57173,67,20,11,47,9,7,3,female
31,0,Asia,47,269,222.5444556,1494.184401,21.875,32685.28377,63,37,31,26,6,11,4,female
31,0,Asia,61,269,304.2381821,1595.368344,27.47727273,43836.37108,63,19,12,44,7,7,1,female
46,0,Unknown,38,285,178.0746464,1495.659341,23.1,34549.73078,85,57,45,28,12,13,6,female
31,0,Asia,68,437,347.0121354,2660.221262,59.17241379,157411.7133,77,46,45,31,1,15,5,female
31,0,AsiaEurope,69,374,352.582306,2284.588147,49.5,113087.1133,76,34,24,42,10,10,3,female
31,3700,Asia,68,380,345.9899115,2313.23588,71.06060606,164379.9436,67,28,16,39,12,5,2,female
46,200,Asia,42,408,210.885574,2200.065508,19.5,42901.27742,89,46,38,43,8,9,3,female
31,0,Asia,0,0,0,0,0,0,50,17,10,33,7,7,2,female
31,0,AsiaEurope,46,332,219.336581,1833.822569,27,49513.20937,105,35,18,70,17,10,4,female
31,1800,Asia,64,624,324.5848274,3744,34.36363636,128657.4545,86,44,33,42,11,19,4,female
31,0,AsiaEurope,51,288,241.523656,1633.658498,24.75,40433.04784,72,18,12,54,6,6,3,female
46,0,Europe,89,529,487.5430078,3425.662985,65.23404255,223469.8449,73,50,40,23,10,23,14,female
46,0,Asia,47,331,227.9505705,1838.56891,21.11111111,38814.23254,103,51,40,52,11,7,2,female
31,0,Asia,41,327,204.176133,1751.919506,19,33286.4706,72,42,38,30,4,8,1,female
31,200,Asia,71,504,370.1802547,3099.472548,66.24,205309.0616,74,42,39,32,3,19,8,female
31,300,Asia,106,607,608.4972857,4083.847716,32.58333333,133065.3714,85,61,55,24,6,33,12,female
31,0,AsiaEurope,81,551,432.75063,3493.257352,71.13953488,248508.7032,95,52,44,43,8,14,4,female
31,0,Asia,81,659,436.5004103,4177.961152,102.6470588,428855.4241,62,33,33,29,0,14,7,female
31,0,Asia,45,457,212.7441865,2509.776865,24.5,61489.53319,151,108,91,43,17,26,11,female
31,100,Asia,62,561,314.0400072,3340.30413,43,143633.0776,127,86,84,41,2,12,6,female
31,0,Asia,73,546,378.8670746,3379.644209,52.41666667,177149.684,84,31,19,53,12,6,3,female
31,0,Asia,107,1025,615.8588276,6910.003661,175.704918,1214121.627,71,27,24,44,3,33,9,female
31,40700,Asia,49,414,241.4064488,2324.489875,28.88888889,67151.92974,143,63,56,80,7,15,3,female
31,0,Asia,101,648,572.0586342,4314.521041,51.43636364,221923.2732,126,85,63,41,22,28,21,female
46,200,AsiaEurope,98,821,550.7131734,5430.676782,84.48113208,458789.7225,142,66,55,76,11,12,4,female
31,0,AsiaEurope,134,1115,815.0172944,7878.689447,117.3311688,924415.8417,156,95,83,61,12,40,18,female
31,0,Asia,86,704,469.3966019,4524.090387,70.35294118,318283.0649,150,81,65,69,16,37,20,female
31,0,Asia,113,1809,659.9956879,12337.70374,236.4242424,2916932.261,170,141,124,29,17,70,51,female
31,0,Asia,113,1809,659.9956879,12337.70374,236.4242424,2916932.261,170,141,124,29,17,70,51,female
46,3700,AsiaEurope,96,587,536.9091685,3865.372988,40.16037736,155234.8378,138,55,40,83,15,17,9,female
31,200,Asia,18,58,63.35824644,241.8556501,7.5,1813.917376,126,33,24,93,9,13,6,female
31,200,Asia,18,58,63.35824644,241.8556501,7.5,1813.917376,128,35,26,93,9,13,6,female
31,0,Asia,6,14,15.509775,36.18947501,0,0,138,55,55,83,0,68,37,female
31,22400,Asia,146,2134,907.0722046,15343.08561,71.86046512,1102561.268,152,59,53,93,6,85,24,female
31,0,Asia,133,1761,808.7626042,12424.35237,110.7341772,1375800.437,141,102,97,39,5,58,46,female
31,300,Asia,78,541,412.2983693,3400.4026,44.73684211,152123.2742,239,85,68,154,17,25,10,female
779,15300,Asia,58,272,283.0128366,1593.370831,38.95833333,62075.07195,44,35,34,9,1,12,3,female
280,16100,Asia,54,241,258.1074956,1386.927888,39.27272727,54468.44069,38,32,32,6,0,11,3,female
311,14100,Asia,60,314,294.6059378,1854.763647,46.85714286,86908.92517,43,37,36,6,1,12,3,female
1014,14000,Asia,54,243,258.1074956,1398.437663,37.09090909,51869.32423,45,39,38,6,1,11,3,female
264,16100,Asia,53,258,252.2386659,1477.803477,36.57142857,54045.38431,44,38,38,6,0,11,3,female
171,12000,Asia,75,430,392.9423377,2678.392037,39.67857143,106274.7698,38,0,0,38,0,0,3,female
280,14700,Asia,0,0,0,0,0,0,50,38,38,12,0,14,3,female
295,16100,Asia,77,361,405.7769322,2262.309941,42.14634146,95348.08728,42,32,28,10,4,15,3,female
186,35200,Asia,71,389,365.7235111,2392.251629,47.88235294,114546.6368,44,0,0,44,0,0,3,female
919,15500,Asia,57,277,275.7915183,1615.710534,42.92307692,69351.26753,64,40,24,24,16,11,3,female
280,16100,Unknown,51,304,241.523656,1724.417304,42.16666667,72712.92965,58,39,33,19,6,11,3,female
295,14500,Asia,46,279,209.6645878,1541.073786,53.66666667,82704.29317,47,41,41,6,0,11,3,female
264,29000,Asia,63,283,313.6717238,1691.570218,40.7,68846.90789,51,39,34,12,5,11,3,female
280,14200,Asia,58,309,284.2247957,1810.116127,57.27272727,103670.2873,61,41,28,20,13,14,3,female
1013,34700,Asia,81,393,434.543206,2491.561051,48.125,119906.3756,43,29,29,14,0,12,3,female
280,14900,Antarctic,64,360,320.4063545,2160,58.53448276,126434.4828,59,48,47,11,1,12,3,female
171,12000,Asia,67,438,339.4387425,2656.947065,54.60606061,145085.4125,58,51,51,7,0,15,4,female
265,14800,Asia,67,358,339.4387425,2171.65993,32.96969697,71598.96982,53,29,29,24,0,8,3,female
311,58300,Asia,60,339,294.4615345,2002.435912,39.55172414,79199.79279,56,45,43,11,2,12,3,female
311,26600,Europe,57,344,276.0964047,2006.514165,60.8,121996.0612,53,33,29,20,4,11,3,female
1029,16000,Unknown,58,378,281.7628977,2214.316816,49,108501.524,54,44,40,10,4,11,3,female
795,18900,Asia,51,268,241.523656,1520.209992,24.75,37625.19729,54,44,39,10,5,13,2,female
795,20800,Asia,36,306,174.9737366,1581.99705,17,26893.94986,82,68,66,14,2,11,4,female
280,16100,North America,52,337,247.1756287,1921.048185,36.47368421,70067.70485,59,38,35,21,3,9,3,female
108,12800,Asia,65,408,328.3421192,2457.126068,35.25,86613.69389,72,62,62,10,0,18,6,female
810,22400,AsiaEurope,48,276,223.0669539,1541.44965,51.05882353,78704.60567,62,47,41,15,6,11,3,female
483,16000,AsiaAfrica,56,331,270.0391,1922.234479,46.66666667,89704.2757,52,40,34,12,6,10,3,female
1107,16000,Europe,49,342,227.3200108,1920.230767,46.4,89098.70757,54,40,34,14,6,11,3,female
780,14200,Asia,65,357,328.3421192,2149.985309,60.75,130611.6075,69,46,33,23,13,16,8,female
795,14200,Asia,66,359,335.0885565,2169.937489,62.30769231,135203.7974,69,46,33,23,13,16,8,female
795,16100,Asia,55,312,263.0928815,1803.784231,45.17307692,81482.4838,53,36,26,17,10,11,3,female
265,24000,Asia,66,356,333.1049912,2151.804306,40.08064516,86245.70487,55,30,26,25,4,12,3,female
187,13800,Asia,71,475,365.8862514,2921.129882,64.69736842,188989.4162,58,0,0,58,0,0,3,female
249,17000,South America,65,328,327.3557123,1975.336643,43.60714286,86138.78717,66,39,26,27,13,13,5,female
218,15100,Asia,71,463,365.7235111,2847.332916,33.73529412,96055.61338,76,64,64,12,0,16,4,female
296,28600,Asia,39,265,175.7360429,1400.631588,15,21009.47382,66,43,34,23,9,5,2,female
327,22300,AsiaEurope,55,299,265.9634675,1728.626554,30.625,52939.18823,65,50,44,15,6,14,4,female
295,13400,Asia,83,444,447.6031056,2830.517508,47.31428571,133923.9141,48,34,34,14,0,21,8,female
234,10600,Asia,68,468,346.6279634,2848.93261,57.63333333,164193.4827,65,40,37,25,3,14,3,female
858,13200,Europe,50,298,233.1201147,1681.869145,32.45238095,54580.65819,60,45,39,15,6,13,3,female
265,13400,Asia,83,450,447.6031056,2868.767744,47.31428571,135733.6967,50,36,36,14,0,22,8,female
717,11200,Asia,65,439,326.5538222,2643.81947,61.41935484,162381.6862,57,20,15,37,5,5,1,female
249,14200,Unknown,61,396,305.1157897,2348.571986,46.66666667,109600.026,58,33,27,25,6,8,3,female
873,15900,Asia,73,475,378.8670746,2940.166665,63.20833333,185843.0346,68,58,58,10,0,18,7,female
295,24000,Asia,37,251,177.7286241,1307.572795,17,22228.73751,52,33,32,19,1,12,4,female
795,16100,Asia,68,380,345.9474732,2313.23588,41.5,95999.28901,64,40,39,24,1,8,3,female
764,16300,AsiaAfrica,62,382,307.9068682,2274.502991,49.25925926,112040.3325,64,40,38,24,2,11,3,female
296,20800,Asia,38,365,188.1173001,1915.493542,18,34478.88376,86,64,57,22,7,16,6,female
764,16100,Europe,55,300,265.9634675,1734.407914,45.5,78915.56009,66,44,30,22,14,16,3,female
327,28600,Asia,72,505,372.3949821,3115.812126,44.14705882,137553.9412,72,53,51,19,2,19,3,female
296,21100,Asia,76,348,399.7943904,2174.278775,39.52325581,85934.57622,54,41,41,13,0,13,3,female
405,15900,Asia,93,490,515.2115894,3204.187817,58.59375,187745.3799,60,40,37,20,3,17,4,female
280,14200,Asia,70,428,359.4212455,2623.333131,57.59375,151087.5925,64,38,32,26,6,9,3,female
748,14200,Asia,60,295,295.1851693,1742.532726,51,88869.16901,69,42,38,27,4,12,3,female
779,13900,Europe,83,495,446.1369639,3155.644519,73.21428571,231038.2594,78,40,22,38,18,17,6,female
108,12000,Asia,106,574,608.4972857,3861.826341,78.2,301994.8199,60,9,-1,51,10,9,2,female
109,12000,Asia,106,574,608.4972857,3861.826341,78.2,301994.8199,60,9,-1,51,10,9,2,female
264,15700,Asia,60,361,295.1851693,2132.387505,30.07692308,64135.65496,76,59,54,17,5,14,3,female
280,31000,Asia,59,402,292.5692484,2364.822506,52.65,124507.9049,93,40,26,53,14,12,3,female
748,19000,Unknown,53,323,254.5835556,1850.118307,48.61111111,89936.30658,73,58,51,15,7,13,3,female
841,14000,Asia,69,408,352.582306,2492.277978,46.75,116513.9955,87,37,24,50,13,8,3,female
312,24600,Asia,57,373,278.3559659,2175.667975,52.28571429,113756.3541,76,44,34,32,10,12,3,female
218,17300,Asia,68,492,346.1173001,2995.031718,48.88888889,146423.7729,91,70,70,21,0,18,4,female
779,16100,Europe,51,334,240.7106228,1894.590064,48.84210526,92535.76735,82,59,51,23,8,13,4,female
826,115500,Unknown,55,443,265.9634675,2561.142353,49.875,127736.9749,98,45,28,53,17,12,3,female
763,16100,Asia,64,442,322.2270913,2652,49.92,132387.84,76,39,39,37,0,8,3,female
265,10300,Europe,62,335,307.9068682,1994.655764,52.5,104719.4276,83,46,33,37,13,11,3,female
280,26300,Europe,37,284,181.5249056,1479.484756,17.5,25890.98323,97,41,16,56,25,11,3,female
249,14200,Asia,81,482,432.75063,3055.807701,74.11842105,226491.6419,95,55,39,40,16,16,7,female
280,13400,Asia,90,510,494.5555318,3310.845079,63.42857143,210002.1736,81,54,45,27,9,26,5,female
561,15900,Asia,71,496,365.7235111,3050.274571,71.27941176,217421.7772,91,43,35,48,8,13,4,female
311,17100,Asia,73,452,378.8670746,2797.800701,58.86486486,164692.1602,97,54,28,43,26,17,4,female
904,14200,Asia,106,680,607.4046851,4574.985909,83.03571429,379887.2228,71,46,43,25,3,24,7,female
1013,64400,Asia,81,465,433.2506894,2948.030251,47.6,140326.24,75,51,51,24,0,19,6,female
529,24500,AsiaEurope,69,462,352.4986422,2822.138299,56.61764706,159782.8302,92,51,40,41,11,12,3,female
327,28300,Asia,41,320,204.176133,1714.416641,19,32573.91619,95,53,40,42,13,13,4,female
280,16900,Asia,76,383,399.1845378,2392.956238,31.58536585,75582.39824,83,41,31,42,10,10,3,female
280,17300,Asia,53,385,255.6041684,2205.249375,58.23529412,128423.346,67,45,39,22,6,13,3,female
296,16900,Asia,59,438,288.6764386,2576.597656,68.53846154,176596.0393,76,54,48,22,6,13,3,female
343,26300,Asia,38,175,162.6452839,918.3873149,25.3,23235.19907,91,58,55,33,3,10,4,female
296,9500,Asia,74,537,386.1246381,3334.476457,69.57575758,231998.7256,91,50,40,41,10,18,4,female
467,14800,Asia,90,538,494.3950605,3492.616966,71.04651163,248138.2519,87,45,34,42,11,17,7,female
265,22000,Asia,80,492,426.079159,3110.388623,45.90540541,142783.6507,101,47,27,54,20,12,5,female
233,9800,Asia,86,486,466.692323,3123.164671,58.70454545,183343.9624,100,52,47,48,5,17,4,female
295,14900,Asia,78,474,413.5983953,2979.280652,49.77272727,148286.9233,108,80,80,28,0,24,9,female
358,25500,AsiaEurope,71,479,366.1306865,2945.72887,50.578125,148989.443,124,74,61,50,13,18,4,female
265,22400,Asia,84,613,453.8154506,3918.49058,52.35106383,205137.1505,92,39,30,53,9,16,5,female
296,16900,Asia,91,687,501.5981141,4470.854918,58.33333333,260799.8702,104,65,53,39,12,18,7,female
295,24600,Asia,89,639,487.5430078,4137.993662,84.44680851,349440.3584,111,56,31,55,25,25,9,female
358,36400,Asia,80,520,425.8985773,3287.402609,57.47368421,188939.1394,123,83,68,40,15,22,5,female
1419,11000,Asia,84,544,453.2640759,3477.420678,61.73076923,214663.8534,105,66,54,39,12,21,8,female
249,19500,Asia,65,445,326.9987489,2679.953677,34.75862069,93151.49332,166,91,66,75,25,17,6,female
592,17900,Asia,75,681,392.4020294,4241.825528,63.42857143,269052.9335,119,81,80,38,1,17,7,female
295,26600,Europe,77,559,405.6268983,3503.133676,55.5,194423.919,127,65,58,62,7,18,3,female
295,20800,Asia,91,797,503.0010296,5186.712328,134.0754717,695410.902,88,54,54,34,0,22,9,female
280,23000,Asia,89,733,487.3483806,4746.712605,73.63636364,349530.6555,168,118,118,50,0,32,9,female
280,47800,AsiaEurope,77,631,405.551932,3954.342307,52.34210526,206978.6013,143,54,42,89,12,17,5,female
343,18400,Asia,107,1022,615.8588276,6889.77926,175.704918,1210568.1,115,66,64,49,2,38,11,female
311,24600,Asia,50,624,255.7247662,3521.766262,29.33333333,103305.1437,208,139,114,69,25,34,12,female
265,29900,Asia,68,725,346.6279634,4413.41056,61.43333333,271130.5221,184,53,2,131,51,10,5,female
234,15600,Asia,84,636,455.7586984,4065.513881,44.64705882,181513.2374,160,38,19,122,19,10,3,female
764,15300,Asia,116,1334,683.1336612,9148.546648,86.74285714,793571.0749,200,143,126,57,17,36,12,female
311,39400,Asia,8,69,24,207,0,0,226,47,-12,179,59,12,3,female
249,10100,Asia,11,26,38.05374781,89.94522208,0,0,151,73,73,78,0,68,38,female
311,24600,Asia,79,1357,428.0138843,8554.230475,45.83333333,392068.8968,396,271,222,125,49,67,23,female
280,16100,Asia,49,373,235.7693245,2094.286772,30.83333333,64573.84213,263,51,11,212,40,24,16,female
327,14500,Asia,69,461,352.7497745,2816.029775,53.765625,151405.6008,70,65,65,5,0,23,5,female
576,92400,Asia,73,489,378.8670746,3026.824209,60.63888889,183543.2569,60,53,53,7,0,21,5,female
623,92400,Asia,73,492,378.8670746,3045.393683,61.15277778,186234.2831,61,54,54,7,0,21,5,female
390,12500,Asia,81,538,432.9647657,3410.839302,47.93181818,163487.7292,55,52,52,3,0,23,5,female
358,13900,Unknown,134,797,830.2669693,5631.673085,71.02105263,399967.3506,27,23,23,4,0,28,9,female
421,15800,Asia,74,402,385.6555921,2496.200253,50.7,126557.3528,49,40,39,9,1,17,3,female
452,15800,Asia,74,402,385.6555921,2496.200253,50.7,126557.3528,50,40,38,10,2,17,3,female
498,22300,Asia,72,502,372.2746801,3097.302351,57.08571429,176811.717,77,69,69,8,0,23,5,female
405,20100,Asia,72,528,372.2746801,3257.720401,54.39189189,177193.5759,76,67,67,9,0,20,6,female
421,13700,Asia,80,526,426.079159,3325.334178,44.74418605,148789.3711,79,74,74,5,0,22,5,female
655,139300,Asia,72,490,372.2746801,3023.263251,62.37142857,188565.2479,58,51,51,7,0,20,5,female
436,14200,Asia,79,581,419.4466845,3662.496615,56.93023256,208506.784,72,60,53,12,7,27,5,female
811,17200,Europe,78,415,412.4094067,2608.441921,49.31081081,128624.3861,58,49,46,9,3,19,4,female
857,20500,Asia,79,470,419.0808777,2962.776952,74.98684211,222169.2875,60,54,54,6,0,20,5,female
795,116700,AsiaEurope,62,425,309.4603455,2530.533432,41.16666667,104173.6263,80,58,50,22,8,21,4,female
280,24200,Asia,78,542,412.2983693,3406.688003,56.84210526,193643.318,76,63,57,13,6,18,4,female
826,14900,Asia,80,466,425.7903187,2946.018492,59.92682927,176545.5472,76,54,46,22,8,17,3,female
982,15200,Asia,76,525,398.9944238,3280.161945,45.45,149083.3604,75,68,68,7,0,22,4,female
1590,15700,Asia,88,510,480.5611817,3294.310126,61.63043478,203029.7653,59,52,52,7,0,19,4,female
342,18000,Asia,77,599,405.551932,3753.805138,59.52631579,223450.19,70,56,51,14,5,25,5,female
296,18000,Asia,77,599,405.551932,3753.805138,59.52631579,223450.19,70,56,51,14,5,25,5,female
1341,15000,Asia,85,535,460.0105131,3429.024151,65.33333333,224029.5779,92,68,51,24,17,21,4,female
358,15000,Asia,85,549,460.0105131,3518.755624,64,225200.3599,88,72,70,16,2,28,5,female
311,12500,Asia,80,622,425.7903187,3932.239275,66.23076923,260435.232,73,49,49,24,0,19,6,female
93,8100,Asia,86,636,466.6587689,4087.104384,65,265661.785,76,6,6,70,0,4,1,female
935,17200,Asia,93,610,516.4569079,3988.886875,79.24528302,316100.4693,68,53,48,15,5,23,5,female
514,16400,Asia,81,644,433.6087556,4082.863402,46.41304348,189498.1166,108,76,67,32,9,25,6,female
311,17400,AsiaEurope,83,516,446.5546348,3289.520347,66.71111111,219447.5573,89,65,50,24,15,18,5,female
982,41100,Asia,83,631,446.1369639,4022.649881,55.64285714,223831.7327,72,10,10,62,0,7,1,female
483,15600,Asia,99,689,559.9530637,4567.626711,65.42372881,298831.1713,98,75,68,23,7,25,5,female
2729,87200,Asia,39,509,190.8721876,2690.269729,18,48424.85513,114,98,98,16,0,27,4,female
530,22300,Asia,87,625,473.9427998,4026.839685,65.53191489,263886.5155,88,75,74,13,1,28,7,female
764,17400,Asia,73,606,378.8670746,3751.033683,38.54166667,144571.0899,100,76,68,24,8,27,3,female
327,12000,Asia,119,700,712.9490957,4826.372434,49.02469136,236611.419,57,44,42,13,2,22,3,female
171,11000,Asia,89,580,487.4132344,3755.92539,57.02173913,214169.3978,82,54,51,28,3,22,6,female
1388,37600,Asia,80,606,426.3322913,3831.088426,54,206878.775,94,85,85,9,0,23,5,female
452,28200,Asia,102,726,582.037295,4844.180798,58.38709677,282837.6531,88,0,0,88,0,0,5,female
436,28200,Asia,102,726,582.037295,4844.180798,58.38709677,282837.6531,88,0,0,88,0,0,5,female
233,10700,Asia,66,517,333.6312234,3124.95176,68.25862069,213304.8968,84,78,78,6,0,19,5,female
1216,16600,Asia,80,516,425.8985773,3262.114897,54.71052632,178472.0229,105,73,50,32,23,23,6,female
202,12100,Asia,96,596,537.2412569,3924.63765,54.83333333,215200.9645,80,0,-1,80,1,0,6,female
670,23800,Asia,86,616,466.6587689,3958.579089,55.5,219701.1394,87,57,57,30,0,21,5,female
405,14100,Asia,89,676,488.714938,4377.595799,72.64705882,318019.4595,80,8,-3,72,11,7,1,female
249,25200,Asia,124,749,750.9289161,5208.693036,54.14117647,282004.7689,62,0,-3,62,3,0,1,female
405,17200,Asia,105,750,605.8492213,5035.684138,60.40298507,304170.3538,94,77,70,17,7,21,4,female
327,17200,Asia,105,750,605.8492213,5035.684138,60.40298507,304170.3538,94,77,70,17,7,21,4,female
1107,28900,Asia,93,572,515.2115894,3740.39884,69.375,259490.1695,88,72,71,16,1,25,6,female
264,6300,Asia,100,716,565.1081736,4757.001032,88.77272727,422291.9552,104,19,7,85,12,6,3,female
498,19200,Asia,98,742,550.3593685,4908.114704,85.24509804,418392.7192,82,6,1,76,5,6,1,female
327,10700,Asia,104,731,594.628427,4898.021434,57.93333333,283758.7084,70,2,0,68,2,4,2,female
265,14500,Africa,84,619,454.1955001,3956.844485,60,237410.6691,94,79,72,15,7,24,5,female
717,20100,AsiaEurope,87,652,473.5443757,4200.799159,99.76744186,419102.9859,99,66,50,33,16,19,5,female
780,108800,Asia,82,658,439.6362367,4183.269219,65.42105263,273673.8758,125,53,23,72,30,24,5,female
468,108800,Asia,82,660,439.6362367,4195.984323,65.42105263,274505.7112,125,53,23,72,30,24,5,female
436,18200,North America,104,734,593.8467477,4918.122753,96.36206897,473920.4839,88,59,51,29,8,18,4,female
1403,15400,AsiaEurope,90,576,496.3295586,3739.307383,58.99056604,220583.8591,94,66,54,28,12,19,5,female
795,17400,Asia,83,559,446.1369639,3563.647042,74.67857143,266128.0702,118,82,61,36,21,24,6,female
499,13300,AsiaEurope,94,674,522.9001971,4417.792886,71.48076923,315787.2338,117,62,50,55,12,19,5,female
467,11900,Asia,89,729,488.323496,4720.809671,63.57,300101.8708,106,90,89,16,1,23,5,female
280,40200,AsiaAfrica,98,663,552.6400215,4385.552627,63.10344828,276743.4933,119,91,68,28,23,24,6,female
717,230300,Asia,102,747,581.4346098,4984.30173,77.29508197,385262.0108,118,73,62,45,11,23,7,female
607,19800,AsiaEurope,85,638,459.8067162,4089.191417,85.95348837,351480.2669,128,83,70,45,13,27,7,female
561,10900,Asia,98,694,550.3593685,4590.608632,65.43137255,300369.8236,91,16,7,75,9,5,1,female
1357,15800,Antarctica,121,855,719.9353928,5915.628068,102.9041096,608742.439,105,76,76,29,0,34,8,female
577,25900,Asia,47,560,235.1694072,3110.569757,23.91666667,74394.46002,116,88,74,28,14,18,5,female
2012,21400,Asia,93,705,517.3960298,4610.106962,69.43636364,320109.0634,95,74,70,21,4,28,5,female
342,107400,Asia,103,762,586.0529843,5095.113402,78.10909091,397974.6759,89,64,52,25,12,33,7,female
1388,59900,Asia,110,738,640.424805,5004.643469,53.73529412,268925.9887,91,61,61,30,0,25,5,female
608,21400,Asia,78,647,412.2983693,4066.655236,70.52631579,286806.2114,113,93,84,20,9,23,6,female
342,36500,Europe,87,641,473.5443757,4129.926781,58.8372093,242993.3664,119,67,53,52,14,15,6,female
280,12900,Asia,97,743,544.8715078,4903.735242,67.72321429,332096.7126,102,17,16,85,1,7,4,female
280,24100,Asia,97,660,543.2584855,4355.942476,71.91,313235.8234,124,60,28,64,32,21,7,female
233,24000,Asia,101,812,571.4865019,5406.467724,116.6666667,630754.5678,129,23,2,106,21,8,6,female
311,14200,AsiaEurope,80,606,425.7903187,3831.088426,61.82926829,236873.3941,111,67,66,44,1,23,5,female
1232,15800,Asia,118,778,694.7639251,5354.696292,73.828125,395327.1872,103,73,65,30,8,34,10,female
919,36400,Asia,97,820,543.2584855,5411.928531,94.94,513808.4947,130,81,63,49,18,23,6,female
546,23500,Asia,105,770,601.1597899,5169.969049,68.22033898,352697.041,96,65,62,31,3,32,10,female
1575,25000,Asia,89,631,487.5430078,4086.187795,65.68085106,268384.292,109,77,70,32,7,16,4,female
202,12900,Asia,97,835,544.452116,5510.927223,68.72727273,378750.9983,105,17,16,88,1,7,4,female
1465,58900,Europe,72,649,372.5956925,4004.281326,80.95454545,324164.7746,130,91,75,39,16,29,4,female
1559,14600,Asia,85,684,460.2145365,4384.0234,75.0326087,328944.7123,130,85,60,45,25,30,5,female
358,18400,Asia,110,844,643.6558456,5723.467598,65.44444444,374569.1573,97,0,0,97,0,0,5,female
468,30200,Asia,43,575,221.6596322,3120.102234,20.5,63962.0958,152,109,89,43,20,29,8,female
373,86800,AsiaEurope,55,608,282.613175,3515.066706,33.22222222,116778.3272,155,81,58,74,23,28,7,female
1481,59500,Asia,91,769,501.4075845,5004.494078,104.3645833,522291.9393,145,86,70,59,16,29,7,female
405,16200,AsiaEurope,94,772,522.2541717,5060.142593,67.95918367,343883.1599,143,99,93,44,6,30,6,female
670,16100,AsiaEurope,94,772,522.2541717,5060.142593,67.95918367,343883.1599,143,99,93,44,6,30,6,female
374,15000,AsiaEurope,94,772,522.2541717,5060.142593,67.95918367,343883.1599,143,99,93,44,6,30,6,female
467,16200,AsiaEurope,94,772,522.2541717,5060.142593,67.95918367,343883.1599,144,99,92,45,7,30,6,female
482,15000,AsiaEurope,93,780,515.3357736,5100.543873,66.44897959,338925.9357,143,99,93,44,6,30,6,female
1216,19400,Asia,98,918,550.7131734,6072.303637,96.36792453,585175.2986,153,113,99,40,14,31,7,female
467,16200,AsiaEurope,94,777,522.2541717,5092.915538,67.95918367,346110.3825,144,99,93,45,6,30,6,female
421,16200,AsiaEurope,94,777,522.2541717,5092.915538,67.95918367,346110.3825,144,99,93,45,6,30,6,female
436,16200,AsiaEurope,94,777,522.2541717,5092.915538,67.95918367,346110.3825,144,99,93,45,6,30,6,female
451,16200,AsiaEurope,94,777,522.2541717,5092.915538,67.95918367,346110.3825,144,99,93,45,6,30,6,female
420,15000,AsiaEurope,93,786,515.3357736,5139.778826,66.44897959,341533.0583,144,99,93,45,6,30,6,female
405,15000,AsiaEurope,97,812,543.5562547,5359.129228,65.76923077,352465.8069,143,99,93,44,6,30,6,female
748,33800,AsiaEurope,92,702,508.4501668,4579.540493,79.41836735,363699.6292,128,68,54,60,14,22,7,female
374,17900,AsiaEurope,94,857,522.16205,5617.282646,90.5625,508715.1596,165,94,76,71,18,31,6,female
405,108200,Asia,0,0,0,0,0,0,116,77,65,39,12,24,5,female
857,15600,Asia,121,1071,723.5907575,7410.102527,84.62179487,627056.176,119,20,19,99,1,12,2,female
93,7000,Asia,128,977,772.4541826,6839,54.48717949,372637.8205,149,74,67,75,7,37,13,female
639,12800,Europe,95,770,529.7522498,5058.788818,83.10576923,420414.5361,160,122,99,38,23,30,8,female
1653,15300,Asia,22,98,85.46551026,437.0242986,9.5,4151.730837,138,39,38,99,1,22,3,female
889,15600,Asia,118,1303,700.4907862,8968.083893,94.31333333,845809.8856,140,20,15,120,5,12,2,female
1809,15600,Asia,113,1163,661.7031787,7931.868133,94.37681159,748584.4244,130,33,31,97,2,20,3,female
1060,92300,Asia,53,1032,271.1333893,5911.213909,39.375,232754.0477,183,142,128,41,14,49,17,female
904,92300,Asia,53,1032,271.1333893,5911.213909,39.375,232754.0477,183,142,128,41,14,49,17,female
1544,28300,Asia,107,799,617.9312396,5386.432122,45.23076923,243632.4683,140,103,90,37,13,36,7,female
499,29200,Asia,108,1096,621.7684232,7403.356702,74.71052632,553108.6757,137,106,102,31,4,59,15,female
608,42400,Europe,98,993,552.134363,6568.406875,62.93859649,413406.3099,170,120,100,50,20,33,9,female
592,32900,Europe,100,1002,566.7355721,6657.143902,62.19491525,414040.5008,170,121,102,49,19,33,9,female
811,74200,Unknown,0,0,0,0,0,0,165,94,75,71,19,44,13,female
483,112100,Asia,107,980,615.8588276,6606.637647,175.704918,1160818.726,150,106,104,44,2,44,11,female
405,30600,Asia,119,1037,702.509796,7149.926021,78.6969697,562677.5114,149,106,102,43,4,37,13,female
577,17800,Europe,128,1612,780.1957163,11284,147.7413793,1667113.724,145,119,100,26,19,56,36,female
810,74200,Unknown,0,0,0,0,0,0,169,94,75,75,19,44,13,female
576,112100,Asia,107,980,615.8588276,6606.637647,175.704918,1160818.726,163,118,115,45,3,50,11,female
545,14900,Asia,127,1193,763.5842671,8337.500831,84.58666667,705241.4037,108,73,68,35,5,42,18,female
951,14600,Asia,129,1085,779.5550655,7607.181572,82.71153846,629201.6912,153,108,99,45,9,27,12,female
748,18600,Asia,94,755,525.2245053,4948.714583,51.92982456,256985.8801,217,84,67,133,17,32,7,female
514,34400,Unknown,67,1184,348.7888228,7182.249602,56.84210526,408254.1879,257,138,74,119,64,51,13,female
124,11200,Asia,126,969,755.9224144,6760.984246,77.64864865,524981.2902,370,60,26,310,34,18,7,female
109,11200,Asia,126,969,755.9224144,6760.984246,77.64864865,524981.2902,369,60,27,309,33,18,7,female
702,14100,Asia,66,271,333.6312234,1638.030806,39.55172414,64786.94258,35,31,31,4,0,13,2,female
1309,10600,Asia,55,280,264.5725015,1618.78072,28.5,46135.25051,27,15,15,12,0,4,1,female
1669,11600,Asia,55,256,262.9879004,1480.028087,26.03571429,38533.5884,44,27,19,17,8,9,1,female
561,12800,Unknown,79,345,419.4466845,2174.804358,51.48837209,111977.136,29,24,24,5,0,14,2,female
561,12700,Unknown,79,345,419.4466845,2174.804358,51.48837209,111977.136,29,24,24,5,0,14,2,female
4476,29400,Asia,54,256,257.2458179,1473.251201,36.25,53405.35602,49,32,22,17,10,6,2,female
779,15700,Europe,59,234,290.8572701,1376.538474,26.90909091,37041.39892,39,32,29,7,3,14,2,female
810,29400,Asia,55,272,263.6191856,1572.529842,37.45833333,58904.347,52,34,23,18,11,6,2,female
514,24500,Asia,73,460,379.1044231,2847.319297,69.74358974,198582.2689,35,29,29,6,0,21,1,female
966,23500,Europe,73,348,378.9461511,2154.058946,53.74285714,115765.2822,56,44,44,12,0,13,2,female
1481,11800,Asia,66,305,332.9737366,1843.540206,39.3125,72474.17436,42,27,27,15,0,16,2,female
764,10600,Asia,72,334,372.2746801,2060.75495,60.25714286,124175.2054,48,37,32,11,5,15,2,female
904,11800,Asia,66,324,335.0885565,1958.383695,53.07692308,103944.9807,59,48,45,11,3,14,2,female
1450,11800,Asia,66,305,332.9737366,1843.540206,39.3125,72474.17436,42,27,27,15,0,16,2,female
561,21700,Asia,70,398,359.2147805,2439.454641,43.25675676,105522.896,50,41,41,9,0,15,2,female
4430,12900,Asia,71,313,365.7235111,1924.870848,56.58823529,108925.0445,39,35,35,4,0,13,2,female
779,11800,Asia,65,286,327.8032081,1722.397195,44.33333333,76359.60896,45,36,35,9,1,14,2,female
920,11900,Europe,77,350,405.6268983,2193.375289,65.40540541,143458.6,67,46,34,21,12,16,2,female
685,21100,Asia,50,245,248.1889572,1382.744766,25.05555556,34645.43832,46,38,38,8,0,14,2,female
577,10600,Asia,75,338,392.17102,2105.340717,40.56756757,85408.55181,59,35,33,24,2,14,2,female
701,11800,Asia,71,344,366.4572094,2115.513009,59.35483871,125565.9334,53,46,44,7,2,17,1,female
920,21200,Europe,73,373,378.9461511,2308.80456,55.37142857,127841.8068,67,56,56,11,0,14,2,female
4773,12000,Asia,64,303,321.1317371,1818,51.38888889,93425,60,42,37,18,5,11,2,female
1169,12900,Asia,68,333,345.9474732,2027.125126,38.5,78044.31736,51,37,37,14,0,15,1,female
483,15900,Asia,69,362,352.4986422,2211.285853,34.48529412,76256.84303,78,69,68,9,1,14,2,female
795,13100,Asia,73,338,378.9461511,2092.160701,49.4,103352.7386,47,34,31,13,3,14,2,female
826,9400,Europe,77,390,405.551932,2444.046751,63.33333333,154789.6276,57,39,31,18,8,14,1,female
4477,18900,Asia,53,314,253.6843594,1798.567023,50.10526316,90117.67398,71,52,41,19,11,15,2,female
592,11800,Asia,78,305,412.2613731,1917.047677,39.5,75723.38323,49,34,30,15,4,9,2,female
826,11800,Asia,62,309,309.4603455,1839.84666,44.33333333,81566.53526,58,52,52,6,0,16,3,female
998,21100,AsiaEurope,45,216,219.07273,1186.240269,19,22538.56511,54,42,39,12,3,11,2,female
685,15400,AsiaEurope,61,310,302.2137048,1838.528575,64.8,119136.6516,58,42,31,16,11,14,2,female
873,51700,Asia,71,334,366.8663501,2054.015538,60.81666667,124918.3783,51,42,42,9,0,16,2,female
2105,9400,Asia,79,388,419.2271063,2445.86693,66.40540541,162418.7851,58,42,38,16,4,14,4,female
811,9400,Asia,75,365,392.17102,2273.518822,57.44736842,130607.6734,47,8,8,39,0,2,1,female
779,9400,Asia,75,365,392.17102,2273.518822,57.44736842,130607.6734,47,8,8,39,0,2,1,female
670,11800,Asia,79,408,419.0078103,2571.942545,56.55,145443.3509,44,32,29,12,3,16,2,female
2730,11800,Unknown,85,442,459.8067162,2832.950794,53.23255814,150805.2178,65,51,46,14,5,18,3,female
2058,11900,Asia,70,404,360.541081,2476.230339,89.06896552,220555.2747,40,34,34,6,0,16,2,female
4117,13900,Asia,69,335,353.0013311,2046.355693,53.93548387,110371.1845,60,41,40,19,1,14,2,female
826,0,Europe,67,326,339.5249056,1977.545076,41.14285714,81361.85456,57,32,18,25,14,6,1,female
2167,11700,Asia,70,404,360.541081,2476.230339,89.06896552,220555.2747,41,34,34,7,0,16,2,female
2761,9400,Asia,75,406,393.3293845,2528.900388,33.48837209,84688.75719,48,37,34,11,3,15,2,female
826,18800,Asia,87,460,473.9427998,2963.754008,62.12765957,184131.1001,62,50,44,12,6,16,2,female
951,17800,AsiaEurope,69,363,352.582306,2217.394378,61.63636364,136672.1262,56,40,33,16,7,14,2,female
2183,11800,Asia,76,314,398.8804611,1961.849239,41.74358974,81894.62978,51,29,20,22,9,13,1,female
4399,117400,Unknown,58,278,285.8598074,1628.518717,31.35,51054.06177,78,63,54,15,9,18,2,female
1247,21500,Unknown,84,384,452.9546635,2454.64989,45.5,111686.57,52,44,44,8,0,21,2,female
748,11800,Asia,77,331,405.7769322,2074.306345,35.875,74415.74013,55,31,31,24,0,8,2,female
904,10600,Asia,66,376,333.6312234,2272.692189,48.48275862,110186.3868,77,44,40,33,4,14,2,female
795,15500,Antarctica,73,403,378.8670746,2494.499297,61.15277778,152545.5612,69,48,32,21,16,13,2,female
1855,12900,Asia,73,383,379.3421297,2370.702806,54.45,129084.7678,52,35,35,17,0,14,1,female
795,11800,Asia,66,355,334.5126491,2145.759912,45.5,97632.07601,59,36,33,23,3,14,2,female
701,9400,Asia,72,330,373.6840496,2036.07525,44.1,89790.91855,71,55,52,16,3,15,2,female
2433,9400,Asia,73,419,379.3421297,2593.53649,37.125,96285.0422,54,39,36,15,3,15,2,female
873,21100,Asia,72,333,372.3949821,2054.585025,52.52941176,107926.1428,67,52,52,15,0,14,2,female
748,9500,Asia,68,326,346.1173001,1984.512886,46.6875,92651.94538,57,45,42,12,3,15,2,female
685,11800,Unknown,73,399,378.8670746,2469.739999,66.80555556,164992.3527,57,46,42,11,4,17,3,female
670,9400,Asia,85,422,460.4869215,2704.762975,58.21276596,157451.734,62,48,46,14,2,13,2,female
780,0,Asia,79,413,420.1071259,2603.461449,49.48888889,128842.4144,49,31,25,18,6,12,1,female
624,15400,Asia,75,346,392.6333688,2155.171267,51.85294118,111751.9689,70,36,30,34,6,12,1,female
685,15400,Unknown,69,364,353.3374044,2223.502902,37.7,83826.05942,62,43,37,19,6,15,2,female
2542,0,Asia,75,314,392.2479866,1955.849069,31.95833333,62505.67649,63,36,30,27,6,5,1,female
4446,11800,Asia,79,419,419.0078103,2641.284133,66.7875,176404.7641,73,46,36,27,10,14,3,female
1122,15400,Europe,62,335,307.1601712,1994.655764,44,87764.85362,55,52,51,3,1,12,1,female
826,12900,Asia,72,552,372.2346001,3405.798601,57,194130.5202,85,76,73,9,3,25,2,female
701,9500,Asia,68,347,346.6279634,2112.349606,43.06666667,90971.85636,74,53,49,21,4,13,2,female
280,13900,Asia,86,543,466.9609738,3489.461762,60,209367.7057,80,59,53,21,6,23,3,female
873,23700,Asia,44,316,210.1173001,1725.180391,18,31053.24705,80,54,42,26,12,12,2,female
732,11800,AsiaAfrica,77,461,405.551932,2888.988595,67.22368421,194208.457,85,70,61,15,9,23,1,female
2308,71900,AsiaEurope,57,353,275.7915183,2059.010175,50.07692308,103108.8941,73,37,26,36,11,10,1,female
4352,15500,AsiaEurope,68,384,345.9474732,2337.585731,55.5,129736.0081,71,54,45,17,9,18,5,female
2745,12200,Asia,92,440,508.6701412,2870.367261,55.02,157927.6067,79,49,36,30,13,14,3,female
1950,369900,Europe,67,358,339.4387425,2171.65993,27.3030303,59292.89688,70,41,36,29,5,6,2,female
1590,14200,Europe,69,393,353.3374044,2400.650112,66.95,160723.525,78,51,36,27,15,15,3,female
3915,9400,AsiaEurope,71,357,366.1306865,2195.459722,45.09375,99001.51182,71,45,39,26,6,12,2,female
4523,23500,Asia,61,387,303.4631705,2295.19535,48.73913043,111865.8255,69,54,50,15,4,17,2,female
951,40000,Unknown,71,451,365.6422056,2773.535951,64.16666667,177968.5568,65,55,55,10,0,16,2,female
280,12900,Africa,81,473,432.536756,2998.749051,72.68292683,217957.8579,68,53,48,15,5,25,3,female
295,12900,Asia,81,473,432.536756,2998.749051,72.68292683,217957.8579,68,53,48,15,5,25,3,female
810,14100,Asia,90,529,494.2667787,3434.190288,68,233524.9396,72,60,55,12,5,26,6,female
2745,0,Asia,55,360,263.6191856,2081.289497,58.77083333,122319.1181,71,48,36,23,12,14,1,female
1029,18200,Asia,84,613,453.092115,3918.49058,112.2,439654.6431,80,65,60,15,5,29,1,female
2246,24300,Asia,55,370,272.9626011,2139.103094,38.07142857,81438.71065,74,44,28,30,16,21,5,female
717,75200,Asia,69,395,352.582306,2412.86716,35.45454545,85547.10842,71,50,44,21,6,14,2,female
483,11300,Asia,100,620,564.6454601,4119.190838,54.98113208,226477.7755,64,53,53,11,0,28,20,female
732,15400,Unknown,53,436,256.7497745,2497.373318,25.4375,63526.93378,93,62,49,31,13,23,1,female
1247,15500,Asia,78,418,412.2613731,2627.298127,38.5,101150.9779,85,56,49,29,7,10,4,female
873,15400,Europe,62,363,307.2067179,2161.373261,50.13333333,108356.8461,62,59,58,3,1,16,1,female
467,11800,Asia,71,456,365.6422056,2804.284686,42.17142857,118260.6914,94,80,78,14,2,20,3,female
717,11800,Asia,88,585,482.043467,3778.767497,49.33333333,186419.1965,101,62,51,39,11,22,3,female
3010,10600,Asia,79,466,419.0078103,2937.561829,35.5875,104540.4816,91,59,59,32,0,10,3,female
2043,16700,Asia,64,393,322.9162238,2358,35.83333333,84495,103,81,78,22,3,12,1,female
2105,16700,Asia,64,393,322.9162238,2358,35.83333333,84495,103,81,78,22,3,12,1,female
2121,16700,Asia,64,393,322.9162238,2358,35.83333333,84495,104,81,78,23,3,12,1,female
889,25800,Asia,102,596,579.9778889,3976.765504,82.68965517,328837.3682,67,50,43,17,7,22,5,female
857,32700,Asia,56,499,279.7803007,2897.870106,40.5,117363.7393,98,74,73,24,1,19,4,female
467,12900,Asia,75,443,392.9423377,2759.36668,56.63636364,156280.4947,103,82,73,21,9,24,2,female
4367,14100,Asia,83,557,446.1369639,3550.896963,68.12195122,241894.0297,76,53,52,23,1,25,3,female
701,15500,Europe,77,516,405.551932,3233.661855,71.61538462,231579.9375,80,36,30,44,6,17,2,female
888,22400,Asia,38,175,162.6452839,918.3873149,25.3,23235.19907,87,57,54,30,3,11,2,female
327,12800,Asia,49,224,228.6387356,1257.695005,29.27777778,36822.51487,96,67,64,29,3,32,5,female
779,25100,Asia,65,519,328.9735285,3125.608895,100.8,315061.3766,100,62,42,38,20,18,4,female
514,48100,Asia,116,605,683.1336612,4149.078502,51.58571429,214033.1782,79,47,37,32,10,11,3,female
716,11800,North America,134,719,819.147473,5080.518128,72.02380952,365918.2699,57,45,40,12,5,33,7,female
748,11800,North America,134,719,819.147473,5080.518128,72.02380952,365918.2699,57,45,40,12,5,33,7,female
2870,15400,Asia,70,484,359.7107722,2966.57298,67.93548387,201535.5708,84,35,22,49,13,12,1,female
1045,23600,Asia,65,365,327.3557123,2198.164252,46.25,101665.0966,91,61,56,30,5,16,3,female
4320,16700,Unknown,73,396,380.0574174,2451.170525,62.32258065,152763.2727,91,60,40,31,20,18,1,female
1262,9600,Asia,87,558,473.9427998,3595.162471,45.95744681,165224.488,102,73,73,29,0,18,2,female
280,15300,Asia,83,522,446.2065082,3327.770583,64.18604651,213596.4374,100,67,62,33,5,22,3,female
4507,18800,Asia,81,574,432.75063,3639.073902,64.5,234720.2667,91,41,41,50,0,15,4,female
4523,11900,Europe,73,441,379.3421297,2729.71263,39.39393939,107534.1339,107,52,41,55,11,8,2,female
732,11800,Asia,104,590,593.0955666,3953.259434,79.29090909,313457.5344,100,66,59,34,7,28,4,female
764,9400,Asia,96,646,538.6054173,4253.885775,48.57894737,206649.2932,117,48,16,69,32,11,4,female
171,13000,Asia,122,600,728.2270778,4158.442403,44.18,183719.9853,71,52,52,19,0,36,15,female
779,15400,AsiaEurope,102,565,578.7005665,3769.920318,56.85849057,214351.9788,99,66,52,33,14,23,7,female
888,18800,Asia,52,383,257.71338,2183.268412,24.22727273,52894.63926,93,43,17,50,26,14,2,female
2355,10700,AsiaEurope,71,493,366.4572094,3031.82533,54.83870968,166261.3891,104,64,59,40,5,13,1,female
4351,15400,Asia,73,388,380.0574174,2401.651929,66.38709677,159438.699,92,60,50,32,10,16,4,female
638,15400,AsiaEurope,108,564,621.9557072,3809.756551,56.89655172,216762.0107,102,68,53,34,15,22,7,female
218,15800,Asia,95,482,529.5086837,3166.670403,57.37254902,181679.9529,99,51,47,48,4,20,3,female
187,15800,Asia,95,479,529.5086837,3146.960836,57.37254902,180549.1648,99,50,46,49,4,20,3,female
187,15500,Asia,95,486,529.5086837,3192.949826,57.37254902,183187.6704,99,49,45,50,4,20,3,female
2417,10700,AsiaEurope,71,482,366.4572094,2964.178112,54.83870968,162551.7029,100,60,55,40,5,12,1,female
779,24900,Asia,34,191,142.0956728,971.7054027,18.81818182,18285.72894,88,48,41,40,7,13,1,female
4570,23500,Asia,61,387,303.4631705,2295.19535,48.73913043,111865.8255,91,54,51,37,3,17,2,female
842,16200,South America,91,537,502.5535519,3494.685722,39.375,137603.2503,126,78,50,48,28,13,3,female
1778,50000,AsiaEurope,82,528,439.3544556,3356.787458,55.23809524,185422.5453,112,61,47,51,14,13,4,female
4929,23700,Asia,42,464,214.8771238,2502.035284,20,50040.70568,140,95,87,45,8,19,2,female
1029,11800,Unknown,104,604,592.8734765,4047.06559,76.5,309600.5176,92,78,78,14,0,28,7,female
1294,10600,Asia,74,452,385.8508604,2806.672921,31.76470588,89153.13985,99,43,32,56,11,9,1,female
935,23500,Asia,40,340,194.1173001,1809.455552,18,32570.19994,99,55,54,44,1,13,2,female
857,12000,Asia,92,491,508.1990654,3203.06892,46.47777778,148871.5255,128,48,17,80,31,14,4,female
187,10600,Asia,121,810,719.3553825,5604.279222,51.72222222,289865.7753,122,93,86,29,7,47,13,female
4398,15400,Asia,75,435,393.7950768,2709.53613,69.5483871,188443.8676,108,76,66,32,10,19,4,female
1231,11800,Asia,79,395,421.065676,2489.993396,39.65625,98743.80059,93,49,46,44,3,14,3,female
716,11800,North America,108,747,621.9557072,5045.900964,63.36206897,319718.7249,96,46,34,50,12,25,8,female
748,15400,Asia,71,651,372.120125,4003.485375,74.08695652,296606.0469,100,66,61,34,5,23,8,female
701,10700,Asia,86,659,466.692323,4234.908473,120.75,511365.1982,150,101,94,49,7,32,8,female
3431,251700,Antarctica,134,1049,817.7421297,7412.327561,98.92682927,733278.0631,142,105,105,37,0,45,11,female
3338,251700,Antarctica,135,1052,825.5511381,7444.810008,98.6746988,734614.3851,143,106,106,37,0,45,11,female
4102,23500,AsiaEurope,74,484,385.6555921,3005.375429,41.22857143,123907.3355,139,53,42,86,11,17,4,female
2386,11900,AsiaEurope,73,482,379.3421297,2983.495437,42.42424242,126572.5337,139,53,42,86,11,17,4,female
1388,29500,Asia,93,1195,517.9616502,7814.294779,68.10810811,532216.8336,168,119,96,49,23,75,20,female
795,23100,Asia,110,825,636.89576,5594.621764,57.03278689,319076.8708,131,74,68,57,6,27,10,female
733,11800,Asia,90,692,498.9397367,4492.362343,46.31578947,208067.3085,181,50,31,131,19,7,1,female
3447,18800,Asia,57,1348,294.284957,7862.735739,56.4,443458.2957,346,279,257,67,22,40,13,female
46,100,Asia,53,240,251.6875812,1374.700909,40.15909091,55206.73878,29,25,25,4,0,7,2,female
31,100,Asia,65,290,326.7316235,1746.486666,24.5,42788.92331,28,20,20,8,0,7,3,female
31,100,Asia,45,259,206.8830545,1422.389952,32.10714286,45668.87739,36,30,30,6,0,8,1,female
31,100,Asia,40,256,176.4876789,1362.413592,29.07692308,39614.79522,61,55,54,6,1,14,4,female
46,400,Asia,43,214,192.3819626,1161.220658,33.75,39191.19719,32,27,25,5,2,7,1,female
46,300,Asia,56,324,269.6764904,1881.582995,29.14,54829.32847,44,39,39,5,0,13,1,female
30,400,Asia,43,304,199.6842869,1649.584485,44.55,73488.98883,53,44,42,9,2,13,1,female
31,100,Asia,52,230,246.4385619,1311.101135,24.8,32515.30815,37,33,33,4,0,8,2,female
31,100,Asia,63,327,314.9612072,1954.570535,49.80769231,97352.6478,54,40,38,14,2,10,3,female
31,200,Asia,64,327,320,1962,34.5,67689,50,46,44,4,2,10,1,female
31,100,Asia,48,302,227.6306219,1686.658675,22.88461538,38598.53507,50,29,29,21,0,8,1,female
31,100,Unknown,62,354,307.3464548,2107.785494,44.94827586,94741.32384,59,49,44,10,5,14,3,female
31,0,Asia,59,402,288.1860234,2364.822506,30.44642857,72000.39951,40,21,21,19,0,3,1,female
31,400,Asia,41,285,182.7116542,1526.902321,33.38461538,50975.04673,50,47,47,3,0,12,1,female
31,100,Europe,47,342,221.0794529,1899.669387,35.30769231,67072.94221,72,55,45,17,10,17,1,female
46,300,Asia,43,297,198.0537478,1611.600632,37.81818182,60947.80572,64,48,43,16,5,13,1,female
31,2700,Unknown,87,580,475.4109925,3736.907228,53.64705882,200474.0819,39,33,33,6,0,23,3,female
31,100,Asia,66,455,333.6312234,2750.199324,33.17241379,91230.75,92,86,85,6,1,16,1,female
46,0,Asia,94,470,524.6331211,3080.65676,39.69642857,122291.071,57,45,42,12,3,19,3,female
31,100,Asia,44,321,210.1173001,1752.47755,29.25,51259.96833,56,50,47,6,3,19,1,female
31,100,Asia,70,428,359.2147805,2623.333131,73.43939394,192655.9953,58,49,44,9,5,11,3,female
31,200,Europe,36,332,174.9737366,1716.4151,17,29179.05671,53,41,39,12,2,15,1,female
46,100,Europe,54,447,261.1759501,2572.434713,19,48876.25956,53,33,19,20,14,27,1,female
31,100,Europe,44,372,198.6059378,2030.908562,35,71081.79967,78,67,64,11,3,17,1,female
15,100,Asia,74,372,385.5385456,2309.916652,38.84210526,89722.02575,57,49,48,8,1,9,1,female
30,100,Asia,50,377,240.8554909,2127.733784,41.26923077,87809.93653,58,50,48,8,2,13,2,female
31,100,Europe,69,345,353.0013311,2107.440938,34.93548387,73624.46888,62,53,49,9,4,11,3,female
31,100,Asia,13,28,40.05374781,103.6123121,5.5,569.8677166,57,38,35,19,3,15,2,female
46,400,Asia,36,336,174.9737366,1737.0948,17,29530.61161,72,59,54,13,5,13,2,female
46,4400,Asia,76,500,399.1845378,3123.963757,43.53658537,136006.7148,84,78,77,6,1,12,1,female
31,100,Asia,55,379,265.2124025,2191.135331,29.14285714,63855.94394,47,32,28,15,4,17,2,female
62,30800,Asia,37,309,181.5249056,1609.72109,17.5,28170.11907,66,54,54,12,0,15,1,female
31,8000,Asia,72,377,372.2746801,2326.061726,35.41428571,82375.81454,68,45,38,23,7,10,3,female
31,100,Asia,51,349,242.4606049,1979.676444,33,65329.32266,85,32,18,53,14,8,2,female
31,100,Asia,46,381,219.336581,2104.477105,23.4,49244.76426,107,104,104,3,0,20,1,female
46,100,Asia,68,442,347.4830616,2690.658576,65,174892.8074,69,57,57,12,0,17,3,female
31,100,Europe,49,347,230.4650059,1948.304316,49.5,96441.06364,72,48,42,24,6,14,1,female
31,100,AsiaEurope,66,437,333.3240179,2641.40023,47.4,125202.3709,90,35,24,55,11,9,2,female
31,100,Asia,46,407,215.9932866,2248.089716,29.75,66880.66905,91,68,54,23,14,21,2,female
46,200,Asia,49,425,228.6387356,2386.251684,30.13888889,71918.97436,114,109,109,5,0,19,2,female
31,200,Asia,71,495,368.5969538,3044.124824,35.03703704,106657.1142,73,48,48,25,0,15,2,female
31,200,Unknown,54,376,262.2366428,2163.837701,26.11764706,56514.34936,67,40,40,27,0,11,1,female
31,0,Asia,58,606,283.0128366,3549.936483,26.20833333,93037.91866,105,93,93,12,0,26,2,female
31,0,Asia,65,607,328.9735285,3655.577263,40,146223.0905,91,75,75,16,0,26,2,female
31,300,Asia,70,470,360.0838417,2880.763018,44,126753.5728,92,86,86,6,0,19,2,female
31,9800,Asia,87,521,473.5443757,3356.773561,58.14772727,195188.7536,111,63,47,48,16,13,8,female
31,100,Asia,67,415,347.5042379,2517.427014,37.6,94655.25573,76,51,46,25,5,17,3,female
31,300,Asia,76,412,398.9944238,2574.146136,40.05,103094.5527,74,50,44,24,6,12,3,female
46,200,Europe,63,452,316.1697866,2701.730525,44.6875,120733.5829,87,61,38,26,23,25,3,female
31,200,AsiaEurope,57,357,278.3559659,2082.341735,30.85714286,64255.1164,70,49,46,21,3,11,1,female
46,200,AsiaEurope,46,406,219.336581,2242.566154,39.6,88805.6197,63,55,51,8,4,14,1,female
31,100,Asia,64,553,320.0450916,3318,37.79032258,125388.2903,97,79,75,18,4,23,3,female
31,100,Asia,52,465,252.7242144,2650.704469,23.07142857,61155.53882,66,43,40,23,3,12,2,female
31,400,Asia,63,479,318.7159976,2863.117083,39,111661.5663,99,65,64,34,1,11,1,female
30,100,Europe,63,428,315.5176503,2558.275807,34.2,87493.03261,91,40,28,51,12,10,2,female
31,3300,Asia,73,498,379.6596322,3082.53263,39.078125,120459.5954,95,59,59,36,0,16,2,female
31,100,Asia,73,485,378.8670746,3002.064911,34.43055556,103362.7627,78,56,54,22,2,12,1,female
46,1400,Asia,73,510,378.9461511,3156.810525,48.85714286,154232.7428,84,55,55,29,0,16,3,female
31,100,Asia,57,409,277.0156616,2385.652016,31.7826087,75822.2445,79,54,50,25,4,12,1,female
31,1100,Asia,94,665,523.2394163,4358.801586,41.77358491,182082.7682,77,67,65,10,2,32,4,female
31,200,Asia,42,386,191.6338334,2081.434525,18.31818182,38128.09608,110,93,87,17,6,30,1,female
31,400,AsiaEurope,67,540,339.6973857,3275.688163,38.32258065,125532.8238,108,79,73,29,6,18,3,female
31,1700,Asia,91,721,504.0920843,4692.119936,34.69090909,162773.9061,140,108,96,32,12,31,5,female
46,100,Asia,50,416,244.1844343,2347.844175,31.90909091,74917.57322,92,69,63,23,6,17,3,female
31,100,Unknown,41,372,208.1306865,1993.009346,19.5,38863.68224,111,85,85,26,0,20,1,female
31,0,Asia,78,797,414.08385,5009.465568,80.69565217,404242.0911,151,135,124,16,11,36,7,female
31,0,Asia,48,519,232.6405265,2898.595538,53.2,154205.2826,82,77,76,5,1,32,1,female
31,1000,Unknown,73,486,378.9461511,3008.254736,42.34285714,127378.1005,114,73,66,41,7,16,5,female
31,100,Asia,49,404,234.2230164,2268.342777,56.76923077,128772.0746,111,85,70,26,15,22,1,female
31,100,Asia,46,376,223.4212455,2076.859295,28.5,59190.48992,97,84,83,13,1,21,2,female
31,11800,Asia,66,683,332.9737366,4128.321184,41.96875,173260.4797,135,120,115,15,5,29,1,female
31,0,Asia,73,603,378.9461511,3732.464209,39.08571429,145886.0297,108,77,70,31,7,21,4,female
31,100,Asia,71,617,365.7235111,3794.393973,57.13235294,216782.6556,71,66,66,5,0,29,1,female
30,200,AsiaEurope,63,441,314.1308434,2635.980446,43.125,113676.6567,102,95,91,7,4,24,2,female
31,1000,Asia,50,576,240.8554909,3250.861165,59.76923077,194301.4712,143,120,116,23,4,24,1,female
46,200,Asia,113,759,658.7614447,5176.515832,39.68253968,205417.2949,104,73,66,31,7,40,12,female
46,200,Asia,39,446,194.7497745,2357.28939,18.5,43609.85371,122,81,63,41,18,26,1,female
31,200,Asia,56,638,271.7635715,3705.09244,39.16666667,145116.1206,170,148,146,22,2,22,2,female
31,0,Asia,84,574,454.1955001,3669.190201,28.125,103195.9744,83,55,54,28,1,26,2,female
31,100,Europe,49,552,232.8278745,3099.319834,58.75,182085.0402,132,113,99,19,14,21,1,female
31,300,Unknown,50,573,235.05865,3233.929597,37.33333333,120733.3716,115,81,69,34,12,35,2,female
31,100,AsiaEurope,71,619,367.3587806,3806.693467,73.13793103,278413.6843,138,107,89,31,18,25,1,female
31,100,Asia,62,696,315.2736412,4144.120632,36.66666667,151951.0898,156,109,103,47,6,24,3,female
31,100,Asia,58,685,284.2247957,4012.716982,62.18181818,249518.0378,145,111,111,34,0,31,1,female
31,200,AsiaEurope,44,652,240.2149912,3559.549415,0,0,156,94,76,62,18,25,4,female
31,100,Asia,85,675,460.0105131,4326.338882,55.11111111,238429.3428,105,61,51,44,10,21,3,female
46,200,Asia,34,766,158.3349731,3896.996536,15.5,60403.44631,187,173,173,14,0,27,1,female
46,0,Asia,48,689,232.6405265,3848.039163,53.2,204715.6835,106,84,81,22,3,31,1,female
31,100,AsiaEurope,97,935,544.452116,6170.918507,75.98181818,468877.608,142,105,99,37,6,28,3,female
31,3400,Asia,53,529,254.5835556,3030.06992,26.25,79539.33541,131,115,111,16,4,29,1,female
31,1700,Asia,62,807,319.669035,4805.036422,43.86666667,210780.9311,166,127,123,39,4,42,3,female
31,0,Asia,74,1115,386.9094701,6923.540503,77.13953488,534078.6941,236,116,-2,120,118,40,3,female
31,100,Asia,79,596,420.5488559,3757.053326,44.60606061,167587.3484,120,95,89,25,6,35,3,female
31,14300,Asia,93,696,515.7710242,4551.254533,36.23529412,164916.0466,104,47,39,57,8,17,1,female
31,100,Asia,73,642,378.8670746,3973.867367,38.54166667,153159.4714,139,109,99,30,10,21,1,female
31,200,Europe,82,746,439.3544556,4742.733795,102.375,485537.3723,145,109,100,36,9,27,8,female
31,100,Asia,49,596,239.3499675,3346.367067,42.9,143559.1472,163,145,140,18,5,22,2,female
31,100,Europe,103,1296,589.445759,8665.704683,150.7936508,1306733.246,101,76,60,25,16,48,32,female
46,100,Asia,57,679,276.0964047,3960.53232,38.4,152084.4411,145,125,113,20,12,23,2,female
31,100,Asia,38,932,184.2797931,4891.068443,17.5,85593.69774,224,210,210,14,0,33,1,female
31,3900,Asia,74,674,388.0148382,4185.171568,43.44827586,181838.4888,160,97,66,63,31,20,3,female
46,21500,Asia,101,898,571.6579841,5979.073912,58.41509434,349268.1666,125,83,79,42,4,23,10,female
31,1100,Asia,71,576,366.1306865,3542.254341,40.828125,144623.603,171,91,81,80,10,27,3,female
46,3400,AsiaEurope,42,843,210.885574,4545.723587,19.5,88641.60995,233,178,175,55,3,35,3,female
31,200,Asia,66,724,335.7560369,4376.141342,45.92,200952.4104,156,135,130,21,5,27,1,female
31,100,South America,54,556,259.4122985,3199.717451,74.8,239338.8653,136,126,121,10,5,33,1,female
31,100,Europe,89,592,488.714938,3833.634191,51.78431373,198522.1157,148,91,71,57,20,27,5,female
46,100,Asia,107,980,615.8588276,6606.637647,175.704918,1160818.726,140,98,96,42,2,49,8,female
31,3800,AsiaEurope,95,616,529.3261988,4047.031055,46.8,189401.0534,121,56,50,65,6,21,6,female
46,4000,Asia,134,1884,817.1076343,13312.51203,88.66049383,1180293.891,176,107,104,69,3,74,32,female
31,4000,Asia,134,1886,817.1076343,13326.64421,88.66049383,1181546.857,178,108,105,70,3,74,32,female
31,100,Asia,76,726,401.9471249,4535.995375,41.32758621,187461.7399,261,65,26,196,39,32,14,female
31,100,Asia,74,1322,385.8508604,8208.897349,44.11764706,362157.236,327,281,281,46,0,56,2,female
31,33800,Asia,244,6863,1737.148,54428.65035,92.16666667,5016507.274,1823,1368,1302,455,66,395,78,female
233,18000,Asia,51,267,238.9889445,1514.537566,27.02272727,40926.9356,40,36,36,4,0,10,3,female
1512,34000,Asia,39,262,187.5249056,1384.775381,17.5,24233.56917,69,48,40,21,8,9,2,female
233,15500,Asia,0,0,0,0,0,0,56,44,38,12,6,14,5,female
295,70700,Europe,68,297,348.0415947,1807.976464,41.75925926,75499.75789,46,33,29,13,4,14,2,female
1528,22100,AsiaEurope,78,400,412.2613731,2514.160888,64.5,162163.3772,53,47,47,6,0,16,3,female
202,14900,Asia,64,337,320.4063545,2022,35,70770,52,31,31,21,0,7,2,female
1559,21800,Asia,64,358,321.1317371,2148,58.92592593,126572.8889,68,50,41,18,9,17,3,female
1575,25400,Asia,64,358,321.1317371,2148,58.92592593,126572.8889,68,50,41,18,9,17,3,female
1497,21800,Asia,64,364,321.1317371,2184,58.92592593,128694.2222,69,50,41,19,9,17,3,female
249,18200,Africa,75,328,392.17102,2043.05253,50.83783784,103864.3732,59,45,38,14,7,10,4,female
374,32100,Asia,72,475,372.2746801,2930.714376,49.18918919,144159.4639,64,56,56,8,0,20,3,female
327,32000,Asia,0,0,0,0,0,0,67,55,49,12,6,20,5,female
295,24900,North America,85,408,460.0105131,2615.031502,51.11111111,133657.1657,81,56,40,25,16,12,2,female
295,18700,Europe,68,371,347.4830616,2258.448714,59.28571429,133893.7452,63,42,39,21,3,16,3,female
1621,21700,Unknown,57,315,277.0156616,1837.360354,40.65217391,74692.69267,77,65,64,12,1,12,3,female
1513,13300,Asia,84,447,453.092115,2857.365888,53.63636364,153258.7158,64,24,24,40,0,8,2,female
187,14900,Asia,87,523,473.9427998,3369.659448,48.5106383,163464.3307,51,0,0,51,0,0,2,female
920,26000,Asia,61,302,303.4631705,1791.082676,36.34782609,65101.96161,77,49,41,28,8,9,2,female
1559,28000,Asia,52,277,249.0117739,1579.021802,38.08823529,60142.15393,62,44,39,18,5,11,2,female
342,71300,Europe,81,386,432.536756,2447.182101,42.025,102842.8278,77,59,59,18,0,15,4,female
265,41600,Asia,65,367,326.5538222,2210.208987,26.87096774,59390.4544,72,41,33,31,8,13,2,female
1528,28200,Asia,83,500,446.5546348,3187.519716,70.08888889,223409.7152,80,64,56,16,8,18,5,female
264,21800,Asia,62,365,307.5796744,2173.281653,49.78571429,108198.3795,57,51,51,6,0,11,2,female
264,32200,Asia,85,519,460.0105131,3326.473896,47.55555556,158192.3142,88,83,83,5,0,22,4,female
217,11500,Asia,89,461,487.3483806,2985.313112,64.04444444,191192.7197,70,27,21,43,6,9,3,female
311,80900,Asia,77,527,406.6799972,3302.596507,52.875,174624.7903,37,29,29,8,0,21,4,female
826,57200,Asia,78,464,412.4094067,2916.42663,51.8902439,151334.0891,64,52,46,12,6,21,4,female
264,18200,Asia,94,488,522.16205,3198.63936,41.2173913,131839.5701,48,33,33,15,0,20,8,female
295,18200,Asia,94,488,522.16205,3198.63936,41.2173913,131839.5701,49,33,33,16,0,20,8,female
841,31200,Asia,53,374,258.0246044,2142.24225,40.53333333,86832.2192,66,52,47,14,5,14,3,female
1528,21800,AsiaAfrica,63,400,314.1308434,2390.911969,45.625,109085.3586,90,57,46,33,11,14,3,female
483,57300,AsiaEurope,70,471,359.7107722,2886.892301,56.61290323,163435.3545,83,61,54,22,7,21,3,female
280,22900,Asia,64,410,323.7015572,2460,32.08695652,78933.91304,94,72,64,22,8,19,5,female
810,41600,Asia,39,389,190.8721876,2056.021463,18,37008.38634,58,36,34,22,2,12,2,female
249,21800,AsiaEurope,71,352,366.1306865,2164.710986,53.625,116082.6266,87,59,39,28,20,16,3,female
233,20000,Unknown,56,366,274.4798955,2125.491901,27.44444444,58332.94441,86,50,35,36,15,12,2,female
280,18900,Asia,100,529,564.385619,3514.599924,43.5,152885.0967,50,35,35,15,0,21,8,female
1481,21800,Asia,60,368,295.6213103,2173.735739,56.7,123250.8164,80,61,54,19,7,15,3,female
264,19700,Asia,72,372,372.3949821,2295.212101,36.88235294,84652.82277,72,48,41,24,7,13,2,female
1138,41400,Asia,90,538,495.0699333,3492.616966,62,216542.2519,87,64,53,23,11,22,7,female
311,34900,Asia,59,390,294.7182822,2294.230789,30.75,70547.59677,74,46,41,28,5,14,3,female
264,28600,Asia,72,510,372.8771238,3146.661751,55.625,175033.0599,82,64,58,18,6,15,3,female
748,15800,AsiaEurope,77,433,405.7769322,2713.518572,45.65853659,123895.287,68,46,40,22,6,15,2,female
763,21800,Asia,61,382,302.2137048,2265.541663,58.32,132126.3898,82,62,55,20,7,15,3,female
296,27600,Asia,74,384,385.6555921,2384.430092,50.14285714,119562.1375,72,57,57,15,0,15,3,female
1512,46200,Asia,89,612,487.7378322,3963.14886,65.77083333,260659.6031,85,17,17,68,0,5,1,female
280,17400,Asia,72,377,372.3949821,2326.061726,37.13157895,86370.3446,87,50,34,37,16,11,4,female
77,17200,Asia,108,584,622.8406536,3944.854301,73.58196721,290270.1399,63,6,-4,57,10,7,1,female
77,17200,Asia,108,584,622.8406536,3944.854301,73.58196721,290270.1399,63,6,-4,57,10,7,1,female
763,29900,Asia,91,479,503.0010296,3117.233633,52.33962264,163154.832,89,62,58,27,4,16,3,female
686,29900,Asia,91,480,503.0010296,3123.741427,52.33962264,163495.4475,89,62,58,27,4,16,3,female
295,19700,Asia,74,506,386.4773318,3141.983403,42.28571429,132861.0125,84,68,66,16,2,18,4,female
327,42900,Asia,93,574,516.8946117,3753.477158,59.58333333,223644.6806,100,76,64,24,12,24,7,female
483,70600,Asia,86,618,466.692323,3971.431618,53.93181818,214186.528,98,75,71,23,4,26,5,female
233,17900,AsiaEurope,67,367,339.6973857,2226.254733,56.90322581,126681.0758,85,51,43,34,8,12,3,female
764,35900,Asia,50,365,246.0964047,2060.007509,32,65920.2403,80,59,57,21,2,16,4,female
436,41600,Asia,75,442,392.4020294,2753.137861,35.875,98768.82077,77,67,67,10,0,21,3,female
1434,23600,AsiaEurope,64,344,320.0450916,2064,47.37096774,97773.67742,74,53,42,21,11,10,2,female
343,24700,Europe,64,398,320.0450916,2388,31.40322581,74990.90323,85,69,62,16,7,12,2,female
265,24700,Asia,99,531,557.4885414,3520.188365,56.49038462,198856.7947,75,45,42,30,3,15,5,female
1481,18900,AsiaEurope,63,450,313.8551855,2689.775966,59.20689655,159253.2873,82,61,54,21,7,19,2,female
155,33300,Asia,86,602,466.7930215,3868.611382,61.5,237919.6,93,60,49,33,11,26,5,female
342,28500,Asia,45,300,227.6596322,1647.555929,20.5,33774.89654,85,68,68,17,0,12,2,female
405,37400,Asia,93,571,517.3960298,3733.859681,52.50909091,196061.5774,78,65,61,13,4,20,4,female
452,37400,Asia,93,577,517.3960298,3773.094634,52.50909091,198121.7691,78,65,61,13,4,20,4,female
1497,140000,Unknown,66,491,336.5164318,2967.797513,50.75,150615.7238,105,66,63,39,3,17,3,female
421,40600,North America,75,524,392.17102,3263.900994,50.63157895,165256.4608,103,70,60,33,10,16,6,female
280,18200,AsiaEurope,80,442,426.079159,2794.292218,37.43023256,104591.0076,91,47,39,44,8,11,3,female
826,22300,Asia,0,0,0,0,0,0,86,68,68,18,0,13,2,female
811,19600,Asia,66,357,334.0271833,2157.848701,44.10714286,95176.5409,91,57,45,34,12,14,2,female
327,29900,Asia,89,622,487.5430078,4027.906194,58.53191489,235761.0626,121,87,82,34,5,23,4,female
311,31300,Unknown,83,653,446.3456778,4162.900749,54.95454545,228770.3184,91,68,68,23,0,24,5,female
842,27500,Asia,77,515,407.6639356,3227.395068,48.96774194,158038.2488,91,48,48,43,0,13,5,female
1668,36000,AsiaEurope,46,433,231.2692727,2391.702327,24.6,58835.87724,116,71,54,45,17,17,2,female
405,56300,Asia,79,562,421.065676,3542.72478,71.96875,254965.474,87,13,13,74,0,5,2,female
1544,33800,Asia,60,513,296.1564001,3030.234876,36.75,111361.1317,106,97,92,9,5,29,4,female
295,30700,Asia,46,430,217.5786534,2375.131641,27.04545455,64236.51484,111,88,78,23,10,18,2,female
389,22900,Asia,97,611,544.8715078,4032.546747,60.40178571,243573.0245,84,70,70,14,0,21,4,female
826,32600,Asia,77,533,407.6639356,3340.197226,48.96774194,163561.9158,92,49,49,43,0,13,5,female
436,52600,Asia,89,563,487.5430078,3645.837922,59.87234043,218284.8492,92,78,78,14,0,25,4,female
280,34900,Unknown,58,289,283.5668306,1692.956508,42.71428571,72313.42797,108,54,48,54,6,16,4,female
1684,49800,Asia,105,823,603.0459669,5525.824061,76.33333333,421804.57,133,74,56,59,18,19,4,female
701,66400,Asia,50,470,250.4773318,2652.612409,31.5,83557.29089,108,75,68,33,7,18,4,female
810,21800,Europe,43,133,191.698301,721.6932124,32.88235294,23730.97092,93,73,67,20,6,18,4,female
888,66400,Asia,50,467,250.4773318,2635.680841,31.5,83023.94648,108,75,68,33,7,18,4,female
1528,64100,AsiaEurope,60,512,297.5287411,3024.327985,69.95454545,211565.4895,98,82,74,16,8,24,3,female
811,35300,Asia,58,391,285.8598074,2290.470569,38.95,89213.82867,106,87,84,19,3,9,3,female
436,31700,Asia,97,560,543.5562547,3695.951192,63.60576923,235083.8186,104,74,51,30,23,26,3,female
265,51000,Asia,86,619,467.1963626,3977.857883,60.85897436,242088.3509,129,68,49,61,19,25,5,female
373,28900,Europe,66,529,333.6312234,3197.484489,69.53448276,222335.4301,108,64,56,44,8,20,3,female
467,35400,Asia,80,593,426.6582949,3748.90336,49.38888889,185154.1715,103,79,79,24,0,23,4,female
249,28900,AsiaEurope,97,510,543.5562547,3365.95555,53.65384615,180596.4612,91,66,57,25,9,24,7,female
264,28900,AsiaEurope,97,512,543.5562547,3379.155375,53.65384615,181304.6826,91,66,57,25,9,24,7,female
467,76700,Asia,85,574,459.8067162,3678.990397,55.6744186,204825.6514,113,33,33,80,0,9,1,female
249,21800,AsiaEurope,90,487,494.5555318,3161.532458,49.875,157681.4313,89,43,36,46,7,9,3,female
1544,49900,Asia,66,554,333.3240179,3348.594342,52.2,174796.6247,132,98,70,34,28,26,4,female
280,35300,Europe,45,439,212.7441865,2410.923509,24.5,59067.62598,156,70,17,86,53,20,6,female
951,23300,Asia,91,638,501.8524417,4151.97298,72.57,301308.6792,109,39,13,70,26,12,2,female
436,35900,Asia,81,580,432.9647657,3677.113002,57.18181818,210264.0071,112,69,53,43,16,19,3,female
233,30300,Asia,97,673,544.8715078,4441.741343,61.86607143,274793.0872,93,44,37,49,7,17,4,female
373,74100,Asia,85,539,460.0105131,3454.661715,48.88888889,168894.5727,94,78,78,16,0,17,3,female
342,59600,Asia,94,596,522.6230769,3906.534956,63.23529412,247030.8869,113,94,81,19,13,26,6,female
264,53800,AsiaEurope,63,499,320.925614,2982.662682,32.42105263,96701.06379,138,65,46,73,19,19,6,female
249,23300,Asia,81,685,432.536756,4342.797252,59.45,258179.2966,124,88,88,36,0,21,6,female
1543,32300,Asia,114,739,665.3547617,5049.50572,76.02459016,383886.6029,98,74,70,24,4,31,7,female
889,35200,Asia,74,582,385.6555921,3613.901859,80.22857143,289938.1834,115,81,68,34,13,23,5,female
248,30300,Asia,96,675,536.6378566,4444.849688,68.11538462,302762.6461,99,50,44,49,6,17,4,female
436,26200,Asia,84,738,452.9890166,4717.530258,82.85365854,390864.6411,152,115,98,37,17,28,5,female
1637,63900,Unknown,60,477,304.2149912,2817.586814,33,92980.36487,118,69,52,49,17,18,4,female
265,25300,Asia,48,502,244.9390249,2803.651175,25.8,72334.20032,113,56,26,57,30,22,6,female
811,24300,Asia,100,740,565.4268669,4916.45358,70.71428571,347663.5032,110,85,84,25,1,25,8,female
374,33900,Asia,88,701,480.9553238,4528.061565,80.83333333,366018.3098,121,94,82,27,12,27,9,female
280,37400,AsiaEurope,90,552,495.424379,3583.502909,45.11764706,161679.2195,128,68,45,60,23,12,3,female
265,21800,Europe,108,694,624.7832923,4687.891927,62.18461538,291514.7564,130,81,67,49,14,32,14,female
467,31600,Asia,107,804,615.8588276,5420.139457,93.50819672,506827.4666,88,62,57,26,5,26,10,female
327,43600,Asia,84,792,452.9890166,5062.715399,82.85365854,419464.4929,162,122,105,40,17,29,6,female
607,41300,North America,95,668,530.851908,4388.663546,53.09090909,232998.1374,149,81,59,68,22,18,6,female
295,33700,Asia,91,642,501.4075845,4178.004159,85.55208333,357436.96,129,62,44,67,18,25,8,female
545,93800,Europe,112,780,653.0138619,5309.736839,64.12121212,340466.7622,134,97,96,37,1,28,5,female
295,34800,Asia,52,535,259.6966127,3049.735249,29.4,89662.21633,125,110,108,15,2,32,9,female
389,37500,Asia,87,675,473.7434822,4348.98686,69.9673913,304287.2654,114,91,86,23,5,31,7,female
1512,21700,Asia,82,478,439.6362367,3038.909858,34.97727273,106292.7789,105,55,47,50,8,13,3,female
889,19500,Asia,63,318,314.1308434,1900.775016,38.125,72467.04747,133,57,55,76,2,14,2,female
327,36900,Asia,52,536,259.6966127,3055.435689,29.4,89829.80925,131,112,110,19,2,32,9,female
826,21000,Unknown,99,583,558.5412601,3864.91491,58.35714286,225545.3915,125,63,34,62,29,19,6,female
249,30700,Asia,88,685,480.7253082,4424.710659,65.42553191,289489.0484,163,110,108,53,2,28,9,female
264,27500,Asia,119,821,703.680997,5660.645384,75.36231884,426599.3622,169,115,97,54,18,32,12,female
920,20900,Asia,110,1039,637.6343112,7045.832742,115.2619048,812116.1025,158,5,-9,153,14,1,1,female
810,38000,Asia,0,0,0,0,0,0,225,153,114,72,39,37,10,female
451,46400,Asia,95,746,529.5086837,4901.112284,72.90196078,357300.6955,149,118,110,31,8,36,6,female
498,112100,Asia,0,0,0,0,0,0,124,84,72,40,12,22,4,female
233,24400,Asia,80,753,426.6582949,4760.411855,55.92857143,266243.0345,185,133,125,52,8,23,9,female
311,22100,Asia,80,580,426.6582949,3666.718295,46.92857143,172073.8514,130,78,77,52,1,14,3,female
405,34300,Asia,124,1033,744.345223,7183.684789,64.87179487,466018.526,187,96,48,91,48,31,8,female
264,29600,Asia,93,508,515.2115894,3321.892676,45.86666667,152364.1441,184,54,16,130,38,17,4,female
233,115800,Asia,70,1098,368.6313714,6729.952753,41.25,277610.551,191,143,128,48,15,51,19,female
514,42200,Asia,110,988,638.08385,6699.983397,76.1875,510454.9851,140,79,64,61,15,21,5,female
842,30700,Asia,101,565,575.2908578,3761.889488,39,146713.69,132,51,41,81,10,18,4,female
1668,77100,Asia,104,732,594.2093292,4904.721874,41.18644068,202008.0365,133,70,61,63,9,17,2,female
374,30900,Asia,77,792,406.0022373,4963.29494,46.2,229304.2262,241,171,142,70,29,41,14,female
312,51500,Asia,127,1214,764.7353731,8484.26321,98.7012987,837407.7973,172,23,23,149,0,9,4,female
327,43600,Asia,98,1269,550.2415647,8394.066792,92.5,776451.1783,261,193,165,68,28,46,17,female
467,21900,Asia,93,739,518.5920309,4832.438361,50.52631579,244165.3067,189,49,31,140,18,13,4,female
358,141800,Asia,153,1665,967.9654031,12083.55076,86.92,1050302.232,139,66,61,73,5,51,34,female
436,30300,Asia,138,1309,848.3780137,9305.058514,114.4176471,1064662.901,199,123,84,76,39,56,21,female
311,30300,Asia,144,1313,894.3150596,9414.111527,113.0898876,1064640.815,199,123,84,76,39,55,20,female
296,141800,Asia,161,1719,1032.100893,12601.84611,88.06542056,1109786.878,141,68,63,73,5,53,34,female
327,141800,Asia,161,1719,1032.100893,12601.84611,88.06542056,1109786.878,141,68,63,73,5,53,34,female
483,15300,Asia,108,1044,621.7684232,7052.102552,89.47368421,630977.5968,295,169,146,126,23,42,12,female
311,32000,Asia,143,1433,881.4725755,10260.09563,96.42857143,989366.3639,207,109,70,98,39,55,33,female
296,25400,Asia,125,1567,746.422204,10915.38397,116.0955882,1267227.923,295,195,159,100,36,52,24,female
265,20000,Asia,16,253,55.30296891,1012,7,7084,256,83,72,173,11,26,8,female
280,53200,Asia,6,14,15.509775,36.18947501,0,0,190,108,108,82,0,81,40,female
280,25400,Asia,136,2041,829.6185035,14465.51166,154.012987,2227876.659,369,249,206,120,43,72,29,female
405,44000,Asia,135,2045,821.9184309,14472.0879,156.0394737,2258216.978,370,250,207,120,43,72,29,female
358,34600,Asia,49,373,235.7693245,2094.286772,30.83333333,64573.84213,285,68,23,217,45,34,18,female
233,17200,Asia,71,321,366.1306865,1974.068825,29.12820513,57501.08168,105,38,38,67,0,13,3,female
31,500,Asia,77,323,405.551932,2024.172053,45.30769231,91710.56454,27,18,16,9,2,12,1,female
62,19500,Asia,67,322,339.5249056,1953.280719,31.08571429,60719.12636,56,49,49,7,0,16,2,female
78,31300,Unknown,98,434,553.8346812,2870.784072,39.58333333,113635.2029,41,35,35,6,0,15,1,female
93,31500,Asia,58,352,284.2247957,2062.00931,40.90909091,84354.92633,41,36,36,5,0,21,1,female
62,15900,Asia,63,346,316.1697866,2068.138854,30.0625,62173.42428,38,26,26,12,0,7,1,female
62,15800,Asia,0,0,0,0,0,0,49,38,33,11,5,16,4,female
62,16500,Asia,64,383,322.9162238,2298,27.5,63195,63,54,54,9,0,17,2,female
46,21400,Asia,77,381,405.551932,2387.645672,35.92105263,85766.74585,65,56,56,9,0,18,1,female
171,4100,Asia,78,381,413.1887278,2394.738245,58.23529412,139458.2861,55,35,31,20,4,20,3,female
280,15800,Asia,97,411,544.452116,2712.564178,38.56363636,104606.3386,54,47,47,7,0,17,4,female
78,4100,Asia,81,375,432.9647657,2377.443751,33.63636364,79968.56254,53,32,29,21,3,7,2,female
46,20700,Asia,86,471,466.9609738,3026.770699,42.17391304,127650.7643,55,48,48,7,0,19,2,female
77,16100,Asia,75,510,392.17102,3176.697532,73.94594595,234903.904,57,48,48,9,0,16,1,female
46,16000,South Africa,85,484,460.2145365,3102.145213,43.66304348,135449.1013,61,51,51,10,0,20,4,female
78,4000,Europe,73,404,378.9461511,2500.689122,64.6,161544.5173,59,42,35,17,7,16,1,female
46,15600,Asia,64,330,320.1804545,1980,24.93333333,49368,54,43,41,11,2,19,4,female
62,4100,Asia,82,562,439.6362367,3572.944227,44.47727273,158914.8148,58,49,49,9,0,25,1,female
78,15900,AsiaEurope,59,390,288.3819626,2294.230789,62.22222222,142752.138,53,43,38,10,5,18,2,female
655,96900,North America,72,378,372.3949821,2332.231651,46.94117647,109477.6975,71,39,20,32,19,14,3,female
155,58200,Asia,87,551,473.5443757,3550.061866,71.34090909,253264.6409,60,52,51,8,1,19,2,female
171,4000,Asia,65,422,326.5538222,2541.439217,47.86764706,121652.7155,83,57,51,26,6,19,4,female
15,600,Asia,71,471,366.1306865,2896.530893,36.5625,105904.4108,51,19,19,32,0,10,1,female
61,16000,Asia,83,470,446.2065082,2996.268533,33.95348837,101733.7688,52,31,31,21,0,12,1,female
46,16200,Asia,82,470,439.3544556,2988.049442,50,149402.4721,63,44,38,19,6,20,1,female
46,4000,Asia,70,445,359.4212455,2727.530943,57,155469.2637,74,46,40,28,6,17,1,female
374,47200,Asia,89,522,490.9485208,3380.332851,33.38181818,112841.6566,70,63,63,7,0,20,3,female
140,15900,Asia,69,403,354.8592943,2461.735356,76.22222222,187638.9394,62,54,52,8,2,16,3,female
764,66300,AsiaEurope,34,294,162,1495.714075,16,23931.42521,58,38,35,20,3,15,2,female
31,20800,Asia,73,478,380.0574174,2958.736139,43.35483871,128275.5281,63,36,35,27,1,21,1,female
467,236200,Asia,82,530,439.6362367,3369.502562,54.42105263,183371.8763,62,52,52,10,0,20,3,female
451,236200,Asia,82,530,439.6362367,3369.502562,54.42105263,183371.8763,62,52,52,10,0,20,3,female
46,15900,Europe,56,333,270.5069309,1933.849189,19.36956522,37457.81799,50,44,44,6,0,19,1,female
155,4100,Asia,84,499,453.2640759,3189.766394,64.03846154,204267.7325,72,50,45,22,5,27,4,female
155,62600,Asia,37,339,181.5249056,1766.004691,17.5,30905.08209,71,54,44,17,10,7,2,female
155,4200,Asia,84,500,453.2640759,3196.158711,64.03846154,204677.0867,72,50,45,22,5,27,4,female
139,17100,Europe,63,490,314.9612072,2928.867163,53.36538462,156300.1226,66,51,50,15,1,20,3,female
62,31500,Asia,71,450,365.8862514,2767.386204,58.72727273,162521.0443,45,40,40,5,0,18,2,female
124,31500,Asia,42,442,210.885574,2383.404301,19.5,46476.38387,47,28,24,19,4,10,1,female
61,4000,Asia,81,371,432.6080183,2352.084351,49,115252.1332,69,54,52,15,2,18,2,female
46,4200,Asia,56,435,276.8771238,2526.199391,28.75,72628.23249,77,64,64,13,0,19,1,female
77,19700,Asia,66,377,333.3240179,2278.736583,29.4,66994.85554,67,58,56,9,2,19,2,female
62,47400,Asia,88,414,482.043467,2674.20469,39.53921569,105735.956,63,50,45,13,5,17,3,female
61,32000,Asia,96,562,536.6378566,3700.748925,44.42307692,164398.6542,55,45,45,10,0,29,4,female
155,19400,AsiaEurope,75,449,392.9423377,2796.739592,78.27272727,218908.4353,63,53,48,10,5,19,1,female
186,31600,Asia,68,386,347.4830616,2349.760657,62.14285714,146020.8408,61,45,45,16,0,17,3,female
187,15800,Europe,83,455,446.2065082,2900.642941,90.8375,263487.1532,72,35,22,37,13,14,3,female
935,20300,South America,71,490,365.6422056,3013.376089,61.25,184569.2854,71,64,64,7,0,19,5,female
468,15900,Asia,69,360,352.7497745,2199.068804,42.78125,94078.91229,75,50,40,25,10,17,2,female
46,16000,Asia,72,489,372.5956925,3017.093326,68.54545455,206808.0334,72,48,44,24,4,19,1,female
873,16800,AsiaEurope,66,371,333.6312234,2242.470218,52.94827586,118734.9317,64,39,28,25,11,11,1,female
46,16100,Asia,71,537,370.1802547,3302.414203,83.72,276478.1171,62,48,48,14,0,13,2,female
826,15800,Asia,77,437,405.7769322,2738.585718,49.54166667,135674.1008,56,42,41,14,1,15,2,female
93,126000,Asia,0,0,0,0,0,0,76,55,46,21,9,16,3,female
202,15900,Asia,60,440,296.7916995,2599.031862,35.39130435,91983.12764,86,60,56,26,4,19,2,female
46,17500,Asia,81,543,433.2506894,3442.538552,46.875,161368.9946,84,69,67,15,2,15,5,female
702,15700,AsiaEurope,74,489,385.5385456,3036.422696,65.44444444,198716.9964,72,52,52,20,0,24,2,female
342,39500,Asia,79,541,419.0808777,3410.345385,60.96052632,207896.4496,59,49,49,10,0,30,4,female
327,39700,Asia,79,541,419.0808777,3410.345385,60.96052632,207896.4496,59,49,49,10,0,30,4,female
155,16000,Asia,76,440,398.8804611,2749.088106,66.93243243,184003.1539,81,51,32,30,19,18,5,female
31,8000,Asia,78,482,412.5946318,3029.563869,33.42857143,101273.9922,89,60,50,29,10,15,1,female
46,8000,Asia,79,496,419.4466845,3126.675251,35.1627907,109942.6274,79,60,60,19,0,16,1,female
140,19600,Asia,73,535,378.8670746,3311.556139,62.69444444,207616.1724,76,61,51,15,10,23,2,female
732,97100,Unknown,74,575,385.6555921,3570.435685,51.15384615,182641.5177,91,64,59,27,5,24,4,female
46,15800,Asia,70,452,359.2147805,2770.435924,71.75757576,198799.7657,74,55,42,19,13,16,2,female
46,17200,Europe,61,433,302.7888745,2568.009267,70.14583333,180135.1501,55,49,46,6,3,20,1,female
31,600,Asia,91,531,501.5981141,3455.638954,70,241894.7268,62,45,40,17,5,22,4,female
405,40600,Asia,100,579,567.2905595,3846.792734,44.66666667,171823.4088,97,60,48,37,12,27,6,female
109,31400,Asia,70,514,360.541081,3150.451471,78.46551724,247201.8042,97,73,63,24,10,23,3,female
46,4000,Asia,91,571,501.8524417,3715.95074,46.74,173683.5376,69,46,43,23,3,26,1,female
296,4000,Asia,96,567,537.6344164,3733.673738,48.08181818,179521.8218,85,73,68,12,5,20,4,female
46,4000,Asia,92,579,508.6701412,3777.142373,47.88,180849.5768,69,46,43,23,3,26,1,female
61,16800,Europe,59,400,290.8572701,2353.05722,46.25,108828.8964,63,54,50,9,4,17,1,female
62,4200,Asia,85,567,460.0105131,3634.124661,46.125,167624,58,48,46,10,2,32,5,female
77,31400,Asia,69,441,352.7497745,2693.859285,45.09375,121476.2172,62,50,49,12,1,19,2,female
62,15800,Europe,62,440,307.3464548,2619.846377,43.24137931,113285.7709,74,63,59,11,4,22,1,female
46,15800,Asia,74,584,385.5385456,3626.320766,46.42105263,168337.6271,99,67,61,32,6,18,3,female
795,16000,Asia,61,408,303.4631705,2419.740834,54.52173913,131928.4785,96,70,52,26,18,21,4,female
140,27600,Asia,99,684,561.9099458,4534.479928,64.4516129,292254.545,85,70,63,15,7,27,1,female
358,800,Europe,74,553,385.6555921,3433.827711,80.22857143,275491.0918,75,62,52,13,10,30,2,female
93,35600,Asia,67,409,339.9564924,2481.030479,33.91666667,84148.28374,86,74,67,12,7,23,3,female
514,16100,Asia,81,463,432.9647657,2935.350551,62.43243243,183261.075,84,59,46,25,13,21,9,female
30,200,Asia,71,560,366.1306865,3443.858387,76.78125,264423.7518,83,75,74,8,1,25,3,female
61,4000,Asia,66,529,333.3240179,3197.484489,67.2,214870.9577,73,68,68,5,0,24,2,female
31,19700,Asia,92,519,508.4501668,3385.728655,50.89795918,172326.6789,88,63,51,25,12,13,3,female
62,17200,Asia,57,395,277.6324012,2303.991556,51.70454545,119126.8361,74,63,55,11,8,20,1,female
62,17000,Unknown,58,457,289.1465005,2677.097315,33.76470588,90391.40345,87,60,51,27,9,19,2,female
62,15800,Asia,50,450,242.4407955,2539.735285,28.5,72382.45563,77,53,49,24,4,12,1,female
62,17200,AsiaEurope,61,415,301.7363383,2461.255995,59.90384615,147438.7005,73,54,41,19,13,20,1,female
109,31700,Asia,98,657,552.6400215,4345.864368,70.34482759,305709.0797,113,77,54,36,23,21,2,female
919,4000,Asia,75,457,393.7950768,2846.570142,41.87096774,119188.6466,82,48,48,34,0,12,2,female
140,4000,Asia,74,473,386.1246381,2937.071442,65.84848485,193401.7043,97,50,36,47,14,15,2,female
296,19000,AsiaEurope,67,404,341.8710649,2450.700033,37.05769231,90817.28776,69,54,46,15,8,18,2,female
62,900,Europe,72,600,372.3949821,3701.955001,90.52941176,335135.8086,82,68,57,14,11,32,2,female
78,15900,Asia,87,459,473.5443757,2957.311065,37.13636364,109823.7791,75,56,52,19,4,20,2,female
46,9500,Europe,73,491,380.0574174,3039.203858,81.29032258,247057.862,81,63,51,18,12,20,1,female
108,27300,Asia,100,724,567.9056641,4810.151881,54.02459016,259866.484,82,75,75,7,0,37,4,female
62,11900,Asia,82,433,439.3544556,2752.820018,38.0952381,104869.334,84,53,46,31,7,16,2,female
46,1100,AsiaEurope,65,465,328.3421192,2800.401033,68.25,191127.3705,67,51,45,16,6,21,2,female
187,31600,Asia,73,485,378.9461511,3002.064911,68.4,205341.2399,75,60,60,15,0,22,4,female
46,11800,Asia,108,566,625.4073436,3823.266326,41.68181818,159360.6919,69,46,45,23,1,22,4,female
139,32100,Asia,59,463,290.159225,2723.663732,57.91304348,157735.6561,98,78,69,20,9,17,3,female
140,3900,Asia,68,484,346.3298602,2946.332015,74,218028.5691,59,52,52,7,0,18,1,female
171,4000,Asia,68,484,346.3298602,2946.332015,74,218028.5691,59,52,52,7,0,18,1,female
234,15800,Unknown,66,486,336.5164318,2937.575542,36.75,107955.9012,71,46,41,25,5,10,1,female
124,63100,Asia,46,501,242.2149912,2767.30454,22,60880.69988,88,57,46,31,11,21,4,female
46,9100,AsiaEurope,66,580,333.3240179,3505.748589,81,283965.6357,102,91,89,11,2,26,1,female
810,13300,Asia,99,634,557.6636341,4203.012097,42.09433962,176923.0187,83,55,50,28,5,24,5,female
62,16100,Asia,65,507,327.3557123,3053.340481,56.82142857,173495.1681,107,56,56,51,0,13,3,female
62,4200,Asia,66,406,333.3240179,2454.024012,54,132517.2967,84,51,41,33,10,17,3,female
62,32300,Asia,76,621,398.842491,3879.962986,76,294877.1869,89,67,60,22,7,24,3,female
31,300,Asia,99,587,561.1962231,3891.432336,39.55737705,153934.8562,98,62,52,36,10,14,3,female
93,16900,Asia,80,472,425.7903187,2983.950061,51.51282051,153711.6839,85,50,44,35,6,14,1,female
46,15900,Europe,52,486,247.1756287,2770.413703,23.44736842,64958.91077,100,69,50,31,19,27,2,female
62,16800,Asia,0,0,0,0,0,0,80,50,44,30,6,12,1,female
31,700,AsiaEurope,73,471,380.0574174,2915.407367,75.19354839,219219.8249,78,55,51,23,4,17,1,female
46,19500,Asia,75,479,392.2479866,2983.604153,48.75,145450.7024,67,57,57,10,0,11,2,female
62,8600,AsiaEurope,85,563,460.2145365,3608.487097,58.5,211096.4952,102,44,32,58,12,20,3,female
61,15800,Asia,77,637,405.551932,3991.943026,48.23076923,192534.4829,115,67,62,48,5,19,3,female
108,19500,Asia,67,554,341.2590864,3360.613412,61.48148148,206615.4912,93,57,49,36,8,19,3,female
139,75900,Asia,62,385,309.4603455,2292.365579,29.29166667,67147.20843,109,63,33,46,30,17,2,female
61,800,Europe,77,419,406.0022373,2625.783561,51,133914.9616,74,62,57,12,5,17,3,female
93,16600,Asia,100,640,565.1081736,4252.067961,44.18181818,187864.0936,92,64,64,28,0,31,5,female
31,16000,Asia,83,583,446.5546348,3716.647988,78.75,292686.0291,85,51,48,34,3,18,3,female
77,700,North America,68,486,347.0121354,2958.506941,66.56896552,196944.7465,83,69,58,14,11,22,1,female
108,47400,Asia,88,580,480.5611817,3746.470339,75.02380952,281074.4771,99,73,59,26,14,25,10,female
93,5900,Asia,98,602,552.6400215,3982.055326,51.03448276,203222.1339,83,49,46,34,3,19,4,female
296,15900,Asia,75,534,392.9423377,3326.189181,52.18181818,173566.5991,115,67,40,48,27,26,6,female
171,16000,Asia,66,553,336.5164318,3342.549948,64.75,216430.1091,97,53,33,44,20,20,7,female
592,16000,Asia,81,540,432.75063,3423.519002,76.38157895,261493.7869,94,50,42,44,8,19,3,female
78,15800,AsiaEurope,92,567,508.1677,3698.859629,92,340295.0859,85,66,58,19,8,23,4,female
61,15700,Asia,0,0,0,0,0,0,91,68,61,23,7,27,4,female
62,15700,Asia,0,0,0,0,0,0,91,68,61,23,7,27,4,female
78,31900,Asia,80,575,426.3322913,3635.108655,58.90909091,214140.9462,92,68,60,24,8,24,3,female
249,63300,Asia,75,560,394.3401072,3488.138467,54.75,190975.5811,65,57,54,8,3,19,3,female
78,900,Asia,70,639,359.7107722,3916.611848,88.69354839,347378.2024,101,71,62,30,9,28,1,female
46,900,Europe,67,511,340.3026944,3099.771576,75.34482759,233551.755,88,65,48,23,17,23,3,female
171,31600,AsiaEurope,74,673,385.8508604,4178.962115,51.76470588,216322.7448,129,60,35,69,25,21,2,female
109,16000,Unknown,63,396,314.1308434,2367.00285,46.875,110953.2586,118,80,55,38,25,22,2,female
61,36100,AsiaEurope,90,491,494.5555318,3187.49987,46.375,147820.3065,98,54,46,44,8,10,2,female
483,15900,Asia,66,535,333.6312234,3233.750854,52.94827586,171221.5323,96,57,44,39,13,26,3,female
46,8200,Asia,96,712,536.4270818,4688.493301,83.82352941,393006.0561,100,77,72,23,5,25,2,female
109,31600,Asia,61,340,302.2137048,2016.450695,28.08,56621.93551,89,52,42,37,10,18,2,female
62,18100,Asia,83,631,448.094519,4022.649881,85.75,344942.2273,119,90,89,29,1,28,6,female
514,20000,Asia,84,582,453.2640759,3720.32874,86.53846154,321951.5256,108,77,63,31,14,28,10,female
529,700,Asia,81,680,432.9647657,4311.098002,93.94594595,405010.1799,103,95,90,8,5,31,4,female
46,4000,Europe,85,517,461.2380824,3313.655114,70.77777778,234533.1453,115,84,65,31,19,21,7,female
62,32900,AsiaEurope,71,628,365.6422056,3862.041191,62.22857143,240329.3061,85,65,58,20,7,19,1,female
748,19800,Asia,74,606,385.6555921,3762.92874,57.38571429,215938.3535,83,67,62,16,5,29,4,female
78,26700,Asia,105,688,600.5529308,4619.400916,45.47368421,210061.1785,107,76,70,31,6,36,5,female
592,16000,Asia,84,597,453.092115,3816.213501,81.95,312738.6964,101,57,49,44,8,22,3,female
624,4400,Asia,86,612,466.7930215,3932.87403,58.7195122,230936.4446,97,54,50,43,4,23,3,female
61,700,Europe,55,549,282.613175,3173.966483,56.22222222,178447.4489,100,57,47,43,10,11,4,female
685,63100,Asia,45,430,224.4867643,2361.496831,24,56675.92395,107,46,14,61,32,16,2,female
62,18100,Asia,83,631,448.094519,4022.649881,85.75,344942.2273,125,90,89,35,1,28,6,female
46,9100,Europe,41,432,200.7497745,2314.462466,18.5,42817.55562,132,61,23,71,38,18,3,female
46,19900,Asia,100,619,566.2402295,4112.546981,61.55172414,253134.3573,78,53,48,25,5,19,2,female
61,15900,Asia,107,874,616.2935606,5892.042146,63.87096774,376330.4338,114,70,65,44,5,21,3,female
46,4100,Asia,85,535,460.0105131,3429.024151,70.3125,241103.2606,99,81,77,18,4,23,3,female
62,31500,Asia,99,700,557.3135919,4640.549634,53.9,250125.6253,81,56,56,25,0,27,7,female
77,4400,Unknown,72,453,372.5956925,2794.976026,50.81818182,142035.5998,108,77,63,31,14,20,3,female
109,1500,Unknown,71,685,369.344822,4212.576777,63.17307692,266121.4368,107,81,77,26,4,25,4,female
62,31400,Unknown,89,476,487.9979062,3082.449113,57.55102041,177398.0918,102,79,67,23,12,20,1,female
46,4100,Asia,81,555,433.2506894,3518.616752,73.75,259497.9854,109,80,66,29,14,25,5,female
483,31700,AsiaAfrica,76,630,401.9471249,3936.194333,55.9137931,220087.5556,106,68,66,38,2,24,3,female
31,100,AsiaEurope,75,732,392.6333688,4559.495281,112.75,514083.093,121,111,104,10,7,31,5,female
592,1700,South America,83,601,446.2065082,3831.398698,69.3375,265659.6072,92,71,64,21,7,28,4,female
61,47300,Asia,109,656,633.6071054,4439.928917,50.34558824,223530.8331,114,38,29,76,9,11,2,female
77,31400,Asia,38,175,162.6452839,918.3873149,25.3,23235.19907,102,70,67,32,3,15,2,female
46,4000,Asia,107,619,615.8588276,4172.968065,64.47540984,269053.8262,107,65,47,42,18,28,4,female
140,31800,Asia,53,485,268.7443162,2778.04142,26.88888889,74698.44708,117,89,85,28,4,25,4,female
639,253100,Asia,99,737,558.1897755,4885.835829,71.25,348115.8028,92,67,67,25,0,36,11,female
156,192800,Asia,84,703,452.9546635,4493.799148,64,287603.1455,122,83,78,39,5,23,4,female
62,15800,Asia,76,603,399.4510684,3767.500291,44.47058824,167542.9541,126,67,48,59,19,18,3,female
31,700,Europe,70,548,362.4264239,3358.847093,67.69230769,227368.1109,111,66,56,45,10,15,5,female
171,31600,Asia,99,856,557.6636341,5674.729267,68.56603774,389093.701,80,58,51,22,7,25,4,female
61,36200,AsiaEurope,72,371,372.8771238,2289.042176,53.125,121605.3656,110,56,50,54,6,14,1,female
405,800,Asia,84,652,454.1955001,4167.79096,71.33333333,297302.4218,101,46,28,55,18,21,3,female
124,27800,Asia,101,796,571.5436477,5299.93634,65.79591837,348714.1788,121,88,86,33,2,41,8,female
61,2400,Asia,106,681,609.3751625,4581.71383,62.4516129,286135.4185,114,70,51,44,19,31,5,female
62,5000,Asia,100,720,565.1081736,4783.576457,87.13636364,416823.4576,144,95,83,49,12,28,8,female
233,31800,Unknown,63,623,316.1697866,3723.845392,47.9375,178511.8385,135,77,61,58,16,19,3,female
46,4100,Asia,113,772,658.4538637,5265.178159,48.53225806,255530.9852,114,87,81,27,6,43,12,female
62,15900,Asia,84,591,452.9890166,3777.859597,59.59302326,225134.0748,138,68,47,70,21,23,5,female
93,16000,Asia,82,704,439.460071,4475.716611,65.75581395,294304.3888,125,96,92,29,4,27,2,female
78,47000,Asia,61,566,301.0709438,3356.797333,53.03571429,178030.1443,118,99,93,19,6,29,2,female
202,67300,Asia,91,737,501.2172393,4796.24465,74.62222222,357906.4341,101,41,41,60,0,18,5,female
62,19800,Asia,39,209,177.5800856,1104.649064,15.5,17122.06049,110,66,56,44,10,25,6,female
93,20800,Europe,77,746,405.551932,4675.022759,72.1025641,337081.1282,139,105,99,34,6,28,5,female
654,98800,AsiaEurope,76,597,401.2905678,3730.012726,45.23333333,168720.909,144,67,46,77,21,21,6,female
93,17500,Asia,95,633,530.0571158,4158.7186,51.50943396,214213.2411,91,46,41,45,5,16,3,female
77,16000,Asia,78,574,414.6457617,3607.820874,40.17741935,144952.9322,116,60,38,56,22,18,3,female
46,4300,Asia,58,524,303.6501074,3069.582041,29.94444444,91916.92891,144,100,93,44,7,30,4,female
124,15900,Unknown,71,558,369.344822,3431.558893,57.11538462,195994.806,116,75,75,41,0,21,2,female
46,19100,Asia,99,693,559.9530637,4594.144138,63.72881356,292779.3552,104,80,80,24,0,26,2,female
46,15900,Asia,121,776,717.5272573,5369.037872,53.77941176,288743.6985,151,86,71,65,15,35,7,female
78,35800,Unknown,73,520,381.7393272,3218.708771,42.58928571,137082.5075,116,56,39,60,17,20,2,female
46,4000,Asia,119,771,704.1705935,5315.904496,74.9,398161.2467,109,80,73,29,7,33,4,female
62,15800,Asia,76,815,398.9944238,5092.060923,56.66666667,288550.119,136,100,99,36,1,28,5,female
46,21600,AsiaEurope,79,622,419.4466845,3920.951625,59.125,231826.2648,123,77,70,46,7,22,1,female
61,8500,Asia,70,568,359.4212455,3481.432754,59.375,206710.0697,131,79,66,52,13,21,5,female
77,55000,Asia,123,926,736.6264136,6428.768432,67.20779221,432063.3329,136,56,35,80,21,22,2,female
46,16100,Asia,90,586,494.2667787,3804.225914,28,106518.3256,101,48,41,53,7,24,1,female
171,31700,Asia,61,619,308.3880345,3671.126412,29.86111111,109623.9137,206,151,131,55,20,35,12,female
436,20100,Europe,69,544,353.3374044,3323.037304,39,129598.4549,128,62,47,66,15,19,4,female
62,16100,Asia,93,618,515.149526,4041.200145,29.11956522,117677.9912,105,50,43,55,7,24,1,female
482,141700,AsiaEurope,109,933,632.9053075,6314.715975,70.52238806,445328.8505,164,121,109,43,12,32,7,female
249,6300,Asia,141,1102,873.5604711,7867.78559,51.56666667,405715.4769,95,48,45,47,3,35,17,female
62,31900,Asia,70,512,360.541081,3138.192905,50.18965517,157504.8198,145,93,79,52,14,28,2,female
62,32000,Asia,78,1014,414.6457617,6373.39785,59.12903226,376852.8471,174,114,102,60,12,26,3,female
62,19900,Asia,94,870,522.16205,5702.492301,73.79166667,420796.411,178,107,92,71,15,33,6,female
93,130500,Asia,0,0,0,0,0,0,114,68,55,46,13,18,3,female
530,173800,Asia,75,733,393.7950768,4565.7241,72.38709677,330499.5123,143,121,118,22,3,35,8,female
483,173600,Asia,75,733,393.7950768,4565.7241,72.38709677,330499.5123,143,121,118,22,3,35,8,female
607,129600,Asia,61,699,308.3880345,4145.585399,29.86111111,123791.7862,236,163,131,73,32,37,13,female
30,600,AsiaEurope,80,526,425.8985773,3325.334178,40.34210526,134150.9814,146,58,46,88,12,20,4,female
62,31600,AsiaEurope,85,547,459.8067162,3505.936842,41.51162791,145537.1457,148,60,47,88,13,21,4,female
514,173400,Asia,126,1079,760.6612396,7528.485037,83.33333333,627373.7531,187,116,79,71,37,39,9,female
31,200,Asia,158,1629,1026.614,11897.85884,47.5210084,565398.2499,146,142,140,4,2,69,2,female
607,189200,Asia,43,229,190.7497228,1242.614629,22.73684211,28253.13261,138,60,46,78,14,24,3,female
109,8300,Asia,119,1114,705.3002761,7680.826988,133.1666667,1022830.127,148,98,86,50,12,35,10,female
124,8300,Asia,119,1114,705.3002761,7680.826988,133.1666667,1022830.127,148,98,86,50,12,35,10,female
997,31500,Asia,130,1263,788.6486326,8869.250548,67.14814815,595553.7498,244,129,85,115,44,24,6,female
156,102500,Asia,103,973,586.2775517,6505.965013,49.9375,324891.6278,157,87,79,70,8,28,6,female
62,4200,Europe,106,873,607.1595682,5873.474557,81.5,478688.1764,217,68,33,149,35,24,10,female
93,16200,Asia,115,951,674.0507942,6510.061038,58.65151515,381824.9436,169,113,109,56,4,27,11,female
155,16100,Asia,116,944,680.1484193,6473.934059,68.56349206,443875.5265,167,113,109,54,4,29,10,female
109,8900,Europe,99,1341,557.3135919,8889.967228,87.24489796,775604.2836,220,86,30,134,56,49,30,female
31,15700,Asia,153,1408,960.8354139,10218.40208,82.95,847616.4527,244,156,134,88,22,51,26,female
608,172800,Asia,93,743,518.5920309,4858.594997,50.52631579,245486.9051,201,74,56,127,18,27,5,female
888,31300,AsiaEurope,108,672,622.8406536,4539.284401,62.79508197,285044.7361,116,49,44,67,5,26,7,female
124,31400,Asia,139,1547,850.5795187,11013.00184,104.8732394,1154969.179,226,115,73,111,42,57,35,female
46,15900,Asia,6,14,15.509775,36.18947501,0,0,152,73,73,79,0,72,38,female
31,15900,Asia,6,14,15.509775,36.18947501,0,0,152,73,73,79,0,71,38,female
46,15900,Asia,6,14,15.509775,36.18947501,0,0,152,73,73,79,0,72,38,female
61,16000,Asia,149,1619,934.9002079,11687.83383,72.18947368,843738.573,334,200,166,134,34,72,40,female
109,63500,Asia,124,1602,742.2821841,11140.62249,83.3,928013.8534,321,241,221,80,20,55,14,female
93,16600,Asia,47,350,222.5444556,1944.106098,29.16666667,56703.09453,276,66,28,210,38,36,16,female
93,16300,Asia,107,1507,615.1541399,10159.39075,138.28125,1404853.252,332,175,133,157,42,67,17,female
31,900,Asia,80,1643,437.8703933,10386.92786,50.09090909,520290.6592,504,361,300,143,61,82,25,female
92,44300,Asia,210,4369,1452.042082,33703.53867,162.4622642,5475553.202,542,264,181,278,83,206,148,female
93,16500,Asia,73,432,380.0574174,2674.004209,32.8452381,87828.30493,45,36,34,9,2,18,1,female
93,11800,Asia,88,469,480.7253082,3029.473429,36.63829787,110994.7499,43,32,32,11,0,13,2,female
592,25500,AsiaEurope,56,307,272.5558619,1782.857961,41.4,73810.31959,51,46,46,5,0,10,2,female
405,25500,Asia,62,400,309.4603455,2381.678524,62.54166667,148954.1444,67,61,61,6,0,17,2,female
78,20600,Asia,80,405,425.7903187,2560.380878,42.57692308,109013.1397,53,38,35,15,3,18,2,female
546,18600,Asia,55,250,265.2124025,1445.339928,28.33333333,40951.29797,48,38,34,10,4,13,2,female
77,20600,Asia,79,404,419.0808777,2546.727422,44.23684211,112659.1789,56,42,39,14,3,18,2,female
467,22700,Asia,58,369,284.9884404,2161.594987,38.76190476,83787.53903,52,49,48,3,1,16,1,female
124,26700,Unknown,53,311,255.6041684,1781.383261,30.70588235,54698.94485,66,48,45,18,3,12,3,female
108,11700,Asia,63,443,314.4992626,2647.935006,42,111213.2703,67,61,61,6,0,25,2,female
327,23500,Asia,49,322,229.4868683,1807.93657,27.29411765,49346.03343,76,61,61,15,0,14,3,female
389,18200,Asia,57,312,278.3559659,1819.861684,42.85714286,77994.07219,72,53,43,19,10,14,3,female
561,31000,Asia,32,241,149.2067179,1205,15,18075,74,67,66,7,1,11,2,female
358,21800,Asia,58,300,284.9884404,1757.394299,29.95238095,52638.14351,64,55,55,9,0,12,3,female
109,12000,Asia,67,474,339.5249056,2875.326276,38.28125,110071.084,55,0,0,55,0,0,3,female
124,19600,Asia,81,550,433.2506894,3486.917502,44,153424.3701,55,41,38,14,3,17,2,female
374,15200,Asia,62,340,307.9068682,2024.426746,46.66666667,94473.24812,50,42,38,8,4,13,2,female
77,11800,Asia,66,380,333.6312234,2296.869765,45.93103448,105497.6044,70,0,0,70,0,0,2,female
327,22500,Asia,51,330,242.4606049,1871.900363,27,50541.3098,83,67,67,16,0,13,3,female
405,22100,Asia,62,353,310.1726115,2101.831298,47.47826087,99791.29465,77,48,35,29,13,9,2,female
124,23100,Asia,40,307,201.4212455,1633.831925,19,31042.80658,76,58,52,18,6,12,2,female
62,16500,Unknown,96,658,540.5307358,4332.905325,57.9,250875.2183,34,29,29,5,0,24,2,female
389,18200,Asia,59,294,290.8572701,1729.497057,33.63636364,58173.9919,59,54,53,5,1,13,2,female
109,27900,Asia,65,386,327.8032081,2324.633976,40.11111111,93243.6517,65,46,44,19,2,14,2,female
576,21500,Asia,69,361,352.582306,2205.177329,34.90909091,76980.73585,73,55,51,18,4,9,2,female
93,20200,Unknown,52,316,251.3531335,1801.338951,32.06666667,57762.93569,73,49,39,24,10,13,3,female
108,20200,Unknown,53,324,258.0246044,1855.846227,32.93333333,61119.20242,73,51,43,22,8,14,3,female
109,8400,Europe,62,289,310.1726115,1720.762734,37.30434783,64191.93154,70,40,22,30,18,8,2,female
93,18600,Africa,72,323,373.2397178,1992.885775,42.32258065,84344.06895,60,52,49,8,3,13,2,female
124,16100,Asia,66,344,333.3240179,2079.271577,55.2,114775.7911,48,45,45,3,0,12,1,female
639,17600,Asia,69,368,352.582306,2247.937,30.54545455,68664.25746,56,48,44,8,4,12,2,female
109,16100,Asia,66,344,333.3240179,2079.271577,55.2,114775.7911,48,45,45,3,0,12,1,female
61,11800,Asia,94,545,522.4078007,3572.250924,40.48,144604.7174,46,32,32,14,0,21,3,female
109,36400,AsiaEurope,53,342,256.7497745,1958.948795,26.59375,52095.79453,72,44,36,28,8,10,2,female
545,22500,Asia,56,287,272.5558619,1666.710863,36.9,61501.63083,69,57,50,12,7,12,3,female
733,32100,Asia,53,397,259.4336554,2273.98442,36.21428571,82350.72151,52,37,32,15,5,16,2,female
93,10800,Asia,69,456,353.0013311,2785.487152,64.96774194,180966.8105,74,0,-6,74,6,0,2,female
78,11800,Asia,82,487,439.460071,3096.127826,51.69767442,160062.6083,60,0,-3,60,3,0,2,female
639,19600,Asia,80,450,428.700868,2844.867643,33.98387097,96679.61489,43,30,30,13,0,22,8,female
139,12300,Europe,83,529,446.8336245,3372.395859,67.9673913,229212.949,74,57,47,17,10,16,3,female
93,18200,Asia,0,0,0,0,0,0,83,71,71,12,0,14,3,female
482,25400,Asia,57,302,280.1318683,1761.532784,38,66938.2458,62,45,43,17,2,12,3,female
436,17500,Europe,64,354,320.7232379,2124,27.64285714,58713.42857,67,55,52,12,3,21,1,female
514,19500,AsiaAfrica,60,346,296.1564001,2043.784146,37.5,76641.90548,68,57,49,11,8,16,2,female
155,35200,Asia,70,431,359.2147805,2641.72098,38.12121212,100705.6059,50,48,48,2,0,26,3,female
530,27300,Asia,45,314,211.0274844,1724.441872,20.09090909,34645.60489,87,82,81,5,1,18,4,female
576,21500,Asia,64,319,320.7232379,1914,35.35714286,67673.57143,72,55,52,17,3,12,3,female
140,15700,Europe,77,535,406.0022373,3352.730799,59.58333333,199766.8768,64,53,53,11,0,17,2,female
109,17600,Asia,103,658,588.8198034,4399.717347,73.07258065,321498.7006,56,34,34,22,0,20,3,female
140,1000,Asia,63,380,314.9612072,2271.366371,35.57692308,80808.22666,58,51,50,7,1,19,1,female
639,30200,Asia,49,331,235.7693245,1858.468958,26.20833333,48707.37395,72,61,55,11,6,18,2,female
1154,19500,Asia,77,499,405.551932,3127.126484,73.89473684,231078.1886,79,55,35,24,20,21,3,female
93,19200,AsiaEurope,56,279,272.5558619,1620.252023,28.8,46663.25827,85,55,36,30,19,14,3,female
529,11700,Asia,79,539,419.0808777,3397.737823,57.46341463,195245.6174,90,69,68,21,1,18,2,female
93,11800,Asia,84,504,453.2640759,3221.727981,51.13333333,164737.6908,69,0,-3,69,3,0,2,female
405,42100,Asia,70,487,359.7107722,2984.960829,41.51612903,123924.0189,79,60,56,19,4,20,2,female
93,28800,Asia,86,641,469.3966019,4119.235708,40.53846154,166987.4783,85,76,75,9,1,21,1,female
109,30900,Asia,67,378,340.3026944,2292.981714,41.93103448,96147.09532,86,61,58,25,3,11,3,female
546,17500,Asia,63,424,316.1697866,2534.366688,40.625,102958.6467,85,64,60,21,4,19,3,female
436,21100,Asia,62,382,308.3287327,2274.502991,29.07692308,66135.54849,88,0,-12,88,12,0,3,female
62,11800,Asia,93,566,516.0824975,3701.163887,35.08653846,129861.0291,81,53,51,28,2,19,3,female
78,11800,Asia,86,595,466.9609738,3823.627529,77.39130435,295915.5218,60,54,54,6,0,21,4,female
109,8400,Europe,77,352,405.551932,2205.908862,33.86842105,74710.65015,74,45,28,29,17,8,2,female
109,13700,Asia,81,550,432.6080183,3486.917502,47.35714286,165130.4503,96,61,59,35,2,23,2,female
499,13900,Asia,74,451,385.5385456,2800.463468,64.38888889,180318.7311,80,63,52,17,11,21,3,female
124,27000,Asia,37,296,181.5249056,1541.998196,17.5,26984.96843,75,54,49,21,5,12,2,female
576,19600,Asia,56,288,273.4603973,1672.518218,34.07894737,56997.66031,79,68,60,11,8,11,2,female
1684,24500,Asia,67,566,339.6973857,3433.406482,37.74193548,129583.4059,95,80,80,15,0,24,4,female
374,21100,AsiaEurope,57,324,277.0156616,1889.856365,41.39130435,78223.61996,75,60,55,15,5,14,3,female
577,30300,Asia,47,381,219.7679748,2116.298352,23.57142857,49884.17545,85,73,67,12,6,17,1,female
124,14900,Asia,85,503,459.8067162,3223.923641,62.45238095,201341.7074,75,50,46,25,4,20,1,female
233,17600,Unknown,76,529,398.842491,3305.153655,79,261107.1387,62,41,39,21,2,23,3,female
358,67000,Asia,67,407,339.9564924,2468.898301,47.48333333,117231.521,83,50,42,33,8,13,2,female
561,23400,Asia,55,373,267.8084246,2156.447173,49.33333333,106384.7272,64,53,52,11,1,18,1,female
530,20600,Asia,58,462,283.0128366,2706.38722,32.58333333,88183.11691,80,76,76,4,0,23,3,female
109,32600,Asia,41,363,208.1306865,1944.791378,19.5,37923.43186,100,53,30,47,23,11,2,female
78,34300,Asia,78,516,412.2983693,3243.267545,44.175,143271.3438,58,53,53,5,0,23,4,female
373,21800,Asia,64,453,322.9162238,2718,57.5,156285,82,52,44,30,8,13,3,female
779,9800,Asia,67,453,339.9564924,2747.938403,45.63333333,125397.5891,102,69,51,33,18,14,4,female
405,18200,Europe,52,266,252.7242144,1516.316965,29.85714286,45272.89224,89,51,32,38,19,13,2,female
405,18200,Europe,52,266,252.7242144,1516.316965,29.85714286,45272.89224,89,51,32,38,19,13,2,female
218,233900,Asia,103,717,590.1306865,4794.220878,56.3671875,270236.7471,88,73,73,15,0,31,4,female
546,17500,Asia,67,416,340.3026944,2523.493103,49.13793103,123999.2301,93,83,77,10,6,23,4,female
217,32300,Unknown,43,371,221.6596322,2013.144224,20.5,41269.45659,98,82,76,16,6,19,2,female
686,20700,Asia,69,447,354.26557,2730.510432,47.58928571,129943.0411,84,65,54,19,11,19,8,female
529,27300,AsiaEurope,54,356,259.4122985,2048.739951,55.25,113192.8823,79,73,70,6,3,16,1,female
545,26300,Asia,49,383,239.3499675,2150.43387,25.35,54513.49861,79,69,65,10,4,17,4,female
358,15600,Asia,76,489,399.1845378,3055.236554,39.82857143,121685.7073,85,16,5,69,11,10,1,female
140,23100,Asia,60,431,300.3702549,2545.869847,45.31578947,115368.102,93,67,64,26,3,13,3,female
576,22500,AsiaEurope,59,523,288.6764386,3076.622315,82.5,253821.341,79,64,57,15,7,19,2,female
389,22000,Asia,67,513,341.2590864,3111.903755,37.03703704,115255.6946,94,63,62,31,1,19,2,female
93,17600,Asia,74,476,386.9094701,2955.699802,61.72580645,182442.9539,88,63,55,25,8,20,5,female
171,19600,Asia,91,627,502.5535519,4080.387239,57.75,235642.3631,67,56,55,11,1,22,3,female
93,14700,Europe,74,458,385.8508604,2843.929641,40.58823529,115430.0854,77,61,58,16,3,22,2,female
577,18600,AsiaEurope,64,516,320.4063545,3096,80.86206897,250348.9655,85,78,74,7,4,27,2,female
670,14900,Europe,78,520,412.2983693,3268.409154,68.42105263,223627.9947,87,73,68,14,5,22,2,female
389,21800,Asia,64,502,322.9162238,3012,57.5,173190,85,47,41,38,6,12,3,female
109,15700,Europe,71,430,365.8862514,2644.391261,50.09090909,132459.9623,76,59,51,17,8,12,1,female
623,26000,Asia,90,605,494.3950605,3927.571123,59.46808511,233565.1338,78,58,58,20,0,19,5,female
436,28700,Asia,57,310,277.0156616,1808.195904,30.30434783,54796.19762,68,52,43,16,9,10,3,female
358,11800,Asia,80,584,426.3322913,3692.006007,74.86363636,276396.9952,68,58,58,10,0,21,3,female
108,26400,Asia,78,403,412.2613731,2533.017094,43,108919.7351,68,46,30,22,16,15,1,female
421,26000,Asia,74,515,386.1246381,3197.868483,50.31818182,160910.9278,105,42,21,63,21,14,3,female
546,28000,Asia,84,582,453.2640759,3720.32874,46.73076923,173853.8238,67,47,44,20,3,37,10,female
389,26000,Asia,74,514,386.1246381,3191.65903,50.31818182,160598.4794,105,42,21,63,21,14,3,female
420,26000,Asia,74,515,386.1246381,3197.868483,50.31818182,160910.9278,105,42,21,63,21,14,3,female
404,26000,Asia,73,513,379.6596322,3175.379999,51.25,162738.2249,106,42,20,64,22,14,3,female
405,26600,Asia,50,340,242.4407955,1918.911105,22.16666667,42535.86282,82,60,58,22,2,12,3,female
77,15900,Asia,66,532,334.5126491,3215.617671,35.38888889,113797.1365,68,41,36,27,5,26,2,female
109,30700,Europe,43,366,221.6596322,1986.0129,20.5,40713.26445,114,54,25,60,29,14,3,female
78,11400,Asia,86,542,466.7930215,3483.035497,67.42222222,234833.9933,77,39,29,38,10,18,2,female
592,21300,Unknown,21,52,75.60964047,228.400506,14.4,3288.967286,104,87,83,17,4,27,3,female
639,19400,Asia,74,435,386.1246381,2701.112214,34.16666667,92288.00065,78,50,41,28,9,12,2,female
156,15200,AsiaEurope,64,484,325.5680503,2904,46.07142857,133791.4286,165,98,38,67,60,21,7,female
389,26000,Asia,50,443,240.8554909,2500.228292,35.57692308,88950.42962,91,47,35,44,12,9,2,female
421,25700,Asia,144,852,900.2346001,6108.776101,56.5,345145.8497,61,45,45,16,0,46,10,female
389,21500,Asia,62,414,310.1726115,2465.037273,50.86956522,125395.3743,89,76,76,13,0,22,2,female
342,15300,Asia,82,616,440.5905816,3916.252035,48.34285714,189322.8127,86,59,53,27,6,28,6,female
530,24400,Asia,89,683,487.7378322,4422.925933,67.90625,300344.3142,104,96,93,8,3,30,2,female
436,28300,Asia,63,437,315.5176503,2612.071327,51.68,134991.8462,94,72,67,22,5,20,2,female
732,55400,Asia,49,597,237.4749933,3351.981777,24.18181818,81057.01388,85,53,42,32,11,9,2,female
436,43100,AsiaEurope,77,599,405.551932,3753.805138,85.18421053,319764.9271,100,70,58,30,12,23,6,female
296,9800,Asia,61,362,303.4631705,2146.926916,49.56521739,106412.8993,81,54,43,27,11,11,1,female
217,97900,Unknown,92,624,508.9533246,4070.702661,90.03921569,366522.8749,89,66,56,23,10,21,5,female
655,117500,Asia,92,733,508.6701412,4781.770914,72.24,345435.1308,101,76,65,25,11,27,2,female
78,14300,Europe,75,569,392.9423377,3544.197835,100.5454545,356352.9823,89,67,49,22,18,27,3,female
62,18500,Asia,82,718,439.3192644,4564.722339,86,392566.1212,70,55,51,15,4,32,3,female
62,11800,Asia,105,668,600.8285737,4485.116006,79.4137931,356180.0745,79,57,49,22,8,27,5,female
421,15700,Asia,95,558,530.851908,3665.979429,50.90909091,186631.68,91,71,71,20,0,19,2,female
577,15700,Europe,75,465,392.4020294,2896.400691,36.57142857,105925.511,96,54,48,42,6,11,3,female
140,12700,Asia,81,752,433.6087556,4767.567202,66.95652174,319219.717,115,103,102,12,1,29,3,female
202,24500,AsiaEurope,72,440,372.3949821,2714.767001,42.47058824,115297.7514,91,52,43,39,9,13,2,female
124,29400,Asia,80,647,425.7903187,4090.287477,50.46153846,206402.1989,113,82,82,31,0,33,6,female
108,6900,Asia,85,511,460.4869215,3275.198768,40.0212766,131077.6358,125,77,67,48,10,13,2,female
62,12800,Asia,104,831,594.2093292,5568.065406,107.1610169,596679.5513,77,8,-2,69,10,11,3,female
62,12800,Asia,104,831,594.2093292,5568.065406,107.1610169,596679.5513,77,8,-2,69,10,11,3,female
156,27400,Europe,75,502,392.9423377,3126.866983,80.18181818,250717.8799,104,73,51,31,22,23,4,female
93,13700,Asia,95,758,533.19324,4979.950551,49.72881356,247647.0325,124,92,91,32,1,25,3,female
249,48000,Asia,62,651,307.9068682,3876.181798,82.96296296,321579.527,106,68,58,38,10,19,3,female
78,15000,Asia,85,620,459.8067162,3973.82238,54.69767442,217358.8428,116,80,80,36,0,20,3,female
638,75300,AsiaEurope,56,529,273.4603973,3072.090754,114.8947368,352967.0587,94,74,67,20,7,17,2,female
234,112700,Asia,97,670,545.3518546,4421.941604,49.8245614,220321.301,93,70,67,23,3,28,4,female
390,5900,Asia,76,456,398.9944238,2849.054946,47.77777778,136121.5141,81,59,54,22,5,7,2,female
78,14800,Asia,82,505,439.3192644,3210.563762,45,144475.3693,80,66,61,14,5,20,1,female
592,15600,Asia,60,425,296.7916995,2510.428503,40.2173913,100962.8855,122,76,49,46,27,14,3,female
358,15300,Asia,83,614,447.1829761,3914.274211,46.34722222,181415.7367,93,59,53,34,6,28,6,female
607,29300,Asia,85,557,459.8067162,3570.030751,56.82142857,202854.2473,95,72,70,23,2,18,2,female
233,35500,Asia,73,807,379.3421297,4995.188419,52.12121212,260355.2752,77,60,56,17,4,47,3,female
639,75300,AsiaEurope,56,539,273.4603973,3130.164303,114.8947368,359639.4039,96,74,67,22,7,17,2,female
358,16600,Antarctica,111,730,645.065676,4959.923582,82.6171875,409774.9366,85,56,56,29,0,28,6,female
124,28000,Asia,79,473,419.7398968,2981.688294,45.88571429,136816.8971,107,52,25,55,27,13,4,female
109,6900,Asia,85,535,460.4869215,3429.024151,40.0212766,137233.924,129,81,71,48,10,14,2,female
155,33800,Europe,81,642,432.536756,4070.183702,53.65853659,218400.1011,123,89,81,34,8,28,5,female
124,22100,Asia,79,643,419.0078103,4053.331021,69.225,280591.8399,109,93,92,16,1,27,2,female
374,13300,AsiaEurope,80,556,425.7903187,3514.992021,69.38461538,243886.3694,95,68,54,27,14,21,1,female
171,45000,Asia,109,868,631.6688991,5874.783994,70.06153846,411596.4047,76,0,-3,76,3,0,1,female
1029,7800,Asia,59,415,290.159225,2441.296865,32.86956522,80244.36654,102,68,51,34,17,16,5,female
327,16600,Asia,81,765,432.536756,4849.985252,99.02439024,480266.8323,104,83,75,21,8,23,4,female
389,17000,Asia,85,456,459.8067162,2922.682267,43,125675.3375,91,47,35,44,12,19,2,female
389,34800,Asia,52,348,252.7242144,1983.753022,29.85714286,59229.19737,102,61,56,41,5,12,2,female
374,17100,Asia,85,462,459.8067162,2961.138612,43,127328.9603,91,47,35,44,12,19,2,female
623,27400,Asia,51,404,250.9308716,2291.659838,30.90909091,70833.12227,116,61,41,55,20,23,2,female
93,9900,AsiaEurope,101,698,573.5532717,4647.431615,64.77966102,301059.0446,110,72,61,38,11,17,2,female
171,20100,Europe,58,572,295.2391057,3350.765129,41.53846154,139185.6284,107,66,55,41,11,13,5,female
155,26400,AsiaEurope,71,596,366.1306865,3665.249283,91.40625,335026.6923,105,85,79,20,6,29,2,female
124,28000,Asia,69,559,354.8592943,3414.665171,41.22222222,140760.0865,152,75,33,77,42,15,2,female
78,14700,Asia,130,800,787.9470571,5617.89425,94.375,530188.7699,130,92,75,38,17,26,12,female
171,17600,Asia,82,630,440.20115,4005.257763,81.77777778,327541.0793,109,62,48,47,14,15,4,female
78,23500,Asia,82,690,439.3544556,4386.710883,41.9047619,183824.0751,80,59,57,21,2,29,2,female
155,32900,AsiaEurope,82,697,439.3192644,4431.213747,65,288028.8936,81,61,56,20,5,28,2,female
124,14900,Asia,0,0,0,0,0,0,106,75,68,31,7,20,2,female
155,127200,Asia,109,599,631.1333893,4054.142411,45,182436.4085,92,75,71,17,4,20,6,female
576,26400,Asia,55,462,266.8279228,2670.988188,61.57894737,164476.641,89,63,54,26,9,16,1,female
1512,27500,AsiaEurope,79,599,419.2271063,3775.964668,54.48648649,205739.0479,123,66,52,57,14,16,3,female
358,21500,Unknown,56,444,274.4798955,2578.465585,71.77777778,185076.5298,85,65,65,20,0,16,3,female
452,80200,Asia,79,572,419.0078103,3605.762588,51.79487179,186760.011,95,60,56,35,4,19,5,female
280,12800,Asia,92,736,508.9533246,4801.3416,82.40196078,395639.9622,111,58,48,53,10,17,3,female
124,29400,Asia,41,442,197.7269405,2368.037986,21.6,51149.6205,115,77,76,38,1,16,2,female
592,31200,AsiaEurope,80,603,426.079159,3812.122641,73.56976744,280456.9762,107,66,52,41,14,18,4,female
1887,88000,Asia,66,602,336.5164318,3638.72526,63,229239.6914,117,68,36,49,32,22,3,female
140,26000,Asia,103,703,586.2775517,4700.609871,53.71428571,252489.9016,84,58,58,26,0,26,8,female
405,17200,Asia,73,677,378.9461511,4190.511226,42.36842105,177545.3441,170,113,91,57,22,22,4,female
607,28400,Asia,55,446,266.8279228,2578.486432,61.57894737,158780.4803,90,62,53,28,9,16,1,female
1263,21100,AsiaEurope,69,552,354.26557,3371.9055,33.67857143,113560.9602,103,89,83,14,6,25,1,female
155,17200,AsiaEurope,68,462,346.3298602,2812.407833,36.40322581,102380.7174,124,57,47,67,10,14,4,female
109,20500,Asia,102,762,579.6081201,5084.388111,84.86842105,431503.991,119,112,107,7,5,30,4,female
139,19200,Unknown,73,579,378.9461511,3583.90842,28.09210526,100679.5326,135,79,61,56,18,19,3,female
139,160500,Asia,89,751,487.7378322,4863.275807,54.66666667,265859.0774,124,81,55,43,26,27,6,female
389,14300,AsiaEurope,79,608,419.0078103,3832.698695,68.20512821,261409.7059,99,81,75,18,6,26,3,female
483,10800,Europe,55,476,265.9634675,2751.927224,21,57790.4717,99,92,92,7,0,28,1,female
155,18500,Asia,87,752,473.9427998,4845.093509,104.575,506675.6537,133,92,82,41,10,28,5,female
62,11900,Asia,106,824,608.4972857,5543.806455,53.66666667,297517.6131,119,83,81,36,2,48,9,female
140,26000,AsiaEurope,84,696,453.092115,4449.052926,106.3636364,473217.4476,126,80,53,46,27,21,5,female
108,13800,Asia,79,753,420.1071259,4746.746903,76.76470588,364382.6299,124,78,72,46,6,25,1,female
77,47000,Asia,92,883,508.1677,5760.305207,47.5,273614.4973,108,34,32,74,2,20,5,female
514,13700,Asia,113,727,657.9932198,4958.270106,72.875,361333.934,106,81,78,25,3,31,7,female
202,73300,Asia,113,714,661.0808625,4869.607779,46.65441176,227188.6865,111,71,68,40,3,26,5,female
124,10800,Europe,91,850,501.2172393,5531.625444,136.9565217,757592.1804,131,90,61,41,29,30,3,female
218,18200,Asia,69,734,354.26557,4483.656951,105.4285714,472705.5471,100,76,70,24,6,28,5,female
109,26000,Asia,95,786,531.8959763,5163.906508,123.6666667,638603.1048,84,54,54,30,0,19,8,female
93,15600,Asia,92,682,508.4501668,4449.069254,62.30612245,277204.2537,109,65,55,44,10,25,4,female
1528,74300,Asia,113,1061,660.5118257,7236.209879,144.5223881,1045794.332,105,50,47,55,3,28,6,female
93,11800,Asia,79,799,419.7398968,5036.720818,78.57142857,395742.35,144,101,98,43,3,36,2,female
1310,22200,AsiaEurope,92,753,508.1990654,4912.242153,100.5319149,493837.1101,120,97,89,23,8,28,7,female
607,28300,Unknown,68,532,348.0415947,3238.530232,35.68518519,115567.551,137,82,57,55,25,22,2,female
374,28800,Asia,100,881,564.8477751,5853.237303,79.64814815,466199.5119,133,87,87,46,0,33,3,female
530,11800,Europe,68,601,346.1173001,3658.565168,59.625,218141.9481,116,85,66,31,19,35,1,female
139,22500,Asia,0,0,0,0,0,0,111,75,65,36,10,16,4,female
1512,33800,Europe,86,779,466.9609738,5006.060244,57.39130435,287304.327,160,135,124,25,11,34,5,female
109,47000,Asia,108,846,623.7020245,5714.634827,73.92857143,422474.789,119,88,86,31,2,26,4,female
545,247500,Asia,13,28,40.05374781,103.6123121,5.5,569.8677166,141,113,104,28,9,45,5,female
124,16600,Asia,88,712,480.9553238,4599.115312,66.66666667,306607.6875,142,77,59,65,18,23,9,female
529,247500,Asia,13,28,40.05374781,103.6123121,5.5,569.8677166,141,113,104,28,9,45,5,female
124,14000,Asia,93,678,516.0824975,4433.549674,70.3902439,312078.6429,121,82,71,39,11,31,7,female
499,25500,Europe,68,642,351.1753143,3908.151144,51.84782609,202629.1408,162,116,94,46,22,23,8,female
545,37100,Asia,97,1030,546.4971854,6797.910227,70.84745763,481614.6568,199,131,109,68,22,31,9,female
233,89000,Asia,91,730,502.1708162,4750.690087,97.25490196,462027.8987,120,78,55,42,23,27,4,female
560,247500,Asia,13,28,40.05374781,103.6123121,5.5,569.8677166,143,113,105,30,8,45,5,female
748,82300,AsiaEurope,77,659,405.7769322,4129.81233,64.34722222,265741.9518,130,75,60,55,15,16,5,female
202,21600,AsiaEurope,88,739,480.5611817,4773.519966,66.19565217,315986.2673,129,86,79,43,7,28,5,female
124,17200,Asia,98,764,550.7131734,5053.638321,58.16037736,293921.5118,132,102,96,30,6,33,16,female
155,245600,Asia,109,884,630.6524852,5983.074943,70.82539683,423753.6571,151,107,97,44,10,27,8,female
390,25000,AsiaEurope,87,781,473.6107211,5031.93887,71.86666667,361628.6735,146,88,74,58,14,21,3,female
1559,40400,Asia,106,966,608.1416159,6499.171159,59.34745763,385709.285,161,85,44,76,41,29,8,female
124,20100,AsiaEurope,82,913,440.20115,5804.44498,77.08695652,447446.9978,142,98,88,44,10,34,3,female
109,14300,Asia,76,747,398.842491,4667.201853,62.5,291700.1158,131,109,95,22,14,35,1,female
561,24400,Asia,72,523,373.6840496,3226.870776,37.1,119716.9058,127,65,55,62,10,16,2,female
124,18900,AsiaEurope,71,977,368.5969538,6008.302936,105.9259259,636435.0517,162,121,115,41,6,33,2,female
124,22000,Asia,81,703,433.2506894,4456.914552,41.25,183847.7253,164,97,71,67,26,23,3,female
202,29800,AsiaEurope,89,730,487.5430078,4727.285405,98.74468085,466794.2886,131,89,77,42,12,22,4,female
467,41700,Europe,73,792,379.6596322,4902.341051,64.703125,317196.7858,153,114,85,39,29,44,2,female
452,106100,Asia,130,1171,787.2923715,8223.192709,62.94303797,517592.731,159,131,125,28,6,51,14,female
140,25000,Asia,109,930,632.9053075,6294.411422,122.8656716,773367.087,119,83,77,36,6,25,9,female
109,18200,Asia,63,657,318.7159976,3927.07291,33,129593.406,216,141,111,75,30,36,13,female
93,10400,Asia,91,861,502.1708162,5603.211185,67.84313725,380139.4255,142,115,111,27,4,41,2,female
171,18700,AsiaEurope,92,962,508.1677,6275.666602,119,746804.3256,198,114,93,84,21,32,5,female
420,17200,Asia,103,728,587.7428202,4867.772384,49.09166667,238967.0593,166,88,70,78,18,25,10,female
763,24400,Asia,78,760,412.4094067,4776.905686,42.66216216,203793.125,191,136,109,55,27,20,3,female
93,13700,Asia,89,787,487.5430078,5096.40221,76.40425532,389386.8157,163,141,135,22,6,46,3,female
124,18600,North America,97,1072,545.3518546,7075.106567,118.5964912,839082.8139,179,0,-11,179,11,0,3,female
358,20600,Asia,49,607,246.1288162,3408.128875,57,194263.3459,170,128,114,42,14,28,4,female
561,22200,Asia,66,373,334.5126491,2254.559007,38.27777778,86299.50864,162,75,47,87,28,12,4,female
1746,32900,AsiaEurope,88,1041,480.4627738,6724.268315,118.0111111,793538.3753,161,138,126,23,12,45,8,female
546,20100,Asia,74,744,387.4217091,4619.833304,60.86666667,281193.8538,200,124,116,76,8,20,10,female
420,13700,Asia,65,838,327.3557123,5046.744227,42.94642857,216739.6405,194,124,87,70,37,44,4,female
498,25300,Asia,84,645,453.2640759,4123.044738,38.56666667,159012.0921,157,101,82,56,19,26,3,female
1341,35800,Asia,124,1250,742.9206911,8692.745388,125.0526316,1087050.686,132,104,99,28,5,37,11,female
405,16800,Europe,81,736,432.75063,4666.129602,67.89473684,316805.6414,179,74,61,105,13,22,4,female
124,21600,Asia,93,1013,516.4569079,6624.167876,143.1,947918.423,173,104,78,69,26,39,4,female
139,17600,AsiaEurope,81,968,432.536756,6136.974803,91.7375,562990.726,170,123,116,47,7,49,1,female
577,23200,Asia,78,517,413.5983953,3249.552947,51.13636364,166170.3212,172,99,72,73,27,19,4,female
576,22200,Asia,71,384,366.8663501,2361.502894,45.1,106503.7805,172,63,36,109,27,13,4,female
514,27400,Asia,119,931,705.3002761,6419.075338,66.25694444,425308.318,157,87,69,70,18,34,8,female
186,36100,Asia,111,1192,646.0634012,8098.943713,84.20454545,681967.874,168,114,104,54,10,33,1,female
467,31200,Asia,114,905,668.0313232,6183.765463,62.91176471,389031.5978,156,88,72,68,16,28,8,female
108,23500,Asia,108,1071,621.7684232,7234.484515,81.42105263,589039.3444,164,100,79,64,21,29,10,female
108,20000,Asia,84,843,453.092115,5388.723587,81.4,438642.1,158,107,106,51,1,32,2,female
373,30700,Asia,104,1309,593.2900757,8770.875591,102,894629.3103,193,143,143,50,0,56,4,female
140,17200,Unknown,72,576,373.2397178,3553.876801,52.90322581,188011.5469,153,93,82,60,11,19,6,female
530,31300,Asia,114,984,668.0313232,6723.563774,67.30882353,452555.1675,169,101,85,68,16,32,8,female
327,9800,Unknown,84,950,452.9890166,6072.701552,68.69512195,417164.9737,227,151,118,76,33,47,1,female
514,31300,Asia,115,996,675.0131492,6818.108091,68.77205882,468895.3307,170,102,86,68,16,34,8,female
77,23500,Asia,107,1022,615.8588276,6889.77926,175.704918,1210568.1,180,120,117,60,3,46,12,female
155,10400,Europe,99,1462,557.3718925,9692.119379,92.96875,901064.2235,219,101,47,118,54,59,30,female
342,248500,Asia,84,636,455.7586984,4065.513881,44.64705882,181513.2374,211,79,57,132,22,18,3,female
327,248500,Asia,84,636,455.7586984,4065.513881,44.64705882,181513.2374,211,79,58,132,21,18,3,female
234,21600,Asia,87,916,474.2088866,5901.736242,73.23076923,432188.6848,272,175,157,97,18,42,11,female
421,27700,Asia,8,69,24,207,0,0,225,58,3,167,55,11,2,female
233,21600,Asia,87,913,474.2088866,5882.407412,72.61538462,427153.2767,277,180,162,97,18,42,11,female
140,28300,Asia,133,1288,811.3210823,9087.203777,85.54216867,777339.1183,310,218,183,92,35,50,15,female
405,16700,Asia,67,465,341.8710649,2820.731474,56.76923077,160130.756,209,99,90,110,9,21,2,female
1029,26400,Asia,80,780,425.7903187,4931.103914,35.67073171,175896.0847,337,103,-52,234,155,18,2,female
561,17600,Asia,164,1616,1052.071719,11889.80404,85.40952381,1015502.501,263,176,154,87,22,56,26,female
93,16600,Asia,142,1462,874.2613731,10452.93029,89.02564103,930578.8195,199,111,80,88,31,60,33,female
576,17600,AsiaEurope,115,656,677.5639846,4490.641473,51.95833333,233326.2466,99,60,52,39,8,30,11,female
670,213300,Asia,309,7406,2358.546156,61258.45518,550,33692150.35,133,86,84,47,2,76,14,female
139,16000,Asia,153,1877,966.216349,13622.11698,79.13265306,1077954.257,411,265,221,146,44,73,43,female
343,15600,Asia,49,373,235.7693245,2094.286772,30.83333333,64573.84213,276,60,15,216,45,27,17,female
108,115600,Asia,11,26,38.05374781,89.94522208,0,0,188,103,102,85,1,83,41,female
93,119500,Asia,11,26,38.05374781,89.94522208,0,0,190,104,103,86,1,83,41,female
545,29400,Asia,159,2006,1021.070351,14669.64321,94.43636364,1385347.76,327,225,194,102,31,62,18,female
109,13700,Asia,176,3507,1165.513992,26160.22669,98.55426357,2578201.876,381,141,84,240,57,130,92,female
