time(ms),time,memory(KB),memory,country,continent,program_vocabulary,program_length,calculated_estimated_program_length,volume,difficulty,effort,loc,slocP,lsloc,comments,blankLine,cyclomatic_complexity,numberOfFunction,gender
4898 ms,4898,15400 KB,15400,France,Europe,50,245,232.1928095,1382.744766,32,44247.83253,17,14,13,3,1,8,1,male
3462 ms,3462,0 KB,0,China,Asia,54,249,256.8173705,1432.966988,27.46153846,39351.47806,24,21,21,3,0,13,3,male
3353 ms,3353,11600 KB,11600,Unknown,Unknown,52,257,244.4783673,1465.013008,24.53703704,35947.07843,36,30,28,6,2,10,1,male
670 ms,670,18800 KB,18800,Indonesia,Asia,68,280,346.1173001,1704.489596,38.25,65196.72703,31,28,28,3,0,13,2,male
702 ms,702,14100 KB,14100,India,Asia,66,271,333.6312234,1638.030806,39.55172414,64786.94258,35,31,31,4,0,13,2,female
1528 ms,1528,11800 KB,11800,Syria,Asia,66,255,333.3240179,1541.3205,37.2,57337.12262,38,31,29,7,2,14,2,male
1309 ms,1309,10600 KB,10600,China,Asia,55,280,264.5725015,1618.78072,28.5,46135.25051,27,15,15,12,0,4,1,female
1669 ms,1669,11600 KB,11600,China,Asia,55,256,262.9879004,1480.028087,26.03571429,38533.5884,44,27,19,17,8,9,1,female
561 ms,561,9400 KB,9400,China,Asia,81,381,433.2506894,2415.482851,53.2,128503.6877,31,27,27,4,0,17,2,male
1325 ms,1325,9400 KB,9400,China,Asia,65,279,328.3421192,1680.24062,43.5,73090.46696,35,31,31,4,0,15,2,male
623 ms,623,11800 KB,11800,Unknown,Unknown,79,335,419.4466845,2111.766551,41.02325581,86631.53943,34,29,29,5,0,14,2,male
748 ms,748,11800 KB,11800,China,Asia,77,299,405.551932,1873.769176,34.89473684,65384.68229,34,25,25,9,0,8,2,male
779 ms,779,10600 KB,10600,India,Asia,60,262,295.1851693,1547.605336,38.57692308,59701.852,47,37,31,10,6,14,2,male
592 ms,592,12900 KB,12900,China,Asia,72,324,372.2746801,1999.0557,39.64285714,79248.27955,41,36,36,5,0,13,2,male
1419 ms,1419,75100 KB,75100,Iran,Asia,56,241,271.0812322,1399.572536,35.54545455,49748.44197,38,29,27,9,2,6,1,male
529 ms,529,11800 KB,11800,China,Asia,78,338,412.4094067,2124.46595,56.85365854,120783.6617,37,28,24,9,4,14,2,male
686 ms,686,9400 KB,9400,Kyrgyzstan,Asia,60,250,296.7916995,1476.722649,25.73913043,38009.55688,32,27,27,5,0,14,2,male
561 ms,561,12800 KB,12800,Unknown,Unknown,79,345,419.4466845,2174.804358,51.48837209,111977.136,29,24,24,5,0,14,2,female
561 ms,561,12700 KB,12700,Unknown,Unknown,79,345,419.4466845,2174.804358,51.48837209,111977.136,29,24,24,5,0,14,2,female
779 ms,779,10600 KB,10600,Taiwan,Asia,64,277,320.7232379,1662,36,59832,44,33,28,11,5,14,2,male
1372 ms,1372,39100 KB,39100,China,Asia,63,269,316.1697866,1607.888299,44.6875,71852.50838,39,35,35,4,0,13,2,male
1419 ms,1419,9500 KB,9500,Finland,Europe,62,312,307.2067179,1857.709249,43.2,80253.03955,54,38,27,16,11,14,3,male
810 ms,810,19300 KB,19300,Georgia,AsiaEurope,62,255,309.4603455,1518.320059,19.79166667,30050.0845,39,36,36,3,0,14,1,male
997 ms,997,300600 KB,300600,China,Asia,63,301,313.8551855,1799.161257,27.29411765,49106.51901,51,44,44,7,0,10,2,male
1075 ms,1075,18900 KB,18900,India,Asia,39,246,190.8721876,1300.208946,18,23403.76103,47,40,37,7,3,13,3,male
4991 ms,4991,2600 KB,2600,Russia,AsiaEurope,66,289,333.1049912,1746.8299,32.77142857,57246.11131,36,29,29,7,0,11,2,male
592 ms,592,11800 KB,11800,China,Asia,64,321,322.2270913,1926,31.2,60091.2,46,41,41,5,0,15,2,male
623 ms,623,11800 KB,11800,China,Asia,64,323,322.2270913,1938,31.2,60465.6,46,41,41,5,0,15,2,male
4476 ms,4476,29400 KB,29400,India,Asia,54,256,257.2458179,1473.251201,36.25,53405.35602,49,32,22,17,10,6,2,female
483 ms,483,10900 KB,10900,China,Asia,66,316,333.1049912,1910.028542,49.11290323,93807.04693,52,46,46,6,0,17,3,male
592 ms,592,39100 KB,39100,China,Asia,65,287,329.6987322,1728.419562,46.97916667,81199.71069,39,33,33,6,0,13,2,male
872 ms,872,17600 KB,17600,Unknown,Unknown,67,295,339.6973857,1789.496311,37.16129032,66499.99195,44,36,35,8,1,14,2,male
888 ms,888,21100 KB,21100,Syria,Asia,53,261,253.6843594,1494.987239,38.47368421,57517.66692,29,25,25,4,0,13,1,male
701 ms,701,11800 KB,11800,Unknown,Unknown,65,291,327.8032081,1752.509034,42.92592593,75228.07296,56,47,46,9,1,14,2,male
779 ms,779,15700 KB,15700,Serbia,Europe,59,234,290.8572701,1376.538474,26.90909091,37041.39892,39,32,29,7,3,14,2,female
764 ms,764,15400 KB,15400,South Korea,Asia,70,322,359.2147805,1973.629131,42.60606061,84088.56239,42,34,30,8,4,15,2,male
4383 ms,4383,12300 KB,12300,South Korea,Asia,66,326,333.1049912,1970.472483,50.24193548,99000.35136,42,35,35,7,0,17,2,male
748 ms,748,10600 KB,10600,China,Asia,65,331,326.5538222,1993.403746,62.51612903,124619.8858,45,43,43,2,0,16,2,male
2573 ms,2573,65700 KB,65700,Russia,AsiaEurope,66,257,333.3240179,1553.409289,35.4,54990.68882,41,35,33,6,2,13,1,male
1325 ms,1325,12900 KB,12900,China,Asia,59,332,288.1860234,1953.037492,43.80645161,85555.64241,43,34,31,9,3,10,1,male
810 ms,810,19600 KB,19600,China,Asia,63,273,314.9612072,1631.797419,41.98076923,68504.11088,58,51,51,7,0,14,2,male
904 ms,904,35200 KB,35200,South Korea,Asia,52,268,251.3531335,1527.717844,46.86666667,71599.04298,52,40,35,12,5,14,2,male
670 ms,670,9500 KB,9500,Argentina,South America,68,259,346.6279634,1576.652876,36.1,56917.16882,43,29,22,14,7,7,2,male
794 ms,794,9400 KB,9400,Unknown,Unknown,68,306,346.3298602,1862.763629,38.19354839,71145.55281,52,37,30,15,7,14,2,male
732 ms,732,9400 KB,9400,China,Asia,92,376,510.1851706,2452.859295,45.74074074,112195.6011,35,28,28,7,0,15,2,male
2121 ms,2121,9500 KB,9500,Hong Kong,Asia,74,328,385.6555921,2036.700704,49.80769231,101443.362,42,38,38,4,0,12,1,male
2511 ms,2511,32800 KB,32800,Russia,AsiaEurope,66,261,333.3240179,1577.586865,35.4,55846.57503,42,36,34,6,2,13,1,male
2589 ms,2589,65700 KB,65700,Russia,AsiaEurope,66,261,333.3240179,1577.586865,35.4,55846.57503,42,36,34,6,2,13,1,male
888 ms,888,24900 KB,24900,India,Asia,64,276,321.1317371,1656,37,61272,56,44,39,12,5,12,2,male
1247 ms,1247,10600 KB,10600,China,Asia,67,291,340.7366244,1765.231954,44.57142857,78678.90997,41,32,29,9,3,15,2,male
779 ms,779,11800 KB,11800,Austria,Europe,70,301,359.2147805,1844.914188,44.28787879,81707.33594,53,41,36,12,5,15,2,male
4507 ms,4507,166600 KB,166600,Mexico,North America,34,217,172.9737366,1103.979437,0,0,32,25,25,7,0,3,1,male
810 ms,810,29400 KB,29400,India,Asia,55,272,263.6191856,1572.529842,37.45833333,58904.347,52,34,23,18,11,6,2,female
1731 ms,1731,15400 KB,15400,Brazil,South America,61,268,301.0709438,1589.437606,37.125,59007.87114,43,27,19,16,8,7,1,male
2386 ms,2386,1200 KB,1200,Romania,Europe,47,235,215.9400989,1305.32838,31.41666667,41009.06661,37,20,14,17,6,7,1,male
3400 ms,3400,1300 KB,1300,Russia,AsiaEurope,65,300,326.4650059,1806.710344,33.93939394,61318.6541,38,29,29,9,0,11,2,male
483 ms,483,15300 KB,15300,China,Asia,69,346,352.4986422,2113.549462,45.65714286,96498.62972,47,38,37,9,1,16,2,male
794 ms,794,9500 KB,9500,India,Asia,55,255,268.9081138,1474.246727,24.58823529,36249.1254,62,47,42,15,5,14,2,male
4679 ms,4679,9800 KB,9800,Ukraine,Europe,61,304,301.0709438,1802.944151,38.30357143,69059.20005,60,52,49,8,3,16,2,male
717 ms,717,11700 KB,11700,Bangladesh,Asia,66,312,334.5126491,1885.850965,46.94444444,88530.22587,48,42,41,6,1,17,2,male
498 ms,498,9400 KB,9400,Russia,AsiaEurope,69,277,352.582306,1692.061275,33.91666667,57389.07823,35,32,32,3,0,11,1,male
1762 ms,1762,9400 KB,9400,Brazil,South America,62,292,307.2067179,1738.625323,44.8,77890.41445,46,26,17,20,9,8,2,male
701 ms,701,14100 KB,14100,China,Asia,81,366,435.1207824,2320.385101,34.93877551,81071.41414,30,25,25,5,0,15,3,male
514 ms,514,24500 KB,24500,China,Asia,73,460,379.1044231,2847.319297,69.74358974,198582.2689,35,29,29,6,0,21,1,female
2090 ms,2090,23500 KB,23500,China,Asia,71,315,366.1306865,1937.170343,62.15625,120407.2441,54,41,34,13,7,13,2,male
795 ms,795,11800 KB,11800,China,Asia,72,360,372.2746801,2221.173001,49.68571429,110360.5671,52,43,40,9,3,19,2,male
576 ms,576,11800 KB,11800,China,Asia,78,372,412.2983693,2338.169625,65.075,152156.3884,41,30,26,11,4,15,2,male
904 ms,904,29400 KB,29400,India,Asia,72,301,372.3949821,1857.147425,28.18421053,52342.23402,35,25,25,10,0,9,1,male
1730 ms,1730,100 KB,100,Taiwan,Asia,39,232,184.5833771,1226.213315,17,20845.62635,41,19,16,22,3,4,1,male
857 ms,857,9500 KB,9500,China,Asia,66,304,333.6312234,1837.495812,58.05172414,106669.8,63,57,56,6,1,14,2,male
4601 ms,4601,12300 KB,12300,United States,North America,63,263,313.8551855,1572.02462,26.86764706,42236.60265,39,29,27,10,2,10,1,male
795 ms,795,10600 KB,10600,China,Asia,70,303,359.0498112,1857.172754,39,72429.73741,43,35,35,8,0,14,2,male
779 ms,779,15400 KB,15400,South Korea,Asia,77,339,405.551932,2124.440637,37.02564103,78658.77642,46,38,34,8,4,16,2,male
701 ms,701,10600 KB,10600,China,Asia,85,357,460.8279746,2288.152564,48.94791667,112000.301,39,31,29,8,2,14,2,male
592 ms,592,9400 KB,9400,China,Asia,67,347,339.4387425,2104.932949,39.66666667,83495.67365,49,41,41,8,0,16,2,male
764 ms,764,9500 KB,9500,Norway,Europe,57,289,276.504106,1685.705214,62.5625,105461.9325,42,35,33,7,2,12,1,male
841 ms,841,24900 KB,24900,India,Asia,42,257,201.6270751,1385.825578,21,29102.33713,49,41,41,8,0,8,1,male
4336 ms,4336,15500 KB,15500,Georgia,AsiaEurope,61,312,301.0709438,1850.390049,43.01785714,79599.8148,62,46,35,16,11,14,2,male
966 ms,966,23500 KB,23500,Belarus,Europe,73,348,378.9461511,2154.058946,53.74285714,115765.2822,56,44,44,12,0,13,2,female
701 ms,701,11800 KB,11800,Unknown,Unknown,71,323,366.1306865,1986.36832,42.046875,83520.58044,56,48,47,8,1,14,2,male
592 ms,592,11800 KB,11800,China,Asia,67,283,339.9564924,1716.703241,34.53333333,59283.48525,47,38,35,9,3,8,2,male
702 ms,702,16600 KB,16600,Romania,Europe,59,310,290.8572701,1823.619345,66.43181818,121146.3488,54,40,31,14,9,14,2,male
576 ms,576,11800 KB,11800,China,Asia,82,398,439.3544556,2530.305698,53.80952381,136154.5447,46,34,31,12,3,17,3,male
686 ms,686,11900 KB,11900,South Korea,Asia,77,404,405.551932,2531.781762,76,192415.4139,53,38,29,15,9,16,2,male
1481 ms,1481,11800 KB,11800,China,Asia,66,305,332.9737366,1843.540206,39.3125,72474.17436,42,27,27,15,0,16,2,female
857 ms,857,11900 KB,11900,China,Asia,69,327,353.3374044,1997.487497,65,129836.6873,52,41,38,11,3,15,2,male
764 ms,764,10600 KB,10600,Taiwan,Asia,72,334,372.2746801,2060.75495,60.25714286,124175.2054,48,37,32,11,5,15,2,female
904 ms,904,11800 KB,11800,China,Asia,66,324,335.0885565,1958.383695,53.07692308,103944.9807,59,48,45,11,3,14,2,female
1060 ms,1060,18900 KB,18900,India,Asia,38,254,184.2797931,1332.973588,17.5,23327.0378,42,35,34,7,1,14,2,male
1450 ms,1450,11800 KB,11800,China,Asia,66,305,332.9737366,1843.540206,39.3125,72474.17436,42,27,27,15,0,16,2,female
4383 ms,4383,15500 KB,15500,India,Asia,69,333,352.4986422,2034.138644,43.23529412,87946.58255,54,46,40,8,6,14,2,male
1263 ms,1263,15400 KB,15400,Spain,Europe,56,324,269.6764904,1881.582995,58.9,110825.2384,45,33,24,12,9,12,1,male
857 ms,857,23500 KB,23500,Unknown,Unknown,60,324,297.5287411,1913.832553,44.04545455,84295.62472,64,49,42,15,7,15,2,male
748 ms,748,12200 KB,12200,China,Asia,70,320,359.0910367,1961.370565,43.41176471,85146.55749,57,37,34,20,3,15,2,male
795 ms,795,9400 KB,9400,Italy,Europe,70,338,359.2147805,2071.69766,39.8030303,82459.84473,66,42,26,24,16,15,2,male
4741 ms,4741,28200 KB,28200,Vietnam,Asia,56,300,271.0812322,1742.206477,44.81818182,78082.52663,40,31,29,9,2,15,3,male
561 ms,561,21700 KB,21700,China,Asia,70,398,359.2147805,2439.454641,43.25675676,105522.896,50,41,41,9,0,15,2,female
4414 ms,4414,23500 KB,23500,India,Asia,44,274,210.1173001,1495.884264,20.25,30291.65634,53,43,40,10,3,15,3,male
935 ms,935,18900 KB,18900,India,Asia,44,265,210.1173001,1446.749379,22.5,32551.86103,68,58,58,10,0,13,2,male
4414 ms,4414,16800 KB,16800,India,Asia,35,286,168.4650059,1466.974943,16.5,24205.08656,78,53,37,25,16,15,2,male
717 ms,717,15400 KB,15400,China,Asia,62,340,308.8461793,2024.426746,72.52,146811.4276,50,47,46,3,1,13,1,male
826 ms,826,9400 KB,9400,Uzbekistan,Asia,71,321,365.7235111,1974.068825,51.91891892,102491.5193,52,40,33,12,7,15,2,male
889 ms,889,13200 KB,13200,Peru,South America,76,325,398.8804611,2030.576442,53.12820513,107880.8817,67,47,34,20,13,12,2,male
592 ms,592,25800 KB,25800,China,Asia,75,313,392.4020294,1949.62025,58.28571429,113635.0089,51,40,40,11,0,14,2,male
529 ms,529,11800 KB,11800,China,Asia,82,543,439.460071,3452.150739,82.08139535,283357.3496,33,29,29,4,0,24,3,male
4757 ms,4757,15400 KB,15400,Russia,AsiaEurope,57,298,275.4873867,1738.201224,44.4137931,77200.10954,33,27,24,6,3,14,1,male
4430 ms,4430,12900 KB,12900,India,Asia,71,313,365.7235111,1924.870848,56.58823529,108925.0445,39,35,35,4,0,13,2,female
4976 ms,4976,9400 KB,9400,Vietnam,Asia,56,280,269.4181505,1626.059378,41.16666667,66939.4444,41,32,28,9,4,10,1,male
1715 ms,1715,10700 KB,10700,Estonia,Europe,57,329,275.5886804,1919.020815,37.77777778,72496.34189,35,27,26,8,1,12,1,male
779 ms,779,11800 KB,11800,China,Asia,65,286,327.8032081,1722.397195,44.33333333,76359.60896,45,36,35,9,1,14,2,female
483 ms,483,10900 KB,10900,China,Asia,67,318,339.6973857,1929.016363,50.51612903,97446.43948,53,46,46,7,0,17,3,male
1138 ms,1138,10800 KB,10800,Philippines,Asia,61,344,301.0709438,2040.173644,47.73214286,97381.85983,60,57,57,3,0,16,1,male
2713 ms,2713,21300 KB,21300,Estonia,Europe,55,325,263.3031226,1878.941907,39,73278.73437,35,27,26,8,1,12,1,male
920 ms,920,11900 KB,11900,Belarus,Europe,77,350,405.6268983,2193.375289,65.40540541,143458.6,67,46,34,21,12,16,2,female
701 ms,701,9400 KB,9400,China,Asia,67,319,339.5249056,1935.082452,44.296875,85718.10548,41,36,36,5,0,14,2,male
717 ms,717,9400 KB,9400,Iran,Asia,75,334,392.4020294,2080.425443,56.57142857,117692.6393,53,39,30,14,9,14,2,male
4508 ms,4508,11800 KB,11800,India,Asia,71,312,365.7235111,1918.721101,59.85294118,114841.1012,42,34,32,8,2,14,2,male
950 ms,950,23500 KB,23500,Ukraine,Europe,44,225,214.9310205,1228.372114,22.16666667,27228.9152,46,34,26,12,8,17,1,male
701 ms,701,15400 KB,15400,Mongolia,Asia,67,357,340.3026944,2165.593841,71.4137931,154653.2705,56,50,46,6,4,14,1,male
483 ms,483,11800 KB,11800,Iran,Asia,80,358,425.8985773,2263.250258,62.42857143,141291.4804,56,43,38,13,5,15,3,male
670 ms,670,15400 KB,15400,India,Asia,61,318,302.2137048,1885.974473,46.08,86905.70373,58,50,47,8,3,15,2,male
2511 ms,2511,100 KB,100,Latvia,Europe,49,295,227.3200108,1656.339404,53.65,88862.60903,48,34,28,14,6,8,1,male
873 ms,873,39500 KB,39500,India,Asia,39,251,190.8721876,1326.635957,24,31839.26297,59,49,49,10,0,14,1,male
1201 ms,1201,9400 KB,9400,India,Asia,61,303,300.7868035,1797.013413,28.06451613,50432.31192,73,68,66,5,2,15,1,male
779 ms,779,14200 KB,14200,India,Asia,0,0,0,0,0,0,49,33,27,16,6,14,2,male
779 ms,779,11800 KB,11800,South Korea,Asia,80,372,425.7903187,2351.757251,44.70731707,105140.7571,52,38,35,14,3,15,2,male
499 ms,499,11700 KB,11700,India,Asia,68,297,346.6279634,1807.976464,44.33333333,80153.62323,48,38,36,10,2,14,2,male
748 ms,748,9400 KB,9400,India,Asia,62,248,308.8461793,1476.640685,31.82,46986.7066,66,48,37,18,11,11,1,male
4383 ms,4383,22600 KB,22600,India,Asia,47,283,230.1306865,1571.948645,26.8125,42147.87304,73,57,46,16,11,17,2,male
811 ms,811,19700 KB,19700,Hungary,Europe,66,311,333.3240179,1879.806571,48,90230.71541,43,35,33,8,2,15,2,male
685 ms,685,21100 KB,21100,China,Asia,50,245,248.1889572,1382.744766,25.05555556,34645.43832,46,38,38,8,0,14,2,female
717 ms,717,15400 KB,15400,India,Asia,63,319,314.9612072,1906.752296,46.25,88187.29367,58,50,47,8,3,15,2,male
4367 ms,4367,9700 KB,9700,India,Asia,61,257,301.3556992,1524.199496,38.40740741,58540.551,65,45,29,20,16,14,2,male
1263 ms,1263,17600 KB,17600,Russia,AsiaEurope,65,308,326.9987489,1854.889286,41.88888889,77699.25122,51,41,36,10,5,10,1,male
2760 ms,2760,0 KB,0,South Korea,Asia,58,296,283.0128366,1733.962375,43.91666667,76149.84762,62,37,28,25,9,10,1,male
888 ms,888,15700 KB,15700,Poland,Europe,72,301,372.3949821,1857.147425,34.08823529,63306.87841,54,31,23,23,8,10,3,male
780 ms,780,11800 KB,11800,Indonesia,Asia,74,330,385.6555921,2049.119611,60.17142857,123298.4543,44,29,25,15,4,14,2,male
1278 ms,1278,9400 KB,9400,Chile,South America,83,427,446.8336245,2722.141837,57.91304348,157647.5186,58,37,21,21,16,17,2,male
826 ms,826,23500 KB,23500,Egypt,AsiaAfrica,50,295,240.8554909,1664.937576,85.38461538,142160.0546,45,38,38,7,0,14,2,male
4945 ms,4945,9400 KB,9400,India,Asia,51,301,238.3078374,1707.400028,36.05769231,61564.90485,49,45,45,4,0,12,1,male
4555 ms,4555,72800 KB,72800,Portugal,Europe,59,320,290.159225,1882.445776,29.73913043,55982.30046,54,41,39,13,2,8,2,male
2745 ms,2745,15400 KB,15400,India,Asia,31,232,142.8814489,1149.373544,14.5,16665.91639,66,50,44,16,6,10,1,male
4414 ms,4414,35200 KB,35200,China,Asia,69,302,352.582306,1844.774386,54,99617.81684,41,36,35,5,1,14,2,male
4492 ms,4492,10700 KB,10700,India,Asia,59,276,289.5640056,1623.609482,37.91666667,61561.85951,66,47,37,19,10,12,2,male
639 ms,639,15400 KB,15400,India,Asia,71,357,365.6422056,2195.459722,54.51428571,119683.9185,44,37,34,7,3,11,2,male
951 ms,951,62800 KB,62800,India,Asia,43,198,203.5249056,1074.400421,19.6875,21152.2583,46,39,38,7,1,12,2,male
1045 ms,1045,11800 KB,11800,Tajikistan,Asia,72,366,372.8771238,2258.192551,73.75,166541.7006,58,47,43,11,4,14,1,male
1045 ms,1045,11800 KB,11800,Tajikistan,Asia,72,366,372.8771238,2258.192551,73.75,166541.7006,58,47,43,11,4,14,1,male
717 ms,717,11800 KB,11800,Brazil,South America,79,326,419.0808777,2055.032524,38,78091.23591,51,46,45,5,1,14,2,male
1622 ms,1622,19100 KB,19100,India,Asia,78,377,412.2983693,2369.596637,39.425,93421.34739,49,46,46,3,0,17,5,male
467 ms,467,13200 KB,13200,Singapore,Asia,73,336,379.1044231,2079.781052,57.92647059,120474.3759,43,36,36,7,0,14,2,male
3291 ms,3291,15400 KB,15400,Iran,Asia,67,306,340.7366244,1856.223292,60.58928571,112467.2434,48,43,40,5,3,12,1,male
4351 ms,4351,11800 KB,11800,Romania,Europe,71,277,365.7235111,1703.479952,31.01470588,52832.92969,50,40,36,10,4,11,2,male
249 ms,249,10600 KB,10600,China,Asia,74,370,385.6555921,2297.497745,44.01428571,101122.7222,65,56,54,9,2,20,3,male
701 ms,701,11800 KB,11800,China,Asia,70,312,359.4212455,1912.336301,42.15625,80616.9272,53,41,41,12,0,16,2,male
936 ms,936,12900 KB,12900,India,Asia,0,0,0,0,0,0,51,44,44,7,0,14,2,male
1029 ms,1029,18900 KB,18900,India,Asia,41,332,204.176133,1778.707266,19,33795.43805,57,41,36,16,5,14,3,male
577 ms,577,10600 KB,10600,China,Asia,75,338,392.17102,2105.340717,40.56756757,85408.55181,59,35,33,24,2,14,2,female
1014 ms,1014,18900 KB,18900,India,Asia,41,334,204.176133,1789.42237,19,33999.02502,57,40,35,17,5,13,3,male
701 ms,701,11800 KB,11800,China,Asia,80,376,425.8985773,2377.044964,46.42105263,110344.9294,61,48,43,13,5,19,2,male
4586 ms,4586,11900 KB,11900,Brazil,South America,61,327,302.7888745,1939.351109,70.14583333,136037.3997,65,46,32,19,14,12,2,male
779 ms,779,11900 KB,11900,Russia,AsiaEurope,67,328,339.5249056,1989.677254,61.796875,122955.8366,50,41,36,9,5,11,1,male
686 ms,686,9500 KB,9500,Peru,South America,82,361,439.3544556,2295.076274,45.71428571,104917.7725,42,31,27,11,4,13,2,male
1325 ms,1325,42500 KB,42500,Vietnam,Asia,95,487,532.5126722,3199.519681,43.69827586,139813.4937,31,24,24,7,0,18,2,male
1465 ms,1465,12900 KB,12900,China,Asia,70,331,359.0910367,2028.792679,58.76470588,119221.4051,54,41,38,13,3,14,2,male
2168 ms,2168,15400 KB,15400,Ukraine,Europe,75,374,392.2479866,2329.57819,58.15384615,135473.9317,48,42,38,6,4,13,3,male
2448 ms,2448,57500 KB,57500,Russia,AsiaEurope,66,307,333.3240179,1855.628995,35.4,65689.26641,51,44,42,7,2,14,1,male
998 ms,998,18900 KB,18900,India,Asia,41,338,204.176133,1810.852578,19,34406.19897,57,40,35,17,5,13,3,male
701 ms,701,11800 KB,11800,Hong Kong,Asia,71,344,366.4572094,2115.513009,59.35483871,125565.9334,53,46,44,7,2,17,1,female
920 ms,920,21200 KB,21200,Belarus,Europe,73,373,378.9461511,2308.80456,55.37142857,127841.8068,67,56,56,11,0,14,2,female
4773 ms,4773,12000 KB,12000,China,Asia,64,303,321.1317371,1818,51.38888889,93425,60,42,37,18,5,11,2,female
1169 ms,1169,12900 KB,12900,China,Asia,68,333,345.9474732,2027.125126,38.5,78044.31736,51,37,37,14,0,15,1,female
483 ms,483,15900 KB,15900,China,Asia,69,362,352.4986422,2211.285853,34.48529412,76256.84303,78,69,68,9,1,14,2,female
795 ms,795,13100 KB,13100,China,Asia,73,338,378.9461511,2092.160701,49.4,103352.7386,47,34,31,13,3,14,2,female
826 ms,826,9400 KB,9400,Finland,Europe,77,390,405.551932,2444.046751,63.33333333,154789.6276,57,39,31,18,8,14,1,female
4477 ms,4477,18900 KB,18900,India,Asia,53,314,253.6843594,1798.567023,50.10526316,90117.67398,71,52,41,19,11,15,2,female
592 ms,592,11800 KB,11800,China,Asia,78,305,412.2613731,1917.047677,39.5,75723.38323,49,34,30,15,4,9,2,female
826 ms,826,11800 KB,11800,China,Asia,62,309,309.4603455,1839.84666,44.33333333,81566.53526,58,52,52,6,0,16,3,female
998 ms,998,21100 KB,21100,Russia,AsiaEurope,45,216,219.07273,1186.240269,19,22538.56511,54,42,39,12,3,11,2,female
685 ms,685,15400 KB,15400,Russia,AsiaEurope,61,310,302.2137048,1838.528575,64.8,119136.6516,58,42,31,16,11,14,2,female
873 ms,873,51700 KB,51700,China,Asia,71,334,366.8663501,2054.015538,60.81666667,124918.3783,51,42,42,9,0,16,2,female
2105 ms,2105,9400 KB,9400,China,Asia,79,388,419.2271063,2445.86693,66.40540541,162418.7851,58,42,38,16,4,14,4,female
811 ms,811,9400 KB,9400,China,Asia,75,365,392.17102,2273.518822,57.44736842,130607.6734,47,8,8,39,0,2,1,female
779 ms,779,9400 KB,9400,China,Asia,75,365,392.17102,2273.518822,57.44736842,130607.6734,47,8,8,39,0,2,1,female
670 ms,670,11800 KB,11800,Jordan,Asia,79,408,419.0078103,2571.942545,56.55,145443.3509,44,32,29,12,3,16,2,female
2730 ms,2730,11800 KB,11800,Unknown,Unknown,85,442,459.8067162,2832.950794,53.23255814,150805.2178,65,51,46,14,5,18,3,female
2058 ms,2058,11900 KB,11900,China,Asia,70,404,360.541081,2476.230339,89.06896552,220555.2747,40,34,34,6,0,16,2,female
4117 ms,4117,13900 KB,13900,China,Asia,69,335,353.0013311,2046.355693,53.93548387,110371.1845,60,41,40,19,1,14,2,female
826 ms,826,0 KB,0,Croatia,Europe,67,326,339.5249056,1977.545076,41.14285714,81361.85456,57,32,18,25,14,6,1,female
2167 ms,2167,11700 KB,11700,China,Asia,70,404,360.541081,2476.230339,89.06896552,220555.2747,41,34,34,7,0,16,2,female
2761 ms,2761,9400 KB,9400,India,Asia,75,406,393.3293845,2528.900388,33.48837209,84688.75719,48,37,34,11,3,15,2,female
826 ms,826,18800 KB,18800,Indonesia,Asia,87,460,473.9427998,2963.754008,62.12765957,184131.1001,62,50,44,12,6,16,2,female
951 ms,951,17800 KB,17800,Russia,AsiaEurope,69,363,352.582306,2217.394378,61.63636364,136672.1262,56,40,33,16,7,14,2,female
2183 ms,2183,11800 KB,11800,South Korea,Asia,76,314,398.8804611,1961.849239,41.74358974,81894.62978,51,29,20,22,9,13,1,female
4399 ms,4399,117400 KB,117400,Unknown,Unknown,58,278,285.8598074,1628.518717,31.35,51054.06177,78,63,54,15,9,18,2,female
1247 ms,1247,21500 KB,21500,Unknown,Unknown,84,384,452.9546635,2454.64989,45.5,111686.57,52,44,44,8,0,21,2,female
748 ms,748,11800 KB,11800,China,Asia,77,331,405.7769322,2074.306345,35.875,74415.74013,55,31,31,24,0,8,2,female
904 ms,904,10600 KB,10600,China,Asia,66,376,333.6312234,2272.692189,48.48275862,110186.3868,77,44,40,33,4,14,2,female
795 ms,795,15500 KB,15500,Antarctica,Antarctica,73,403,378.8670746,2494.499297,61.15277778,152545.5612,69,48,32,21,16,13,2,female
1855 ms,1855,12900 KB,12900,China,Asia,73,383,379.3421297,2370.702806,54.45,129084.7678,52,35,35,17,0,14,1,female
795 ms,795,11800 KB,11800,China,Asia,66,355,334.5126491,2145.759912,45.5,97632.07601,59,36,33,23,3,14,2,female
701 ms,701,9400 KB,9400,China,Asia,72,330,373.6840496,2036.07525,44.1,89790.91855,71,55,52,16,3,15,2,female
2433 ms,2433,9400 KB,9400,India,Asia,73,419,379.3421297,2593.53649,37.125,96285.0422,54,39,36,15,3,15,2,female
873 ms,873,21100 KB,21100,India,Asia,72,333,372.3949821,2054.585025,52.52941176,107926.1428,67,52,52,15,0,14,2,female
748 ms,748,9500 KB,9500,Taiwan,Asia,68,326,346.1173001,1984.512886,46.6875,92651.94538,57,45,42,12,3,15,2,female
685 ms,685,11800 KB,11800,Unknown,Unknown,73,399,378.8670746,2469.739999,66.80555556,164992.3527,57,46,42,11,4,17,3,female
670 ms,670,9400 KB,9400,China,Asia,85,422,460.4869215,2704.762975,58.21276596,157451.734,62,48,46,14,2,13,2,female
780 ms,780,0 KB,0,China,Asia,79,413,420.1071259,2603.461449,49.48888889,128842.4144,49,31,25,18,6,12,1,female
624 ms,624,15400 KB,15400,Japan,Asia,75,346,392.6333688,2155.171267,51.85294118,111751.9689,70,36,30,34,6,12,1,female
685 ms,685,15400 KB,15400,Unknown,Unknown,69,364,353.3374044,2223.502902,37.7,83826.05942,62,43,37,19,6,15,2,female
2542 ms,2542,0 KB,0,China,Asia,75,314,392.2479866,1955.849069,31.95833333,62505.67649,63,36,30,27,6,5,1,female
4446 ms,4446,11800 KB,11800,Japan,Asia,79,419,419.0078103,2641.284133,66.7875,176404.7641,73,46,36,27,10,14,3,female
1122 ms,1122,15400 KB,15400,Ukraine,Europe,62,335,307.1601712,1994.655764,44,87764.85362,55,52,51,3,1,12,1,female
826 ms,826,12900 KB,12900,China,Asia,72,552,372.2346001,3405.798601,57,194130.5202,85,76,73,9,3,25,2,female
701 ms,701,9500 KB,9500,India,Asia,68,347,346.6279634,2112.349606,43.06666667,90971.85636,74,53,49,21,4,13,2,female
280 ms,280,13900 KB,13900,China,Asia,86,543,466.9609738,3489.461762,60,209367.7057,80,59,53,21,6,23,3,female
873 ms,873,23700 KB,23700,Japan,Asia,44,316,210.1173001,1725.180391,18,31053.24705,80,54,42,26,12,12,2,female
732 ms,732,11800 KB,11800,Egypt,AsiaAfrica,77,461,405.551932,2888.988595,67.22368421,194208.457,85,70,61,15,9,23,1,female
2308 ms,2308,71900 KB,71900,Russia,AsiaEurope,57,353,275.7915183,2059.010175,50.07692308,103108.8941,73,37,26,36,11,10,1,female
4352 ms,4352,15500 KB,15500,Russia,AsiaEurope,68,384,345.9474732,2337.585731,55.5,129736.0081,71,54,45,17,9,18,5,female
2745 ms,2745,12200 KB,12200,China,Asia,92,440,508.6701412,2870.367261,55.02,157927.6067,79,49,36,30,13,14,3,female
1950 ms,1950,369900 KB,369900,Serbia,Europe,67,358,339.4387425,2171.65993,27.3030303,59292.89688,70,41,36,29,5,6,2,female
1590 ms,1590,14200 KB,14200,Lithuania,Europe,69,393,353.3374044,2400.650112,66.95,160723.525,78,51,36,27,15,15,3,female
3915 ms,3915,9400 KB,9400,Russia,AsiaEurope,71,357,366.1306865,2195.459722,45.09375,99001.51182,71,45,39,26,6,12,2,female
4523 ms,4523,23500 KB,23500,India,Asia,61,387,303.4631705,2295.19535,48.73913043,111865.8255,69,54,50,15,4,17,2,female
951 ms,951,40000 KB,40000,Unknown,Unknown,71,451,365.6422056,2773.535951,64.16666667,177968.5568,65,55,55,10,0,16,2,female
280 ms,280,12900 KB,12900,Zambia,Africa,81,473,432.536756,2998.749051,72.68292683,217957.8579,68,53,48,15,5,25,3,female
295 ms,295,12900 KB,12900,China,Asia,81,473,432.536756,2998.749051,72.68292683,217957.8579,68,53,48,15,5,25,3,female
810 ms,810,14100 KB,14100,China,Asia,90,529,494.2667787,3434.190288,68,233524.9396,72,60,55,12,5,26,6,female
2745 ms,2745,0 KB,0,Iran,Asia,55,360,263.6191856,2081.289497,58.77083333,122319.1181,71,48,36,23,12,14,1,female
1029 ms,1029,18200 KB,18200,Iran,Asia,84,613,453.092115,3918.49058,112.2,439654.6431,80,65,60,15,5,29,1,female
2246 ms,2246,24300 KB,24300,Iran,Asia,55,370,272.9626011,2139.103094,38.07142857,81438.71065,74,44,28,30,16,21,5,female
717 ms,717,75200 KB,75200,India,Asia,69,395,352.582306,2412.86716,35.45454545,85547.10842,71,50,44,21,6,14,2,female
483 ms,483,11300 KB,11300,China,Asia,100,620,564.6454601,4119.190838,54.98113208,226477.7755,64,53,53,11,0,28,20,female
732 ms,732,15400 KB,15400,Unknown,Unknown,53,436,256.7497745,2497.373318,25.4375,63526.93378,93,62,49,31,13,23,1,female
1247 ms,1247,15500 KB,15500,Vietnam,Asia,78,418,412.2613731,2627.298127,38.5,101150.9779,85,56,49,29,7,10,4,female
873 ms,873,15400 KB,15400,Ukraine,Europe,62,363,307.2067179,2161.373261,50.13333333,108356.8461,62,59,58,3,1,16,1,female
467 ms,467,11800 KB,11800,China,Asia,71,456,365.6422056,2804.284686,42.17142857,118260.6914,94,80,78,14,2,20,3,female
717 ms,717,11800 KB,11800,South Korea,Asia,88,585,482.043467,3778.767497,49.33333333,186419.1965,101,62,51,39,11,22,3,female
3010 ms,3010,10600 KB,10600,China,Asia,79,466,419.0078103,2937.561829,35.5875,104540.4816,91,59,59,32,0,10,3,female
2043 ms,2043,16700 KB,16700,India,Asia,64,393,322.9162238,2358,35.83333333,84495,103,81,78,22,3,12,1,female
2105 ms,2105,16700 KB,16700,India,Asia,64,393,322.9162238,2358,35.83333333,84495,103,81,78,22,3,12,1,female
2121 ms,2121,16700 KB,16700,India,Asia,64,393,322.9162238,2358,35.83333333,84495,104,81,78,23,3,12,1,female
889 ms,889,25800 KB,25800,China,Asia,102,596,579.9778889,3976.765504,82.68965517,328837.3682,67,50,43,17,7,22,5,female
857 ms,857,32700 KB,32700,India,Asia,56,499,279.7803007,2897.870106,40.5,117363.7393,98,74,73,24,1,19,4,female
467 ms,467,12900 KB,12900,China,Asia,75,443,392.9423377,2759.36668,56.63636364,156280.4947,103,82,73,21,9,24,2,female
4367 ms,4367,14100 KB,14100,Vietnam,Asia,83,557,446.1369639,3550.896963,68.12195122,241894.0297,76,53,52,23,1,25,3,female
701 ms,701,15500 KB,15500,Ukraine,Europe,77,516,405.551932,3233.661855,71.61538462,231579.9375,80,36,30,44,6,17,2,female
888 ms,888,22400 KB,22400,India,Asia,38,175,162.6452839,918.3873149,25.3,23235.19907,87,57,54,30,3,11,2,female
327 ms,327,12800 KB,12800,China,Asia,49,224,228.6387356,1257.695005,29.27777778,36822.51487,96,67,64,29,3,32,5,female
779 ms,779,25100 KB,25100,Bangladesh,Asia,65,519,328.9735285,3125.608895,100.8,315061.3766,100,62,42,38,20,18,4,female
514 ms,514,48100 KB,48100,China,Asia,116,605,683.1336612,4149.078502,51.58571429,214033.1782,79,47,37,32,10,11,3,female
716 ms,716,11800 KB,11800,Canada,North America,134,719,819.147473,5080.518128,72.02380952,365918.2699,57,45,40,12,5,33,7,female
748 ms,748,11800 KB,11800,Canada,North America,134,719,819.147473,5080.518128,72.02380952,365918.2699,57,45,40,12,5,33,7,female
2870 ms,2870,15400 KB,15400,Taiwan,Asia,70,484,359.7107722,2966.57298,67.93548387,201535.5708,84,35,22,49,13,12,1,female
1045 ms,1045,23600 KB,23600,India,Asia,65,365,327.3557123,2198.164252,46.25,101665.0966,91,61,56,30,5,16,3,female
4320 ms,4320,16700 KB,16700,Unknown,Unknown,73,396,380.0574174,2451.170525,62.32258065,152763.2727,91,60,40,31,20,18,1,female
1262 ms,1262,9600 KB,9600,Jordan,Asia,87,558,473.9427998,3595.162471,45.95744681,165224.488,102,73,73,29,0,18,2,female
280 ms,280,15300 KB,15300,China,Asia,83,522,446.2065082,3327.770583,64.18604651,213596.4374,100,67,62,33,5,22,3,female
4507 ms,4507,18800 KB,18800,Iran,Asia,81,574,432.75063,3639.073902,64.5,234720.2667,91,41,41,50,0,15,4,female
4523 ms,4523,11900 KB,11900,Ukraine,Europe,73,441,379.3421297,2729.71263,39.39393939,107534.1339,107,52,41,55,11,8,2,female
732 ms,732,11800 KB,11800,China,Asia,104,590,593.0955666,3953.259434,79.29090909,313457.5344,100,66,59,34,7,28,4,female
764 ms,764,9400 KB,9400,Bangladesh,Asia,96,646,538.6054173,4253.885775,48.57894737,206649.2932,117,48,16,69,32,11,4,female
171 ms,171,13000 KB,13000,China,Asia,122,600,728.2270778,4158.442403,44.18,183719.9853,71,52,52,19,0,36,15,female
779 ms,779,15400 KB,15400,Russia,AsiaEurope,102,565,578.7005665,3769.920318,56.85849057,214351.9788,99,66,52,33,14,23,7,female
888 ms,888,18800 KB,18800,Iran,Asia,52,383,257.71338,2183.268412,24.22727273,52894.63926,93,43,17,50,26,14,2,female
2355 ms,2355,10700 KB,10700,Russia,AsiaEurope,71,493,366.4572094,3031.82533,54.83870968,166261.3891,104,64,59,40,5,13,1,female
4351 ms,4351,15400 KB,15400,Japan,Asia,73,388,380.0574174,2401.651929,66.38709677,159438.699,92,60,50,32,10,16,4,female
638 ms,638,15400 KB,15400,Russia,AsiaEurope,108,564,621.9557072,3809.756551,56.89655172,216762.0107,102,68,53,34,15,22,7,female
218 ms,218,15800 KB,15800,China,Asia,95,482,529.5086837,3166.670403,57.37254902,181679.9529,99,51,47,48,4,20,3,female
187 ms,187,15800 KB,15800,China,Asia,95,479,529.5086837,3146.960836,57.37254902,180549.1648,99,50,46,49,4,20,3,female
187 ms,187,15500 KB,15500,China,Asia,95,486,529.5086837,3192.949826,57.37254902,183187.6704,99,49,45,50,4,20,3,female
2417 ms,2417,10700 KB,10700,Russia,AsiaEurope,71,482,366.4572094,2964.178112,54.83870968,162551.7029,100,60,55,40,5,12,1,female
779 ms,779,24900 KB,24900,India,Asia,34,191,142.0956728,971.7054027,18.81818182,18285.72894,88,48,41,40,7,13,1,female
4570 ms,4570,23500 KB,23500,India,Asia,61,387,303.4631705,2295.19535,48.73913043,111865.8255,91,54,51,37,3,17,2,female
842 ms,842,16200 KB,16200,Brazil,South America,91,537,502.5535519,3494.685722,39.375,137603.2503,126,78,50,48,28,13,3,female
1778 ms,1778,50000 KB,50000,Russia,AsiaEurope,82,528,439.3544556,3356.787458,55.23809524,185422.5453,112,61,47,51,14,13,4,female
4929 ms,4929,23700 KB,23700,India,Asia,42,464,214.8771238,2502.035284,20,50040.70568,140,95,87,45,8,19,2,female
1029 ms,1029,11800 KB,11800,Unknown,Unknown,104,604,592.8734765,4047.06559,76.5,309600.5176,92,78,78,14,0,28,7,female
1294 ms,1294,10600 KB,10600,Bangladesh,Asia,74,452,385.8508604,2806.672921,31.76470588,89153.13985,99,43,32,56,11,9,1,female
935 ms,935,23500 KB,23500,India,Asia,40,340,194.1173001,1809.455552,18,32570.19994,99,55,54,44,1,13,2,female
857 ms,857,12000 KB,12000,India,Asia,92,491,508.1990654,3203.06892,46.47777778,148871.5255,128,48,17,80,31,14,4,female
187 ms,187,10600 KB,10600,China,Asia,121,810,719.3553825,5604.279222,51.72222222,289865.7753,122,93,86,29,7,47,13,female
4398 ms,4398,15400 KB,15400,Japan,Asia,75,435,393.7950768,2709.53613,69.5483871,188443.8676,108,76,66,32,10,19,4,female
1231 ms,1231,11800 KB,11800,China,Asia,79,395,421.065676,2489.993396,39.65625,98743.80059,93,49,46,44,3,14,3,female
716 ms,716,11800 KB,11800,Canada,North America,108,747,621.9557072,5045.900964,63.36206897,319718.7249,96,46,34,50,12,25,8,female
748 ms,748,15400 KB,15400,South Korea,Asia,71,651,372.120125,4003.485375,74.08695652,296606.0469,100,66,61,34,5,23,8,female
701 ms,701,10700 KB,10700,China,Asia,86,659,466.692323,4234.908473,120.75,511365.1982,150,101,94,49,7,32,8,female
3431 ms,3431,251700 KB,251700,Antarctica,Antarctica,134,1049,817.7421297,7412.327561,98.92682927,733278.0631,142,105,105,37,0,45,11,female
3338 ms,3338,251700 KB,251700,Antarctica,Antarctica,135,1052,825.5511381,7444.810008,98.6746988,734614.3851,143,106,106,37,0,45,11,female
4102 ms,4102,23500 KB,23500,Russia,AsiaEurope,74,484,385.6555921,3005.375429,41.22857143,123907.3355,139,53,42,86,11,17,4,female
2386 ms,2386,11900 KB,11900,Russia,AsiaEurope,73,482,379.3421297,2983.495437,42.42424242,126572.5337,139,53,42,86,11,17,4,female
1388 ms,1388,29500 KB,29500,China,Asia,93,1195,517.9616502,7814.294779,68.10810811,532216.8336,168,119,96,49,23,75,20,female
795 ms,795,23100 KB,23100,India,Asia,110,825,636.89576,5594.621764,57.03278689,319076.8708,131,74,68,57,6,27,10,female
733 ms,733,11800 KB,11800,Bangladesh,Asia,90,692,498.9397367,4492.362343,46.31578947,208067.3085,181,50,31,131,19,7,1,female
3447 ms,3447,18800 KB,18800,India,Asia,57,1348,294.284957,7862.735739,56.4,443458.2957,346,279,257,67,22,40,13,female
31 ms,31,3700 KB,3700,India,Asia,44,211,199.4848078,1151.940072,26.1,30065.63587,48,42,40,6,2,9,3,male
46 ms,46,100 KB,100,China,Asia,53,240,251.6875812,1374.700909,40.15909091,55206.73878,29,25,25,4,0,7,2,female
31 ms,31,9800 KB,9800,China,Asia,46,235,211.2067179,1298.03706,23.4375,30422.74359,48,40,40,8,0,9,2,male
31 ms,31,100 KB,100,China,Asia,65,290,326.7316235,1746.486666,24.5,42788.92331,28,20,20,8,0,7,3,female
31 ms,31,200 KB,200,India,Asia,48,220,221.5920716,1228.69175,25.18421053,30943.63171,39,34,34,5,0,7,2,male
31 ms,31,300 KB,300,Philippines,Asia,50,241,235.05865,1360.169342,27.55555556,37480.22186,43,38,37,5,1,11,2,male
31 ms,31,100 KB,100,China,Asia,51,233,240.0186475,1321.675105,24.8,32777.5426,44,39,39,5,0,10,2,male
31 ms,31,100 KB,100,China,Asia,45,259,206.8830545,1422.389952,32.10714286,45668.87739,36,30,30,6,0,8,1,female
62 ms,62,100 KB,100,China,Asia,59,280,288.1860234,1647.140054,22.14285714,36472.38691,39,34,32,5,2,12,3,male
31 ms,31,400 KB,400,China,Asia,47,287,216.6935862,1594.167,30.88235294,49231.62795,35,32,32,3,0,13,1,male
31 ms,31,100 KB,100,China,Asia,40,256,176.4876789,1362.413592,29.07692308,39614.79522,61,55,54,6,1,14,4,female
46 ms,46,100 KB,100,Bangladesh,Asia,38,264,167.8252188,1385.452864,19.6,27154.87613,54,48,48,6,0,13,1,male
31 ms,31,100 KB,100,China,Asia,58,270,281.9620482,1581.654869,26.98148148,42675.39155,43,37,37,6,0,11,4,male
31 ms,31,3800 KB,3800,India,Asia,41,233,181.6849315,1248.309617,31.82142857,39722.99531,35,24,18,11,6,7,1,male
31 ms,31,200 KB,200,India,Asia,50,296,239.420269,1670.581432,32.14285714,53697.26032,65,61,61,4,0,18,2,male
31 ms,31,4000 KB,4000,India,Asia,59,290,288.0881667,1705.966484,27.93103448,47649.4087,35,30,28,5,2,8,1,male
46 ms,46,400 KB,400,China,Asia,43,214,192.3819626,1161.220658,33.75,39191.19719,32,27,25,5,2,7,1,female
46 ms,46,100 KB,100,China,Asia,51,254,238.9889445,1440.796037,26.36363636,37984.62279,41,34,30,7,4,10,3,male
31 ms,31,100 KB,100,China,Asia,52,319,245.3142135,1818.44027,35.45454545,64471.97321,33,27,27,6,0,13,1,male
30 ms,30,200 KB,200,South Korea,Asia,42,271,194.994331,1461.318022,40.33333333,58939.82687,52,40,36,12,4,8,1,male
46 ms,46,300 KB,300,China,Asia,56,324,269.6764904,1881.582995,29.14,54829.32847,44,39,39,5,0,13,1,female
31 ms,31,100 KB,100,China,Asia,58,228,282.2114327,1335.619667,24.61538462,32876.7918,52,39,33,13,6,8,2,male
31 ms,31,0 KB,0,China,Asia,65,335,326.5538222,2017.493217,25.98529412,52425.15463,59,55,55,4,0,14,1,male
46 ms,46,100 KB,100,China,Asia,59,232,288.3819626,1364.773187,26.07407407,35585.19718,50,34,25,16,9,8,2,male
31 ms,31,100 KB,100,Kyrgyzstan,Asia,65,324,326.5538222,1951.247171,31.91176471,62267.74062,46,33,27,13,6,10,2,male
31 ms,31,2400 KB,2400,China,Asia,53,325,251.6875812,1861.574148,26.77272727,49839.41696,58,54,54,4,0,11,2,male
31 ms,31,2000 KB,2000,China,Asia,47,241,215.9400989,1338.655913,21.75,29115.76611,36,23,21,13,2,8,1,male
31 ms,31,200 KB,200,South Korea,Asia,41,281,188.529325,1505.472113,39.11111111,58880.6871,59,47,43,12,4,11,1,male
31 ms,31,100 KB,100,India,Asia,52,254,248.0323866,1447.911688,37.77777778,54698.88601,52,33,33,19,0,8,3,male
31 ms,31,100 KB,100,United States,North America,66,363,334.0271833,2194.115065,35.96428571,78909.7811,44,37,37,7,0,17,3,male
30 ms,30,400 KB,400,China,Asia,43,304,199.6842869,1649.584485,44.55,73488.98883,53,44,42,9,2,13,1,female
31 ms,31,100 KB,100,India,Asia,57,289,275.5886804,1685.705214,33.33333333,56190.1738,45,38,34,7,4,11,4,male
30 ms,30,0 KB,0,Russia,AsiaEurope,59,246,290.159225,1447.13019,33.65217391,48699.07683,48,40,35,8,5,8,2,male
31 ms,31,300 KB,300,China,Asia,49,242,228.6387356,1358.759782,29.27777778,39781.46696,54,42,36,12,6,10,2,male
31 ms,31,100 KB,100,Germany,Europe,43,227,198.0537478,1231.762099,20.36363636,25083.15548,55,37,26,18,11,5,2,male
31 ms,31,700 KB,700,Iran,Asia,46,247,213.3029689,1364.319803,28.57142857,38980.5658,52,30,13,22,17,9,1,male
31 ms,31,100 KB,100,Iran,Asia,56,240,271.0812322,1393.765181,37.09090909,51696.01763,45,34,32,11,2,9,2,male
46 ms,46,200 KB,200,China,Asia,64,350,321.6326782,2100,28.5,59850,48,38,35,10,3,16,1,male
31 ms,31,100 KB,100,Belarus,Europe,56,256,271.0812322,1486.68286,35.54545455,52844.81803,44,29,27,15,2,8,2,male
31 ms,31,100 KB,100,China,Asia,52,230,246.4385619,1311.101135,24.8,32515.30815,37,33,33,4,0,8,2,female
31 ms,31,100 KB,100,Vietnam,Asia,57,289,275.5886804,1685.705214,33.33333333,56190.1738,45,38,34,7,4,11,4,male
31 ms,31,2900 KB,2900,India,Asia,49,352,228.6387356,1976.377865,90.41666667,178697.4986,61,47,39,14,8,13,1,male
31 ms,31,100 KB,100,United States,North America,46,238,212.1834446,1314.607746,24.8,32602.27209,45,38,35,7,3,9,2,male
31 ms,31,2000 KB,2000,India,Asia,51,262,239.4453837,1486.17544,27.85714286,41400.60153,40,29,27,11,2,8,1,male
31 ms,31,200 KB,200,India,Asia,40,267,182.1094106,1420.954801,24.11111111,34260.7991,53,39,33,14,6,9,3,male
30 ms,30,200 KB,200,India,Asia,55,246,267.8084246,1422.21449,33.91666667,48236.77477,46,31,26,15,5,12,1,male
31 ms,31,100 KB,100,China,Asia,57,294,278.3559659,1714.869664,31.71428571,54385.86649,44,38,38,6,0,13,2,male
46 ms,46,400 KB,400,Bangladesh,Asia,49,269,229.4868683,1510.356948,31.05882353,46909.90992,46,44,44,2,0,8,1,male
31 ms,31,200 KB,200,Mexico,North America,38,236,184.2797931,1238.510893,17.5,21673.94063,41,36,36,5,0,9,1,male
31 ms,31,100 KB,100,China,Asia,46,241,210.3683172,1331.178431,32.41176471,43145.8421,52,35,34,17,1,8,3,male
31 ms,31,200 KB,200,Belarus,Europe,53,243,251.2486429,1391.88467,29.34782609,40848.78924,49,36,30,13,6,5,2,male
31 ms,31,200 KB,200,India,Asia,42,269,193.2192809,1450.533387,19.2,27850.24103,51,39,37,12,2,8,1,male
31 ms,31,100 KB,100,Belarus,Europe,43,270,194.1844178,1465.091484,43.5,63731.47954,48,38,30,10,8,8,1,male
31 ms,31,100 KB,100,Vietnam,Asia,56,341,273.4603973,1980.308028,56.47368421,111835.2902,47,34,31,13,3,10,1,male
31 ms,31,100 KB,100,Vietnam,Asia,54,285,259.4122985,1640.142938,44.2,72494.31786,62,43,28,19,15,12,2,male
31 ms,31,300 KB,300,Unknown,Unknown,41,294,182.7116542,1575.120289,33.38461538,52584.78504,45,41,41,4,0,13,1,male
31 ms,31,400 KB,400,China,Asia,41,294,182.7116542,1575.120289,33.38461538,52584.78504,45,41,41,4,0,13,1,male
31 ms,31,2000 KB,2000,India,Asia,56,308,271.7635715,1788.665316,30.83333333,55150.51391,46,27,23,19,4,6,1,male
46 ms,46,200 KB,200,Bangladesh,Asia,46,234,219.336581,1292.513498,23.4,30244.81585,42,37,36,5,1,9,1,male
46 ms,46,2000 KB,2000,India,Asia,44,288,203.01955,1572.316306,24,37735.59135,57,32,26,25,6,4,1,male
31 ms,31,100 KB,100,China,Asia,63,327,314.9612072,1954.570535,49.80769231,97352.6478,54,40,38,14,2,10,3,female
31 ms,31,200 KB,200,India,Asia,41,249,192.6252211,1334.030449,17,22678.51764,75,60,54,15,6,11,4,male
30 ms,30,100 KB,100,Brazil,South America,60,275,295.1851693,1624.394914,28.76923077,46732.59214,55,41,32,14,9,11,3,male
31 ms,31,200 KB,200,India,Asia,42,297,193.2192809,1601.518275,28.8,46123.72631,50,43,40,7,3,10,1,male
31 ms,31,300 KB,300,Russia,AsiaEurope,48,273,221.5920716,1524.694763,28.23684211,43052.56527,64,34,21,30,13,9,2,male
31 ms,31,100 KB,100,South Korea,Asia,46,239,214.5707223,1320.131307,22.84615385,30159.92295,55,40,32,15,8,9,2,male
31 ms,31,200 KB,200,Russia,AsiaEurope,42,295,187.9089067,1590.73364,24,38177.60735,47,42,40,5,2,11,1,male
30 ms,30,200 KB,200,Kazakhstan,AsiaEurope,47,278,219.7679748,1544.175701,24.75,38218.34859,48,37,33,11,4,9,1,male
46 ms,46,200 KB,200,Kyrgyzstan,Asia,45,317,206.8830545,1740.917432,36.53571429,63605.66187,56,47,42,9,5,20,1,male
31 ms,31,400 KB,400,India,Asia,61,308,303.4631705,1826.6671,28.91304348,52814.50528,61,45,40,16,5,9,2,male
31 ms,31,100 KB,100,China,Asia,57,322,281.1893366,1878.190585,35.75,67145.3134,52,44,42,8,2,16,1,male
31 ms,31,200 KB,200,Indonesia,Asia,64,327,320,1962,34.5,67689,50,46,44,4,2,10,1,female
31 ms,31,2000 KB,2000,China,Asia,57,321,275.5886804,1872.357695,37.22222222,69693.31419,45,32,30,13,2,14,1,male
31 ms,31,100 KB,100,Vietnam,Asia,56,265,271.7635715,1538.949054,30.83333333,47450.92918,48,40,39,8,1,13,2,male
31 ms,31,100 KB,100,Bulgaria,Europe,48,397,234.6600115,2217.230113,26,57647.98293,67,64,64,3,0,17,2,male
31 ms,31,1000 KB,1000,Estonia,Europe,41,203,197.7269405,1087.583057,18,19576.49502,56,39,29,17,10,9,2,male
46 ms,46,100 KB,100,Bangladesh,Asia,40,281,178.9351967,1495.461795,26.36363636,39425.81095,52,40,35,12,5,9,1,male
31 ms,31,100 KB,100,China,Asia,48,302,227.6306219,1686.658675,22.88461538,38598.53507,50,29,29,21,0,8,1,female
30 ms,30,100 KB,100,India,Asia,52,329,249.0117739,1875.444667,35,65640.56335,65,62,61,3,1,20,1,male
31 ms,31,100 KB,100,Unknown,Unknown,62,354,307.3464548,2107.785494,44.94827586,94741.32384,59,49,44,10,5,14,3,female
31 ms,31,200 KB,200,Russia,AsiaEurope,51,306,241.523656,1735.762155,38.5,66826.84295,70,45,38,25,7,11,3,male
31 ms,31,0 KB,0,China,Asia,59,402,288.1860234,2364.822506,30.44642857,72000.39951,40,21,21,19,0,3,1,female
31 ms,31,200 KB,200,Kazakhstan,AsiaEurope,54,319,261.1759501,1835.809113,33,60581.70074,55,43,40,12,3,13,1,male
31 ms,31,100 KB,100,Venezuela,South America,74,424,386.4773318,2632.808227,24,63187.39745,46,20,15,26,5,5,1,male
31 ms,31,400 KB,400,China,Asia,47,298,218.6033589,1655.267478,32,52968.55929,59,49,45,10,4,13,1,male
31 ms,31,400 KB,400,China,Asia,41,285,182.7116542,1526.902321,33.38461538,50975.04673,50,47,47,3,0,12,1,female
31 ms,31,100 KB,100,Romania,Europe,47,342,221.0794529,1899.669387,35.30769231,67072.94221,72,55,45,17,10,17,1,female
46 ms,46,300 KB,300,Bangladesh,Asia,43,297,198.0537478,1611.600632,37.81818182,60947.80572,64,48,43,16,5,13,1,female
31 ms,31,0 KB,0,Antarctica,Antarctica,70,296,360.541081,1814.267773,36.05172414,65407.48127,69,8,-9,61,17,3,1,male
31 ms,31,200 KB,200,India,Asia,52,308,250.1173001,1755.735433,31.5,55305.66615,47,38,34,9,4,10,1,male
31 ms,31,200 KB,200,Unknown,Unknown,35,306,168.4650059,1569.560603,16.5,25897.74995,92,66,51,26,15,20,1,male
46 ms,46,0 KB,0,India,Asia,70,476,360.541081,2917.538716,53.75609756,156835.4959,36,27,23,9,4,20,1,male
31 ms,31,200 KB,200,India,Asia,37,269,177.7286241,1401.342955,17,23822.83024,52,42,39,10,3,11,2,male
31 ms,31,200 KB,200,India,Asia,49,415,234.2230164,2330.104585,22.15384615,51620.77851,66,58,54,8,4,29,1,male
31 ms,31,100 KB,100,India,Asia,42,301,194.994331,1623.087544,31.16666667,50586.22846,87,85,85,2,0,15,1,male
31 ms,31,100 KB,100,Ukraine,Europe,61,324,302.7888745,1921.558897,40.85416667,78503.68745,61,46,41,15,5,10,1,male
31 ms,31,2700 KB,2700,Unknown,Unknown,87,580,475.4109925,3736.907228,53.64705882,200474.0819,39,33,33,6,0,23,3,female
46 ms,46,100 KB,100,India,Asia,61,407,301.0709438,2413.810096,51.26785714,123750.8712,80,45,16,35,29,21,2,male
31 ms,31,300 KB,300,Vietnam,Asia,61,333,302.2137048,1974.935533,32.4,63987.91128,72,57,55,15,2,15,2,male
31 ms,31,100 KB,100,India,Asia,56,279,273.4603973,1620.252023,29.21052632,47328.41436,47,42,42,5,0,10,2,male
46 ms,46,100 KB,100,Bangladesh,Asia,61,338,301.3556992,2004.58922,41.55555556,83301.8187,43,40,39,3,1,15,2,male
31 ms,31,100 KB,100,China,Asia,66,455,333.6312234,2750.199324,33.17241379,91230.75,92,86,85,6,1,16,1,female
31 ms,31,200 KB,200,Brazil,South America,53,422,251.6875812,2417.182432,22.54545455,54496.47664,52,45,40,7,5,22,1,male
46 ms,46,19600 KB,19600,China,Asia,57,373,276.0964047,2175.667975,31.36,68228.9477,59,45,42,14,3,7,1,male
31 ms,31,100 KB,100,India,Asia,56,378,272.5558619,2195.180161,30.6,67172.51291,83,57,47,26,10,15,2,male
31 ms,31,100 KB,100,Jordan,Asia,60,357,296.7916995,2108.759943,28.15217391,59366.17665,71,53,46,18,7,16,4,male
31 ms,31,200 KB,200,Russia,AsiaEurope,60,350,296.1564001,2067.411708,39,80629.05663,48,32,27,16,5,13,1,male
31 ms,31,900 KB,900,Iran,Asia,56,343,275.6175548,1991.922738,27.52941176,54836.46127,72,59,55,13,4,18,1,male
31 ms,31,100 KB,100,Canada,North America,66,393,334.5126491,2375.446889,36.83333333,87495.62707,56,37,34,19,3,13,6,male
46 ms,46,200 KB,200,India,Asia,68,418,346.3298602,2544.559468,32.82258065,83519.00833,53,32,30,21,2,14,4,male
31 ms,31,300 KB,300,India,Asia,54,359,260.2355283,2066.004613,26.71052632,55184.07059,81,66,66,15,0,8,2,male
31 ms,31,100 KB,100,Armenia,Europe,50,394,235.9518742,2223.679339,57.26470588,127338.3433,53,49,47,4,2,13,1,male
31 ms,31,200 KB,200,India,Asia,73,429,378.8670746,2655.434736,30.64864865,81385.48623,53,32,30,21,2,14,4,male
31 ms,31,200 KB,200,Bulgaria,Europe,55,275,265.9634675,1589.873921,32.375,51472.1682,57,39,35,18,4,10,2,male
46 ms,46,0 KB,0,China,Asia,94,470,524.6331211,3080.65676,39.69642857,122291.071,57,45,42,12,3,19,3,female
31 ms,31,100 KB,100,Finland,Europe,51,382,243.5249056,2166.866481,38.28125,82950.35746,81,70,62,11,8,21,1,male
31 ms,31,100 KB,100,Egypt,AsiaAfrica,56,347,273.4603973,2015.152158,41.86842105,84371.23903,69,62,62,7,0,15,1,male
31 ms,31,100 KB,100,India,Asia,44,321,210.1173001,1752.47755,29.25,51259.96833,56,50,47,6,3,19,1,female
31 ms,31,3000 KB,3000,China,Asia,58,460,281.9620482,2694.671258,20.66666667,55689.87266,57,46,46,11,0,15,2,male
31 ms,31,100 KB,100,Unknown,Unknown,59,330,291.6599114,1941.272206,46.14285714,89575.84609,72,50,40,22,10,10,4,male
46 ms,46,2700 KB,2700,China,Asia,73,495,378.8670746,3063.963157,44.27027027,135642.477,46,37,34,9,3,22,1,male
31 ms,31,200 KB,200,Indonesia,Asia,60,361,294.6059378,2132.387505,37.625,80231.07988,58,41,31,17,10,18,3,male
31 ms,31,100 KB,100,India,Asia,59,387,291.6599114,2276.58286,29.85714286,67972.25968,73,60,59,13,1,17,1,male
31 ms,31,400 KB,400,Jordan,Asia,48,294,225.0683649,1641.978975,35.2,57797.65993,74,44,32,30,12,9,1,male
31 ms,31,100 KB,100,Iran,Asia,43,323,198.0537478,1752.683516,32,56085.8725,68,51,47,17,4,16,1,male
46 ms,46,100 KB,100,China,Asia,43,437,194.1844178,2371.277698,35.21428571,83502.85036,102,92,90,10,2,18,1,male
31 ms,31,100 KB,100,China,Asia,70,428,359.2147805,2623.333131,73.43939394,192655.9953,58,49,44,9,5,11,3,female
46 ms,46,200 KB,200,Australia,Australia,53,293,259.4336554,1678.280693,33.42857143,56102.52603,62,47,36,15,11,10,1,male
31 ms,31,200 KB,200,Bangladesh,Asia,44,313,206.1930176,1708.802097,30.6,52289.34416,59,43,41,16,2,11,2,male
31 ms,31,200 KB,200,Tajikistan,Asia,55,376,268.9081138,2173.791252,49.17647059,106899.3816,75,60,47,15,13,17,1,male
31 ms,31,400 KB,400,Unknown,Unknown,44,319,198.6059378,1741.558686,42.875,74669.32868,59,50,49,9,1,13,1,male
31 ms,31,200 KB,200,Serbia,Europe,36,332,174.9737366,1716.4151,17,29179.05671,53,41,39,12,2,15,1,female
31 ms,31,100 KB,100,Unknown,Unknown,52,380,246.4385619,2166.167093,50.4,109174.8215,72,64,58,8,6,18,1,male
31 ms,31,100 KB,100,United States,North America,61,350,303.4631705,2075.758068,30.56521739,63445.9966,67,47,33,20,14,16,1,male
46 ms,46,100 KB,100,Serbia,Europe,54,447,261.1759501,2572.434713,19,48876.25956,53,33,19,20,14,27,1,female
46 ms,46,200 KB,200,Vietnam,Asia,49,318,234.2230164,1785.47773,31.84615385,56860.59849,53,35,25,18,10,13,1,male
31 ms,31,200 KB,200,Bulgaria,Europe,58,378,284.9884404,2214.316816,51.97619048,115091.7526,62,49,40,13,9,11,1,male
31 ms,31,100 KB,100,Romania,Europe,44,372,198.6059378,2030.908562,35,71081.79967,78,67,64,11,3,17,1,female
15 ms,15,100 KB,100,China,Asia,74,372,385.5385456,2309.916652,38.84210526,89722.02575,57,49,48,8,1,9,1,female
30 ms,30,100 KB,100,India,Asia,50,377,240.8554909,2127.733784,41.26923077,87809.93653,58,50,48,8,2,13,2,female
31 ms,31,100 KB,100,Ukraine,Europe,69,345,353.0013311,2107.440938,34.93548387,73624.46888,62,53,49,9,4,11,3,female
31 ms,31,100 KB,100,China,Asia,13,28,40.05374781,103.6123121,5.5,569.8677166,57,38,35,19,3,15,2,female
46 ms,46,400 KB,400,Bangladesh,Asia,36,336,174.9737366,1737.0948,17,29530.61161,72,59,54,13,5,13,2,female
46 ms,46,4400 KB,4400,China,Asia,76,500,399.1845378,3123.963757,43.53658537,136006.7148,84,78,77,6,1,12,1,female
31 ms,31,100 KB,100,China,Asia,55,379,265.2124025,2191.135331,29.14285714,63855.94394,47,32,28,15,4,17,2,female
62 ms,62,30800 KB,30800,Indonesia,Asia,37,309,181.5249056,1609.72109,17.5,28170.11907,66,54,54,12,0,15,1,female
31 ms,31,8000 KB,8000,India,Asia,72,377,372.2746801,2326.061726,35.41428571,82375.81454,68,45,38,23,7,10,3,female
31 ms,31,100 KB,100,China,Asia,51,349,242.4606049,1979.676444,33,65329.32266,85,32,18,53,14,8,2,female
31 ms,31,100 KB,100,China,Asia,46,381,219.336581,2104.477105,23.4,49244.76426,107,104,104,3,0,20,1,female
46 ms,46,100 KB,100,China,Asia,68,442,347.4830616,2690.658576,65,174892.8074,69,57,57,12,0,17,3,female
31 ms,31,100 KB,100,Belarus,Europe,49,347,230.4650059,1948.304316,49.5,96441.06364,72,48,42,24,6,14,1,female
31 ms,31,100 KB,100,Kazakhstan,AsiaEurope,66,437,333.3240179,2641.40023,47.4,125202.3709,90,35,24,55,11,9,2,female
31 ms,31,100 KB,100,Taiwan,Asia,46,407,215.9932866,2248.089716,29.75,66880.66905,91,68,54,23,14,21,2,female
46 ms,46,200 KB,200,China,Asia,49,425,228.6387356,2386.251684,30.13888889,71918.97436,114,109,109,5,0,19,2,female
31 ms,31,200 KB,200,China,Asia,71,495,368.5969538,3044.124824,35.03703704,106657.1142,73,48,48,25,0,15,2,female
31 ms,31,200 KB,200,Unknown,Unknown,54,376,262.2366428,2163.837701,26.11764706,56514.34936,67,40,40,27,0,11,1,female
31 ms,31,0 KB,0,China,Asia,58,606,283.0128366,3549.936483,26.20833333,93037.91866,105,93,93,12,0,26,2,female
31 ms,31,0 KB,0,China,Asia,65,607,328.9735285,3655.577263,40,146223.0905,91,75,75,16,0,26,2,female
31 ms,31,300 KB,300,China,Asia,70,470,360.0838417,2880.763018,44,126753.5728,92,86,86,6,0,19,2,female
31 ms,31,9800 KB,9800,China,Asia,87,521,473.5443757,3356.773561,58.14772727,195188.7536,111,63,47,48,16,13,8,female
31 ms,31,100 KB,100,China,Asia,67,415,347.5042379,2517.427014,37.6,94655.25573,76,51,46,25,5,17,3,female
31 ms,31,300 KB,300,Vietnam,Asia,76,412,398.9944238,2574.146136,40.05,103094.5527,74,50,44,24,6,12,3,female
46 ms,46,200 KB,200,Poland,Europe,63,452,316.1697866,2701.730525,44.6875,120733.5829,87,61,38,26,23,25,3,female
31 ms,31,200 KB,200,Russia,AsiaEurope,57,357,278.3559659,2082.341735,30.85714286,64255.1164,70,49,46,21,3,11,1,female
46 ms,46,200 KB,200,Russia,AsiaEurope,46,406,219.336581,2242.566154,39.6,88805.6197,63,55,51,8,4,14,1,female
31 ms,31,100 KB,100,China,Asia,64,553,320.0450916,3318,37.79032258,125388.2903,97,79,75,18,4,23,3,female
31 ms,31,100 KB,100,China,Asia,52,465,252.7242144,2650.704469,23.07142857,61155.53882,66,43,40,23,3,12,2,female
31 ms,31,400 KB,400,China,Asia,63,479,318.7159976,2863.117083,39,111661.5663,99,65,64,34,1,11,1,female
30 ms,30,100 KB,100,Ukraine,Europe,63,428,315.5176503,2558.275807,34.2,87493.03261,91,40,28,51,12,10,2,female
31 ms,31,3300 KB,3300,China,Asia,73,498,379.6596322,3082.53263,39.078125,120459.5954,95,59,59,36,0,16,2,female
31 ms,31,100 KB,100,China,Asia,73,485,378.8670746,3002.064911,34.43055556,103362.7627,78,56,54,22,2,12,1,female
46 ms,46,1400 KB,1400,China,Asia,73,510,378.9461511,3156.810525,48.85714286,154232.7428,84,55,55,29,0,16,3,female
31 ms,31,100 KB,100,Iran,Asia,57,409,277.0156616,2385.652016,31.7826087,75822.2445,79,54,50,25,4,12,1,female
31 ms,31,1100 KB,1100,China,Asia,94,665,523.2394163,4358.801586,41.77358491,182082.7682,77,67,65,10,2,32,4,female
31 ms,31,200 KB,200,Japan,Asia,42,386,191.6338334,2081.434525,18.31818182,38128.09608,110,93,87,17,6,30,1,female
31 ms,31,400 KB,400,Russia,AsiaEurope,67,540,339.6973857,3275.688163,38.32258065,125532.8238,108,79,73,29,6,18,3,female
31 ms,31,1700 KB,1700,South Korea,Asia,91,721,504.0920843,4692.119936,34.69090909,162773.9061,140,108,96,32,12,31,5,female
46 ms,46,100 KB,100,South Korea,Asia,50,416,244.1844343,2347.844175,31.90909091,74917.57322,92,69,63,23,6,17,3,female
31 ms,31,100 KB,100,Unknown,Unknown,41,372,208.1306865,1993.009346,19.5,38863.68224,111,85,85,26,0,20,1,female
31 ms,31,0 KB,0,China,Asia,78,797,414.08385,5009.465568,80.69565217,404242.0911,151,135,124,16,11,36,7,female
31 ms,31,0 KB,0,China,Asia,48,519,232.6405265,2898.595538,53.2,154205.2826,82,77,76,5,1,32,1,female
31 ms,31,1000 KB,1000,Unknown,Unknown,73,486,378.9461511,3008.254736,42.34285714,127378.1005,114,73,66,41,7,16,5,female
31 ms,31,100 KB,100,Iran,Asia,49,404,234.2230164,2268.342777,56.76923077,128772.0746,111,85,70,26,15,22,1,female
31 ms,31,100 KB,100,India,Asia,46,376,223.4212455,2076.859295,28.5,59190.48992,97,84,83,13,1,21,2,female
31 ms,31,11800 KB,11800,China,Asia,66,683,332.9737366,4128.321184,41.96875,173260.4797,135,120,115,15,5,29,1,female
31 ms,31,0 KB,0,China,Asia,73,603,378.9461511,3732.464209,39.08571429,145886.0297,108,77,70,31,7,21,4,female
31 ms,31,100 KB,100,China,Asia,71,617,365.7235111,3794.393973,57.13235294,216782.6556,71,66,66,5,0,29,1,female
30 ms,30,200 KB,200,Kazakhstan,AsiaEurope,63,441,314.1308434,2635.980446,43.125,113676.6567,102,95,91,7,4,24,2,female
31 ms,31,1000 KB,1000,China,Asia,50,576,240.8554909,3250.861165,59.76923077,194301.4712,143,120,116,23,4,24,1,female
46 ms,46,200 KB,200,China,Asia,113,759,658.7614447,5176.515832,39.68253968,205417.2949,104,73,66,31,7,40,12,female
46 ms,46,200 KB,200,India,Asia,39,446,194.7497745,2357.28939,18.5,43609.85371,122,81,63,41,18,26,1,female
31 ms,31,200 KB,200,India,Asia,56,638,271.7635715,3705.09244,39.16666667,145116.1206,170,148,146,22,2,22,2,female
31 ms,31,0 KB,0,China,Asia,84,574,454.1955001,3669.190201,28.125,103195.9744,83,55,54,28,1,26,2,female
31 ms,31,100 KB,100,Lithuania,Europe,49,552,232.8278745,3099.319834,58.75,182085.0402,132,113,99,19,14,21,1,female
31 ms,31,300 KB,300,Unknown,Unknown,50,573,235.05865,3233.929597,37.33333333,120733.3716,115,81,69,34,12,35,2,female
31 ms,31,100 KB,100,Russia,AsiaEurope,71,619,367.3587806,3806.693467,73.13793103,278413.6843,138,107,89,31,18,25,1,female
31 ms,31,100 KB,100,China,Asia,62,696,315.2736412,4144.120632,36.66666667,151951.0898,156,109,103,47,6,24,3,female
31 ms,31,100 KB,100,China,Asia,58,685,284.2247957,4012.716982,62.18181818,249518.0378,145,111,111,34,0,31,1,female
31 ms,31,200 KB,200,Russia,AsiaEurope,44,652,240.2149912,3559.549415,0,0,156,94,76,62,18,25,4,female
31 ms,31,100 KB,100,Japan,Asia,85,675,460.0105131,4326.338882,55.11111111,238429.3428,105,61,51,44,10,21,3,female
46 ms,46,200 KB,200,China,Asia,34,766,158.3349731,3896.996536,15.5,60403.44631,187,173,173,14,0,27,1,female
46 ms,46,0 KB,0,China,Asia,48,689,232.6405265,3848.039163,53.2,204715.6835,106,84,81,22,3,31,1,female
31 ms,31,100 KB,100,Russia,AsiaEurope,97,935,544.452116,6170.918507,75.98181818,468877.608,142,105,99,37,6,28,3,female
31 ms,31,3400 KB,3400,China,Asia,53,529,254.5835556,3030.06992,26.25,79539.33541,131,115,111,16,4,29,1,female
31 ms,31,1700 KB,1700,India,Asia,62,807,319.669035,4805.036422,43.86666667,210780.9311,166,127,123,39,4,42,3,female
31 ms,31,0 KB,0,China,Asia,74,1115,386.9094701,6923.540503,77.13953488,534078.6941,236,116,-2,120,118,40,3,female
31 ms,31,100 KB,100,China,Asia,79,596,420.5488559,3757.053326,44.60606061,167587.3484,120,95,89,25,6,35,3,female
31 ms,31,14300 KB,14300,Bangladesh,Asia,93,696,515.7710242,4551.254533,36.23529412,164916.0466,104,47,39,57,8,17,1,female
31 ms,31,100 KB,100,China,Asia,73,642,378.8670746,3973.867367,38.54166667,153159.4714,139,109,99,30,10,21,1,female
31 ms,31,200 KB,200,United Kingdom,Europe,82,746,439.3544556,4742.733795,102.375,485537.3723,145,109,100,36,9,27,8,female
31 ms,31,100 KB,100,China,Asia,49,596,239.3499675,3346.367067,42.9,143559.1472,163,145,140,18,5,22,2,female
31 ms,31,100 KB,100,Sweden,Europe,103,1296,589.445759,8665.704683,150.7936508,1306733.246,101,76,60,25,16,48,32,female
46 ms,46,100 KB,100,China,Asia,57,679,276.0964047,3960.53232,38.4,152084.4411,145,125,113,20,12,23,2,female
31 ms,31,100 KB,100,China,Asia,38,932,184.2797931,4891.068443,17.5,85593.69774,224,210,210,14,0,33,1,female
31 ms,31,3900 KB,3900,India,Asia,74,674,388.0148382,4185.171568,43.44827586,181838.4888,160,97,66,63,31,20,3,female
46 ms,46,21500 KB,21500,India,Asia,101,898,571.6579841,5979.073912,58.41509434,349268.1666,125,83,79,42,4,23,10,female
31 ms,31,1100 KB,1100,China,Asia,71,576,366.1306865,3542.254341,40.828125,144623.603,171,91,81,80,10,27,3,female
46 ms,46,3400 KB,3400,Russia,AsiaEurope,42,843,210.885574,4545.723587,19.5,88641.60995,233,178,175,55,3,35,3,female
31 ms,31,200 KB,200,India,Asia,66,724,335.7560369,4376.141342,45.92,200952.4104,156,135,130,21,5,27,1,female
31 ms,31,100 KB,100,Colombia,South America,54,556,259.4122985,3199.717451,74.8,239338.8653,136,126,121,10,5,33,1,female
31 ms,31,100 KB,100,Ukraine,Europe,89,592,488.714938,3833.634191,51.78431373,198522.1157,148,91,71,57,20,27,5,female
46 ms,46,100 KB,100,China,Asia,107,980,615.8588276,6606.637647,175.704918,1160818.726,140,98,96,42,2,49,8,female
31 ms,31,3800 KB,3800,Russia,AsiaEurope,95,616,529.3261988,4047.031055,46.8,189401.0534,121,56,50,65,6,21,6,female
46 ms,46,4000 KB,4000,China,Asia,134,1884,817.1076343,13312.51203,88.66049383,1180293.891,176,107,104,69,3,74,32,female
31 ms,31,4000 KB,4000,China,Asia,134,1886,817.1076343,13326.64421,88.66049383,1181546.857,178,108,105,70,3,74,32,female
31 ms,31,100 KB,100,Bangladesh,Asia,76,726,401.9471249,4535.995375,41.32758621,187461.7399,261,65,26,196,39,32,14,female
31 ms,31,100 KB,100,China,Asia,74,1322,385.8508604,8208.897349,44.11764706,362157.236,327,281,281,46,0,56,2,female
31 ms,31,33800 KB,33800,Bangladesh,Asia,244,6863,1737.148048,54428.65035,92.16666667,5016507.274,1823,1368,1302,455,66,395,78,female
546 ms,546,13500 KB,13500,Peru,South America,68,468,347.0121354,2848.93261,63.20689655,180072.1887,44,34,33,10,1,15,5,male
404 ms,404,16100 KB,16100,China,Asia,81,496,433.6087556,3144.565601,51.73913043,162697.0898,40,35,33,5,2,21,4,male
1404 ms,1404,16800 KB,16800,Russia,AsiaEurope,75,476,392.17102,2964.917697,60.59459459,179657.9858,55,50,50,5,0,22,5,male
452 ms,452,14600 KB,14600,Serbia,Europe,94,581,524.6331211,3808.216123,66.83928571,254538.4455,44,37,37,7,0,18,5,male
389 ms,389,15000 KB,15000,China,Asia,68,472,346.1173001,2873.282461,54,155157.2529,62,55,55,7,0,19,4,male
343 ms,343,15000 KB,15000,North Korea,Asia,68,472,346.1173001,2873.282461,54,155157.2529,63,55,54,8,1,19,4,male
686 ms,686,21000 KB,21000,India,Asia,90,525,494.7804146,3408.222876,66.52040816,226716.3768,48,43,43,5,0,25,5,male
327 ms,327,14500 KB,14500,China,Asia,69,461,352.7497745,2816.029775,53.765625,151405.6008,70,65,65,5,0,23,5,female
1778 ms,1778,13500 KB,13500,Brazil,South America,70,462,359.2147805,2831.728754,64.46969697,182560.6947,64,59,59,5,0,21,5,male
576 ms,576,92400 KB,92400,China,Asia,73,489,378.8670746,3026.824209,60.63888889,183543.2569,60,53,53,7,0,21,5,female
623 ms,623,92400 KB,92400,China,Asia,73,492,378.8670746,3045.393683,61.15277778,186234.2831,61,54,54,7,0,21,5,female
327 ms,327,13300 KB,13300,India,Asia,82,541,440.20115,3439.435634,57.13043478,196496.4532,66,59,59,7,0,22,6,male
421 ms,421,39500 KB,39500,China,Asia,102,650,582.6993217,4337.076472,63.14285714,273855.4001,41,0,0,41,0,0,6,male
390 ms,390,12500 KB,12500,China,Asia,81,538,432.9647657,3410.839302,47.93181818,163487.7292,55,52,52,3,0,23,5,female
467 ms,467,17800 KB,17800,Vietnam,Asia,64,411,320.7232379,2466,52.07142857,128408.1429,56,50,50,6,0,20,5,male
1107 ms,1107,17600 KB,17600,Syria,Asia,72,460,372.2746801,2838.165501,51.27142857,145516.7997,65,55,50,10,5,21,4,male
499 ms,499,17600 KB,17600,China,Asia,71,494,365.6422056,3037.975077,46.66666667,141772.1703,79,73,73,6,0,23,4,male
436 ms,436,15600 KB,15600,China,Asia,73,523,378.8670746,3237.278244,57.40540541,185837.27,61,49,47,12,2,23,4,male
358 ms,358,13900 KB,13900,Unknown,Unknown,134,797,830.2669693,5631.673085,71.02105263,399967.3506,27,23,23,4,0,28,9,female
202 ms,202,11900 KB,11900,China,Asia,82,488,440.20115,3102.485378,72.7826087,225806.9793,53,42,35,11,7,16,5,male
421 ms,421,15800 KB,15800,China,Asia,74,402,385.6555921,2496.200253,50.7,126557.3528,49,40,39,9,1,17,3,female
452 ms,452,15800 KB,15800,China,Asia,74,402,385.6555921,2496.200253,50.7,126557.3528,50,40,38,10,2,17,3,female
312 ms,312,13300 KB,13300,China,Asia,78,579,412.5946318,3639.247885,58.28571429,212116.1624,55,51,51,4,0,23,5,male
498 ms,498,22300 KB,22300,China,Asia,72,502,372.2746801,3097.302351,57.08571429,176811.717,77,69,69,8,0,23,5,female
280 ms,280,10500 KB,10500,China,Asia,65,507,326.9987489,3053.340481,53.37931034,162985.2091,74,69,69,5,0,22,7,male
530 ms,530,14500 KB,14500,China,Asia,77,515,405.6268983,3227.395068,51.8,167179.0645,60,46,43,14,3,21,4,male
452 ms,452,26200 KB,26200,China,Asia,60,506,295.6213103,2988.886641,42,125533.2389,61,57,57,4,0,22,4,male
1232 ms,1232,15800 KB,15800,China,Asia,79,465,419.0808777,2931.258048,64.73684211,189760.3894,69,51,43,18,8,21,5,male
405 ms,405,20100 KB,20100,China,Asia,72,528,372.2746801,3257.720401,54.39189189,177193.5759,76,67,67,9,0,20,6,female
1154 ms,1154,56000 KB,56000,China,Asia,87,536,473.7434822,3453.417714,64.17391304,221619.3281,65,0,0,65,0,0,6,male
732 ms,732,25000 KB,25000,China,Asia,74,471,385.4995491,2924.652535,52.5,153544.2581,56,45,39,11,6,22,4,male
498 ms,498,15800 KB,15800,Iran,Asia,82,508,439.3192644,3229.636418,68.5,221230.0947,69,55,48,14,7,19,4,male
842 ms,842,20500 KB,20500,China,Asia,74,470,385.6555921,2918.443082,62.95714286,183736.838,91,75,74,16,1,21,5,male
1216 ms,1216,14900 KB,14900,China,Asia,78,490,412.2613731,3079.847087,50.5,155532.2779,57,49,49,8,0,24,4,male
499 ms,499,15300 KB,15300,Unknown,Unknown,82,529,439.3192644,3363.14501,57.5,193380.8381,71,55,51,16,4,22,5,male
1762 ms,1762,17000 KB,17000,Canada,North America,84,497,452.9890166,3176.981759,61.02325581,193869.7706,67,53,47,14,6,23,3,male
311 ms,311,16000 KB,16000,China,Asia,103,635,588.2523093,4245.927835,72.63934426,308421.4137,50,33,32,17,1,24,6,male
374 ms,374,19900 KB,19900,China,Asia,80,541,425.7903187,3420.163099,70.3902439,240746.1147,61,49,44,12,5,21,4,male
1606 ms,1606,30000 KB,30000,Kyrgyzstan,Asia,82,442,439.6362367,2810.037986,49.65909091,139543.9318,85,72,66,13,6,19,5,male
1590 ms,1590,32000 KB,32000,Kyrgyzstan,Asia,82,442,439.6362367,2810.037986,49.65909091,139543.9318,85,72,66,13,6,19,5,male
1716 ms,1716,13500 KB,13500,China,Asia,70,462,359.2147805,2831.728754,64.46969697,182560.6947,64,59,59,5,0,21,5,male
374 ms,374,15900 KB,15900,South Korea,Asia,89,495,487.4132344,3205.488048,62.63043478,200761.1102,56,42,35,14,7,23,5,male
421 ms,421,15600 KB,15600,China,Asia,97,616,545.8935843,4065.546311,55.81034483,226899.5415,41,36,36,5,0,23,5,male
421 ms,421,13700 KB,13700,China,Asia,80,526,426.079159,3325.334178,44.74418605,148789.3711,79,74,74,5,0,22,5,female
1699 ms,1699,32000 KB,32000,Kyrgyzstan,Asia,82,445,439.6362367,2829.110642,49.65909091,140491.0626,86,72,66,14,6,19,5,male
249 ms,249,19900 KB,19900,Indonesia,Asia,75,496,392.17102,3089.49407,56.96052632,175979.2083,64,57,57,7,0,21,5,male
265 ms,265,11400 KB,11400,China,Asia,98,639,553.2066264,4226.79959,69.07627119,291971.5548,56,0,0,56,0,0,5,male
311 ms,311,9800 KB,9800,China,Asia,84,615,453.5050955,3931.275215,40.89130435,160754.9713,55,0,0,55,0,0,5,male
265 ms,265,13300 KB,13300,China,Asia,81,528,433.2506894,3347.440802,70.625,236413.0066,66,7,7,59,0,4,1,male
1496 ms,1496,15600 KB,15600,China,Asia,86,508,467.4994455,3264.542495,51.0625,166695.7012,59,10,10,49,0,5,2,male
342 ms,342,15800 KB,15800,India,Asia,95,550,531.3425622,3613.420585,63.02678571,227742.2849,56,43,38,13,5,23,5,male
436 ms,436,18300 KB,18300,India,Asia,80,467,425.7903187,2952.34042,64.20731707,189561.8575,60,46,38,14,8,22,5,male
1294 ms,1294,18900 KB,18900,Italy,Europe,76,540,398.8804611,3373.880857,53.75675676,181368.8926,99,77,64,22,13,25,5,male
545 ms,545,16200 KB,16200,China,Asia,83,556,446.8336245,3544.521924,55.5,196720.9668,66,61,61,5,0,26,6,male
421 ms,421,14500 KB,14500,China,Asia,81,559,433.2506894,3543.976152,48.8,172946.0362,90,70,64,20,6,22,5,male
451 ms,451,34600 KB,34600,China,Asia,70,506,359.0910367,3101.417207,59.97222222,185998.8819,60,46,39,14,7,22,4,male
436 ms,436,19300 KB,19300,India,Asia,63,470,315.5176503,2809.321564,50.92,143050.654,86,76,74,10,2,24,6,male
1559 ms,1559,24000 KB,24000,Lebanon,Asia,82,562,439.6362367,3572.944227,69.09090909,246857.9647,78,68,64,10,4,25,5,male
764 ms,764,15600 KB,15600,China,Asia,87,512,474.2088866,3298.78707,52.40625,172877.0599,60,10,10,50,0,5,2,male
312 ms,312,17600 KB,17600,Russia,AsiaEurope,75,470,392.4020294,2927.544785,43.75,128080.0843,66,60,60,6,0,18,4,male
327 ms,327,19400 KB,19400,Turkmenistan,Asia,69,525,352.582306,3206.97534,58.90909091,188920.0018,71,50,42,21,8,20,4,male
655 ms,655,139300 KB,139300,China,Asia,72,490,372.2746801,3023.263251,62.37142857,188565.2479,58,51,51,7,0,20,5,female
468 ms,468,17200 KB,17200,Argentina,South America,90,579,495.0699333,3758.782943,50.4,189442.6603,63,45,42,18,3,18,5,male
390 ms,390,16200 KB,16200,South Korea,Asia,76,504,398.8804611,3148.955467,53.12820513,167298.352,61,53,50,8,3,22,4,male
826 ms,826,32000 KB,32000,Kyrgyzstan,Asia,83,454,446.3456778,2894.267902,50.96590909,147508.9948,87,74,68,13,6,19,5,male
545 ms,545,221700 KB,221700,China,Asia,71,535,365.7235111,3290.114709,47.33823529,155748.2242,51,40,40,11,0,18,6,male
373 ms,373,21400 KB,21400,China,Asia,84,549,453.092115,3509.382265,73.18181818,256822.9749,70,61,57,9,4,19,4,male
373 ms,373,13100 KB,13100,China,Asia,108,666,630.3519002,4498.755076,63,283421.5698,49,0,-6,49,6,0,4,male
436 ms,436,14200 KB,14200,Vietnam,Asia,79,581,419.4466845,3662.496615,56.93023256,208506.784,72,60,53,12,7,27,5,female
811 ms,811,17200 KB,17200,Serbia,Europe,78,415,412.4094067,2608.441921,49.31081081,128624.3861,58,49,46,9,3,19,4,female
607 ms,607,32000 KB,32000,Kyrgyzstan,Asia,83,457,446.3456778,2913.39302,50.96590909,148483.7238,88,74,68,14,6,19,5,male
857 ms,857,20500 KB,20500,China,Asia,79,470,419.0808777,2962.776952,74.98684211,222169.2875,60,54,54,6,0,20,5,female
514 ms,514,15000 KB,15000,India,Asia,79,436,419.0078103,2748.448406,50.7,139346.3342,86,66,54,20,12,17,3,male
514 ms,514,15000 KB,15000,India,Asia,79,436,419.0078103,2748.448406,50.7,139346.3342,86,66,54,20,12,17,3,male
436 ms,436,15000 KB,15000,India,Asia,79,436,419.0078103,2748.448406,50.7,139346.3342,86,66,54,20,12,17,3,male
467 ms,467,15000 KB,15000,India,Asia,79,436,419.0078103,2748.448406,50.7,139346.3342,86,66,54,20,12,17,3,male
467 ms,467,15000 KB,15000,India,Asia,79,436,419.0078103,2748.448406,50.7,139346.3342,86,66,54,20,12,17,3,male
421 ms,421,18700 KB,18700,India,Asia,79,436,419.0078103,2748.448406,50.7,139346.3342,86,66,54,20,12,17,3,male
420 ms,420,18700 KB,18700,India,Asia,79,436,419.0078103,2748.448406,50.7,139346.3342,86,66,54,20,12,17,3,male
436 ms,436,15000 KB,15000,India,Asia,79,436,419.0078103,2748.448406,50.7,139346.3342,86,66,54,20,12,17,3,male
577 ms,577,34600 KB,34600,China,Asia,77,525,405.551932,3290.062934,77.94871795,256456.1877,63,53,48,10,5,21,5,male
358 ms,358,16000 KB,16000,China,Asia,87,573,475.4109925,3691.806623,46.94117647,173297.7462,81,61,49,20,12,23,3,male
1560 ms,1560,25800 KB,25800,Unknown,Unknown,74,462,385.8508604,2868.767455,60,172126.0473,83,59,57,24,2,23,4,male
1482 ms,1482,15800 KB,15800,India,Asia,72,470,372.5956925,2899.864751,49.63636364,143938.7413,74,57,53,17,4,21,3,male
390 ms,390,18700 KB,18700,India,Asia,79,436,419.0078103,2748.448406,50.7,139346.3342,88,66,53,22,13,17,3,male
483 ms,483,72900 KB,72900,China,Asia,78,588,412.85429,3695.816505,61.04651163,225616.7052,67,55,50,12,5,23,4,male
686 ms,686,27500 KB,27500,Bangladesh,Asia,84,518,452.9890166,3311.220425,67.22093023,222583.3172,66,57,53,9,4,24,4,male
373 ms,373,74400 KB,74400,China,Asia,78,588,412.85429,3695.816505,61.04651163,225616.7052,67,55,50,12,5,23,4,male
826 ms,826,26600 KB,26600,Bangladesh,Asia,81,511,432.75063,3239.663351,76,246214.4147,63,47,36,16,11,22,4,male
1138 ms,1138,18700 KB,18700,Taiwan,Asia,90,589,495.0699333,3823.701474,72.4,276835.9867,84,62,52,22,10,22,6,male
202 ms,202,7000 KB,7000,China,Asia,73,555,378.9461511,3435.35263,51.57142857,177166.0428,60,49,49,11,0,24,6,male
795 ms,795,116700 KB,116700,Kazakhstan,AsiaEurope,62,425,309.4603455,2530.533432,41.16666667,104173.6263,80,58,50,22,8,21,4,female
811 ms,811,15800 KB,15800,Singapore,Asia,78,700,412.85429,4399.781553,74.06976744,325890.7964,81,54,49,27,5,23,4,male
1622 ms,1622,15800 KB,15800,South Korea,Asia,75,438,392.2479866,2728.222586,50.91666667,138912,62,53,51,9,2,19,4,male
1357 ms,1357,19300 KB,19300,Indonesia,Asia,80,512,425.8985773,3236.827185,48.85714286,158142.1282,66,54,50,12,4,21,3,male
1606 ms,1606,23500 KB,23500,Vietnam,Asia,70,440,359.4212455,2696.884527,45.125,121696.9143,67,58,57,9,1,24,5,male
389 ms,389,11800 KB,11800,China,Asia,79,559,419.0078103,3523.813438,54.87179487,193357.9681,96,0,-9,96,9,0,5,male
295 ms,295,16600 KB,16600,Ukraine,Europe,84,488,452.9546635,3119.450902,65,202764.3087,76,61,58,15,3,20,6,male
358 ms,358,19300 KB,19300,Indonesia,Asia,84,510,453.092115,3260.081886,69.54545455,226723.8766,78,59,49,19,10,19,5,male
358 ms,358,19300 KB,19300,Indonesia,Asia,84,510,453.092115,3260.081886,69.54545455,226723.8766,78,59,49,19,10,19,5,male
390 ms,390,15700 KB,15700,Indonesia,Asia,71,506,365.6422056,3111.772042,66.34285714,206443.8481,74,61,56,13,5,20,4,male
436 ms,436,23500 KB,23500,China,Asia,95,660,530.4235573,4336.104701,63.39814815,274901.0083,60,0,0,60,0,0,4,male
249 ms,249,16600 KB,16600,Brazil,South America,76,544,398.8804611,3398.872567,65.46153846,222495.4273,67,53,47,14,6,22,6,male
1559 ms,1559,12900 KB,12900,China,Asia,88,560,481.614055,3617.281706,66.5,240549.2335,77,9,9,68,0,4,1,male
436 ms,436,13100 KB,13100,China,Asia,0,0,0,0,0,0,74,55,51,19,4,24,9,male
233 ms,233,16600 KB,16600,Brazil,South America,76,556,398.8804611,3473.847697,65.46153846,227403.4147,67,53,47,14,6,22,6,male
390 ms,390,17400 KB,17400,India,Asia,74,482,385.8508604,2992.956522,50,149647.8261,89,72,72,17,0,22,3,male
280 ms,280,24200 KB,24200,Taiwan,Asia,78,542,412.2983693,3406.688003,56.84210526,193643.318,76,63,57,13,6,18,4,female
389 ms,389,13300 KB,13300,India,Asia,108,666,630.3519002,4498.755076,63,283421.5698,49,0,-6,49,6,0,4,male
592 ms,592,16600 KB,16600,China,Asia,72,548,372.2346001,3381.118901,52,175818.1828,58,52,52,6,0,26,4,male
826 ms,826,14900 KB,14900,China,Asia,80,466,425.7903187,2946.018492,59.92682927,176545.5472,76,54,46,22,8,17,3,female
1153 ms,1153,13100 KB,13100,Poland,Europe,79,530,419.0078103,3341.003797,78.4875,262227.0355,93,68,48,25,20,21,4,male
748 ms,748,20100 KB,20100,Brazil,South America,81,602,432.6080183,3816.589702,82.17857143,313641.8894,65,43,27,22,16,25,6,male
483 ms,483,59600 KB,59600,China,Asia,82,584,440.5905816,3712.810371,65.90425532,244690.0026,87,0,-10,87,10,0,6,male
608 ms,608,18200 KB,18200,Bangladesh,Asia,62,450,315.2736412,2679.38834,35.44444444,94969.43115,113,72,48,41,24,24,6,male
373 ms,373,24800 KB,24800,Philippines,Asia,76,576,398.8804611,3598.806248,58.34615385,209976.503,70,63,63,7,0,22,5,male
296 ms,296,18500 KB,18500,Kazakhstan,AsiaEurope,95,665,533.19324,4368.95398,76.88135593,335891.106,73,54,44,19,10,24,6,male
499 ms,499,15800 KB,15800,Iran,Asia,85,523,459.8746234,3352.11146,68.02272727,228019.7636,80,57,50,23,7,19,4,male
717 ms,717,15000 KB,15000,Thailand,Asia,93,584,517.3960298,3818.868746,57.34545455,218994.7641,69,49,48,20,1,16,3,male
296 ms,296,16600 KB,16600,Kazakhstan,AsiaEurope,90,540,495.0699333,3505.600672,66.4,232771.8846,74,55,45,19,10,18,6,male
638 ms,638,15800 KB,15800,South Korea,Asia,76,451,398.9944238,2817.815309,52.22222222,147152.5772,63,54,52,9,2,19,4,male
1606 ms,1606,15700 KB,15700,Croatia,Europe,68,588,345.9474732,3579.428151,70.5,252349.6846,91,77,69,14,8,22,5,male
343 ms,343,20100 KB,20100,Unknown,Unknown,81,526,432.6080183,3334.761102,59.23076923,197520.4652,65,52,52,13,0,18,5,male
592 ms,592,17800 KB,17800,China,Asia,68,427,346.6279634,2599.346633,53.83333333,139931.4938,83,65,60,18,5,18,3,male
701 ms,701,17800 KB,17800,Poland,Europe,88,576,480.5611817,3720.632612,70.76086957,263275.199,100,65,44,35,21,22,6,male
702 ms,702,15000 KB,15000,Hong Kong,Asia,87,519,474.2088866,3343.887674,66.21875,221428.0619,61,46,41,15,5,23,4,male
468 ms,468,17600 KB,17600,China,Asia,89,592,488.323496,3833.634191,67.08,257160.1815,61,51,47,10,4,21,4,male
467 ms,467,33800 KB,33800,China,Asia,90,564,494.5555318,3661.405146,72.1875,264307.684,55,40,40,15,0,21,4,male
326 ms,326,16200 KB,16200,Vietnam,Asia,93,536,516.8946117,3504.989123,62.47222222,218964.4594,62,55,54,7,1,18,5,male
436 ms,436,10900 KB,10900,Chile,South America,94,622,523.6410489,4076.954266,71.11111111,289916.7478,97,65,38,32,27,24,4,male
592 ms,592,15800 KB,15800,Latvia,Europe,84,503,452.9546635,3215.335664,70.5,226681.1643,82,56,46,26,10,21,5,male
420 ms,420,59800 KB,59800,China,Asia,82,584,440.5905816,3712.810371,65.90425532,244690.0026,89,0,-11,89,11,0,5,male
483 ms,483,16300 KB,16300,South Korea,Asia,81,579,432.536756,3670.773152,67.80487805,248896.3259,98,65,50,33,15,24,5,male
1466 ms,1466,21100 KB,21100,China,Asia,73,498,379.1044231,3082.53263,62.51470588,192703.6208,73,65,65,8,0,22,6,male
327 ms,327,13300 KB,13300,China,Asia,97,656,545.3518546,4329.542824,65.26315789,282559.637,56,6,6,50,0,4,1,male
249 ms,249,13300 KB,13300,China,Asia,97,656,545.3518546,4329.542824,65.26315789,282559.637,56,6,6,50,0,4,1,male
1310 ms,1310,17000 KB,17000,Ukraine,Europe,82,514,439.3544556,3267.78173,67.61904762,220964.2884,67,48,47,19,1,25,6,male
1575 ms,1575,15800 KB,15800,Iran,Asia,77,532,405.551932,3333.93044,65.28205128,217645.8179,101,77,59,24,18,23,5,male
1560 ms,1560,29100 KB,29100,Unknown,Unknown,88,521,481.2514689,3365.363873,52.13265306,175445.3472,68,58,53,10,5,14,1,male
358 ms,358,10600 KB,10600,Unknown,Unknown,102,624,583.4212455,4163.593413,50.171875,208895.2883,76,67,67,9,0,23,5,male
327 ms,327,16200 KB,16200,Kazakhstan,AsiaEurope,85,531,460.0105131,3403.386587,69.77777778,237480.753,86,59,49,27,10,22,7,male
982 ms,982,15200 KB,15200,China,Asia,76,525,398.9944238,3280.161945,45.45,149083.3604,75,68,68,7,0,22,4,female
1590 ms,1590,15700 KB,15700,China,Asia,88,510,480.5611817,3294.310126,61.63043478,203029.7653,59,52,52,7,0,19,4,female
342 ms,342,18000 KB,18000,China,Asia,77,599,405.551932,3753.805138,59.52631579,223450.19,70,56,51,14,5,25,5,female
296 ms,296,18000 KB,18000,China,Asia,77,599,405.551932,3753.805138,59.52631579,223450.19,70,56,51,14,5,25,5,female
1341 ms,1341,15000 KB,15000,Taiwan,Asia,85,535,460.0105131,3429.024151,65.33333333,224029.5779,92,68,51,24,17,21,4,female
358 ms,358,15000 KB,15000,India,Asia,85,549,460.0105131,3518.755624,64,225200.3599,88,72,70,16,2,28,5,female
311 ms,311,12500 KB,12500,China,Asia,80,622,425.7903187,3932.239275,66.23076923,260435.232,73,49,49,24,0,19,6,female
93 ms,93,8100 KB,8100,China,Asia,86,636,466.6587689,4087.104384,65,265661.785,76,6,6,70,0,4,1,female
935 ms,935,17200 KB,17200,China,Asia,93,610,516.4569079,3988.886875,79.24528302,316100.4693,68,53,48,15,5,23,5,female
514 ms,514,16400 KB,16400,South Korea,Asia,81,644,433.6087556,4082.863402,46.41304348,189498.1166,108,76,67,32,9,25,6,female
311 ms,311,17400 KB,17400,Russia,AsiaEurope,83,516,446.5546348,3289.520347,66.71111111,219447.5573,89,65,50,24,15,18,5,female
982 ms,982,41100 KB,41100,China,Asia,83,631,446.1369639,4022.649881,55.64285714,223831.7327,72,10,10,62,0,7,1,female
483 ms,483,15600 KB,15600,China,Asia,99,689,559.9530637,4567.626711,65.42372881,298831.1713,98,75,68,23,7,25,5,female
2729 ms,2729,87200 KB,87200,China,Asia,39,509,190.8721876,2690.269729,18,48424.85513,114,98,98,16,0,27,4,female
530 ms,530,22300 KB,22300,China,Asia,87,625,473.9427998,4026.839685,65.53191489,263886.5155,88,75,74,13,1,28,7,female
764 ms,764,17400 KB,17400,China,Asia,73,606,378.8670746,3751.033683,38.54166667,144571.0899,100,76,68,24,8,27,3,female
327 ms,327,12000 KB,12000,China,Asia,119,700,712.9490957,4826.372434,49.02469136,236611.419,57,44,42,13,2,22,3,female
171 ms,171,11000 KB,11000,China,Asia,89,580,487.4132344,3755.92539,57.02173913,214169.3978,82,54,51,28,3,22,6,female
1388 ms,1388,37600 KB,37600,China,Asia,80,606,426.3322913,3831.088426,54,206878.775,94,85,85,9,0,23,5,female
452 ms,452,28200 KB,28200,China,Asia,102,726,582.037295,4844.180798,58.38709677,282837.6531,88,0,0,88,0,0,5,female
436 ms,436,28200 KB,28200,China,Asia,102,726,582.037295,4844.180798,58.38709677,282837.6531,88,0,0,88,0,0,5,female
233 ms,233,10700 KB,10700,China,Asia,66,517,333.6312234,3124.95176,68.25862069,213304.8968,84,78,78,6,0,19,5,female
1216 ms,1216,16600 KB,16600,Bangladesh,Asia,80,516,425.8985773,3262.114897,54.71052632,178472.0229,105,73,50,32,23,23,6,female
202 ms,202,12100 KB,12100,China,Asia,96,596,537.2412569,3924.63765,54.83333333,215200.9645,80,0,-1,80,1,0,6,female
670 ms,670,23800 KB,23800,China,Asia,86,616,466.6587689,3958.579089,55.5,219701.1394,87,57,57,30,0,21,5,female
405 ms,405,14100 KB,14100,China,Asia,89,676,488.714938,4377.595799,72.64705882,318019.4595,80,8,-3,72,11,7,1,female
249 ms,249,25200 KB,25200,China,Asia,124,749,750.9289161,5208.693036,54.14117647,282004.7689,62,0,-3,62,3,0,1,female
405 ms,405,17200 KB,17200,China,Asia,105,750,605.8492213,5035.684138,60.40298507,304170.3538,94,77,70,17,7,21,4,female
327 ms,327,17200 KB,17200,China,Asia,105,750,605.8492213,5035.684138,60.40298507,304170.3538,94,77,70,17,7,21,4,female
1107 ms,1107,28900 KB,28900,China,Asia,93,572,515.2115894,3740.39884,69.375,259490.1695,88,72,71,16,1,25,6,female
264 ms,264,6300 KB,6300,China,Asia,100,716,565.1081736,4757.001032,88.77272727,422291.9552,104,19,7,85,12,6,3,female
498 ms,498,19200 KB,19200,China,Asia,98,742,550.3593685,4908.114704,85.24509804,418392.7192,82,6,1,76,5,6,1,female
327 ms,327,10700 KB,10700,China,Asia,104,731,594.628427,4898.021434,57.93333333,283758.7084,70,2,0,68,2,4,2,female
265 ms,265,14500 KB,14500,Zambia,Africa,84,619,454.1955001,3956.844485,60,237410.6691,94,79,72,15,7,24,5,female
717 ms,717,20100 KB,20100,Russia,AsiaEurope,87,652,473.5443757,4200.799159,99.76744186,419102.9859,99,66,50,33,16,19,5,female
780 ms,780,108800 KB,108800,China,Asia,82,658,439.6362367,4183.269219,65.42105263,273673.8758,125,53,23,72,30,24,5,female
468 ms,468,108800 KB,108800,China,Asia,82,660,439.6362367,4195.984323,65.42105263,274505.7112,125,53,23,72,30,24,5,female
436 ms,436,18200 KB,18200,Canada,North America,104,734,593.8467477,4918.122753,96.36206897,473920.4839,88,59,51,29,8,18,4,female
1403 ms,1403,15400 KB,15400,Russia,AsiaEurope,90,576,496.3295586,3739.307383,58.99056604,220583.8591,94,66,54,28,12,19,5,female
795 ms,795,17400 KB,17400,Iran,Asia,83,559,446.1369639,3563.647042,74.67857143,266128.0702,118,82,61,36,21,24,6,female
499 ms,499,13300 KB,13300,Russia,AsiaEurope,94,674,522.9001971,4417.792886,71.48076923,315787.2338,117,62,50,55,12,19,5,female
467 ms,467,11900 KB,11900,China,Asia,89,729,488.323496,4720.809671,63.57,300101.8708,106,90,89,16,1,23,5,female
280 ms,280,40200 KB,40200,Egypt,AsiaAfrica,98,663,552.6400215,4385.552627,63.10344828,276743.4933,119,91,68,28,23,24,6,female
717 ms,717,230300 KB,230300,China,Asia,102,747,581.4346098,4984.30173,77.29508197,385262.0108,118,73,62,45,11,23,7,female
607 ms,607,19800 KB,19800,Russia,AsiaEurope,85,638,459.8067162,4089.191417,85.95348837,351480.2669,128,83,70,45,13,27,7,female
561 ms,561,10900 KB,10900,China,Asia,98,694,550.3593685,4590.608632,65.43137255,300369.8236,91,16,7,75,9,5,1,female
1357 ms,1357,15800 KB,15800,Antarctica,Antarctica,121,855,719.9353928,5915.628068,102.9041096,608742.439,105,76,76,29,0,34,8,female
577 ms,577,25900 KB,25900,Japan,Asia,47,560,235.1694072,3110.569757,23.91666667,74394.46002,116,88,74,28,14,18,5,female
2012 ms,2012,21400 KB,21400,China,Asia,93,705,517.3960298,4610.106962,69.43636364,320109.0634,95,74,70,21,4,28,5,female
342 ms,342,107400 KB,107400,China,Asia,103,762,586.0529843,5095.113402,78.10909091,397974.6759,89,64,52,25,12,33,7,female
1388 ms,1388,59900 KB,59900,China,Asia,110,738,640.424805,5004.643469,53.73529412,268925.9887,91,61,61,30,0,25,5,female
608 ms,608,21400 KB,21400,China,Asia,78,647,412.2983693,4066.655236,70.52631579,286806.2114,113,93,84,20,9,23,6,female
342 ms,342,36500 KB,36500,Ukraine,Europe,87,641,473.5443757,4129.926781,58.8372093,242993.3664,119,67,53,52,14,15,6,female
280 ms,280,12900 KB,12900,China,Asia,97,743,544.8715078,4903.735242,67.72321429,332096.7126,102,17,16,85,1,7,4,female
280 ms,280,24100 KB,24100,India,Asia,97,660,543.2584855,4355.942476,71.91,313235.8234,124,60,28,64,32,21,7,female
233 ms,233,24000 KB,24000,China,Asia,101,812,571.4865019,5406.467724,116.6666667,630754.5678,129,23,2,106,21,8,6,female
311 ms,311,14200 KB,14200,Russia,AsiaEurope,80,606,425.7903187,3831.088426,61.82926829,236873.3941,111,67,66,44,1,23,5,female
1232 ms,1232,15800 KB,15800,China,Asia,118,778,694.7639251,5354.696292,73.828125,395327.1872,103,73,65,30,8,34,10,female
919 ms,919,36400 KB,36400,Iran,Asia,97,820,543.2584855,5411.928531,94.94,513808.4947,130,81,63,49,18,23,6,female
546 ms,546,23500 KB,23500,China,Asia,105,770,601.1597899,5169.969049,68.22033898,352697.041,96,65,62,31,3,32,10,female
1575 ms,1575,25000 KB,25000,Iran,Asia,89,631,487.5430078,4086.187795,65.68085106,268384.292,109,77,70,32,7,16,4,female
202 ms,202,12900 KB,12900,China,Asia,97,835,544.452116,5510.927223,68.72727273,378750.9983,105,17,16,88,1,7,4,female
1465 ms,1465,58900 KB,58900,Belarus,Europe,72,649,372.5956925,4004.281326,80.95454545,324164.7746,130,91,75,39,16,29,4,female
1559 ms,1559,14600 KB,14600,Syria,Asia,85,684,460.2145365,4384.0234,75.0326087,328944.7123,130,85,60,45,25,30,5,female
358 ms,358,18400 KB,18400,China,Asia,110,844,643.6558456,5723.467598,65.44444444,374569.1573,97,0,0,97,0,0,5,female
468 ms,468,30200 KB,30200,India,Asia,43,575,221.6596322,3120.102234,20.5,63962.0958,152,109,89,43,20,29,8,female
373 ms,373,86800 KB,86800,Russia,AsiaEurope,55,608,282.613175,3515.066706,33.22222222,116778.3272,155,81,58,74,23,28,7,female
1481 ms,1481,59500 KB,59500,China,Asia,91,769,501.4075845,5004.494078,104.3645833,522291.9393,145,86,70,59,16,29,7,female
405 ms,405,16200 KB,16200,Russia,AsiaEurope,94,772,522.2541717,5060.142593,67.95918367,343883.1599,143,99,93,44,6,30,6,female
670 ms,670,16100 KB,16100,Russia,AsiaEurope,94,772,522.2541717,5060.142593,67.95918367,343883.1599,143,99,93,44,6,30,6,female
374 ms,374,15000 KB,15000,Russia,AsiaEurope,94,772,522.2541717,5060.142593,67.95918367,343883.1599,143,99,93,44,6,30,6,female
467 ms,467,16200 KB,16200,Russia,AsiaEurope,94,772,522.2541717,5060.142593,67.95918367,343883.1599,144,99,92,45,7,30,6,female
482 ms,482,15000 KB,15000,Russia,AsiaEurope,93,780,515.3357736,5100.543873,66.44897959,338925.9357,143,99,93,44,6,30,6,female
1216 ms,1216,19400 KB,19400,China,Asia,98,918,550.7131734,6072.303637,96.36792453,585175.2986,153,113,99,40,14,31,7,female
467 ms,467,16200 KB,16200,Russia,AsiaEurope,94,777,522.2541717,5092.915538,67.95918367,346110.3825,144,99,93,45,6,30,6,female
421 ms,421,16200 KB,16200,Russia,AsiaEurope,94,777,522.2541717,5092.915538,67.95918367,346110.3825,144,99,93,45,6,30,6,female
436 ms,436,16200 KB,16200,Russia,AsiaEurope,94,777,522.2541717,5092.915538,67.95918367,346110.3825,144,99,93,45,6,30,6,female
451 ms,451,16200 KB,16200,Russia,AsiaEurope,94,777,522.2541717,5092.915538,67.95918367,346110.3825,144,99,93,45,6,30,6,female
420 ms,420,15000 KB,15000,Russia,AsiaEurope,93,786,515.3357736,5139.778826,66.44897959,341533.0583,144,99,93,45,6,30,6,female
405 ms,405,15000 KB,15000,Russia,AsiaEurope,97,812,543.5562547,5359.129228,65.76923077,352465.8069,143,99,93,44,6,30,6,female
748 ms,748,33800 KB,33800,Russia,AsiaEurope,92,702,508.4501668,4579.540493,79.41836735,363699.6292,128,68,54,60,14,22,7,female
374 ms,374,17900 KB,17900,Russia,AsiaEurope,94,857,522.16205,5617.282646,90.5625,508715.1596,165,94,76,71,18,31,6,female
405 ms,405,108200 KB,108200,Iran,Asia,0,0,0,0,0,0,116,77,65,39,12,24,5,female
857 ms,857,15600 KB,15600,China,Asia,121,1071,723.5907575,7410.102527,84.62179487,627056.176,119,20,19,99,1,12,2,female
93 ms,93,7000 KB,7000,China,Asia,128,977,772.4541826,6839,54.48717949,372637.8205,149,74,67,75,7,37,13,female
639 ms,639,12800 KB,12800,Belarus,Europe,95,770,529.7522498,5058.788818,83.10576923,420414.5361,160,122,99,38,23,30,8,female
1653 ms,1653,15300 KB,15300,China,Asia,22,98,85.46551026,437.0242986,9.5,4151.730837,138,39,38,99,1,22,3,female
889 ms,889,15600 KB,15600,China,Asia,118,1303,700.4907862,8968.083893,94.31333333,845809.8856,140,20,15,120,5,12,2,female
1809 ms,1809,15600 KB,15600,China,Asia,113,1163,661.7031787,7931.868133,94.37681159,748584.4244,130,33,31,97,2,20,3,female
1060 ms,1060,92300 KB,92300,China,Asia,53,1032,271.1333893,5911.213909,39.375,232754.0477,183,142,128,41,14,49,17,female
904 ms,904,92300 KB,92300,China,Asia,53,1032,271.1333893,5911.213909,39.375,232754.0477,183,142,128,41,14,49,17,female
1544 ms,1544,28300 KB,28300,India,Asia,107,799,617.9312396,5386.432122,45.23076923,243632.4683,140,103,90,37,13,36,7,female
499 ms,499,29200 KB,29200,China,Asia,108,1096,621.7684232,7403.356702,74.71052632,553108.6757,137,106,102,31,4,59,15,female
608 ms,608,42400 KB,42400,Germany,Europe,98,993,552.134363,6568.406875,62.93859649,413406.3099,170,120,100,50,20,33,9,female
592 ms,592,32900 KB,32900,Germany,Europe,100,1002,566.7355721,6657.143902,62.19491525,414040.5008,170,121,102,49,19,33,9,female
811 ms,811,74200 KB,74200,Unknown,Unknown,0,0,0,0,0,0,165,94,75,71,19,44,13,female
483 ms,483,112100 KB,112100,China,Asia,107,980,615.8588276,6606.637647,175.704918,1160818.726,150,106,104,44,2,44,11,female
405 ms,405,30600 KB,30600,India,Asia,119,1037,702.509796,7149.926021,78.6969697,562677.5114,149,106,102,43,4,37,13,female
577 ms,577,17800 KB,17800,Sweden,Europe,128,1612,780.1957163,11284,147.7413793,1667113.724,145,119,100,26,19,56,36,female
810 ms,810,74200 KB,74200,Unknown,Unknown,0,0,0,0,0,0,169,94,75,75,19,44,13,female
576 ms,576,112100 KB,112100,China,Asia,107,980,615.8588276,6606.637647,175.704918,1160818.726,163,118,115,45,3,50,11,female
545 ms,545,14900 KB,14900,South Korea,Asia,127,1193,763.5842671,8337.500831,84.58666667,705241.4037,108,73,68,35,5,42,18,female
951 ms,951,14600 KB,14600,Japan,Asia,129,1085,779.5550655,7607.181572,82.71153846,629201.6912,153,108,99,45,9,27,12,female
748 ms,748,18600 KB,18600,Bangladesh,Asia,94,755,525.2245053,4948.714583,51.92982456,256985.8801,217,84,67,133,17,32,7,female
514 ms,514,34400 KB,34400,Unknown,Unknown,67,1184,348.7888228,7182.249602,56.84210526,408254.1879,257,138,74,119,64,51,13,female
124 ms,124,11200 KB,11200,China,Asia,126,969,755.9224144,6760.984246,77.64864865,524981.2902,370,60,26,310,34,18,7,female
109 ms,109,11200 KB,11200,China,Asia,126,969,755.9224144,6760.984246,77.64864865,524981.2902,369,60,27,309,33,18,7,female
1029 ms,1029,13200 KB,13200,China,Asia,47,251,217.5800856,1394.201802,53.28125,74284.81475,36,32,32,4,0,12,3,male
811 ms,811,13400 KB,13400,Iran,Asia,51,223,240.7106228,1264.950851,39.57894737,50065.42317,39,34,34,5,0,11,3,male
311 ms,311,14200 KB,14200,Finland,Europe,52,249,244.9233738,1419.40949,30.89130435,43847.41054,32,26,26,6,0,10,3,male
810 ms,810,15300 KB,15300,Poland,Europe,50,223,235.05865,1258.57993,41.77777778,52580.67264,39,34,34,5,0,11,3,male
764 ms,764,15300 KB,15300,Latvia,Europe,51,225,240.7106228,1276.295702,41.26315789,52663.99107,38,33,33,5,0,11,3,male
779 ms,779,13400 KB,13400,Egypt,AsiaAfrica,51,223,240.7106228,1264.950851,39.57894737,50065.42317,39,34,34,5,0,11,3,male
748 ms,748,19700 KB,19700,France,Europe,53,233,252.9035678,1334.605466,39.6,52850.37645,41,36,36,5,0,11,3,male
748 ms,748,15500 KB,15500,India,Asia,63,279,313.5800856,1667.661099,43.59375,72699.60102,40,28,24,12,4,11,3,male
779 ms,779,15300 KB,15300,Iran,Asia,58,272,283.0128366,1593.370831,38.95833333,62075.07195,44,35,34,9,1,12,3,female
342 ms,342,19800 KB,19800,Russia,AsiaEurope,59,280,288.6764386,1647.140054,41.25,67944.52722,39,32,32,7,0,13,3,male
265 ms,265,19700 KB,19700,India,Asia,57,248,276.0964047,1446.556724,38.4,55547.77818,43,31,24,12,7,11,3,male
733 ms,733,15300 KB,15300,India,Asia,58,283,281.9620482,1657.808622,37.88888889,62812.52666,32,28,28,4,0,11,3,male
264 ms,264,14900 KB,14900,China,Asia,73,324,379.3421297,2005.503157,37.5375,75281.57476,31,25,22,6,3,14,3,male
280 ms,280,16100 KB,16100,China,Asia,54,241,258.1074956,1386.927888,39.27272727,54468.44069,38,32,32,6,0,11,3,female
264 ms,264,14200 KB,14200,India,Asia,53,276,252.2386659,1580.906045,53.33333333,84314.98909,44,36,33,8,3,11,3,male
295 ms,295,15500 KB,15500,Bangladesh,Asia,58,313,281.8126557,1833.548051,43.92857143,80545.14655,49,36,29,13,7,12,3,male
311 ms,311,14100 KB,14100,China,Asia,60,314,294.6059378,1854.763647,46.85714286,86908.92517,43,37,36,6,1,12,3,female
483 ms,483,14000 KB,14000,Iran,Asia,58,288,282.5614107,1687.098527,50.82,85738.34712,51,41,37,10,4,11,3,male
296 ms,296,15300 KB,15300,Iran,Asia,60,263,294.8469685,1553.512227,47.05555556,73101.38089,38,30,27,8,3,11,3,male
264 ms,264,14200 KB,14200,Finland,Europe,60,294,296.1564001,1736.625835,43.5,75543.22383,50,38,35,12,3,11,3,male
249 ms,249,16900 KB,16900,Taiwan,Asia,61,314,300.7868035,1862.251524,51.66666667,96216.32874,42,31,24,11,7,13,3,male
1014 ms,1014,14000 KB,14000,China,Asia,54,243,258.1074956,1398.437663,37.09090909,51869.32423,45,39,38,6,1,11,3,female
280 ms,280,16100 KB,16100,Bangladesh,Asia,50,251,235.05865,1416.607904,27.55555556,39035.41779,37,33,33,4,0,11,3,male
717 ms,717,16100 KB,16100,India,Asia,47,269,215.9400989,1494.184401,40.27777778,60182.42727,50,42,42,8,0,11,3,male
780 ms,780,14200 KB,14200,India,Asia,55,260,263.6191856,1503.153526,38.75,58247.19911,53,41,36,12,5,12,3,male
1029 ms,1029,15200 KB,15200,United States,North America,46,277,209.0925853,1530.026662,44.76315789,68488.82505,38,29,24,9,5,10,3,male
810 ms,810,15300 KB,15300,India,Asia,52,241,248.0323866,1373.805972,44.38888889,60981.72065,44,34,34,10,0,11,3,male
748 ms,748,16100 KB,16100,Bangladesh,Asia,57,348,275.7915183,2029.845725,50.07692308,101648.4282,47,36,32,11,4,14,3,male
779 ms,779,16100 KB,16100,India,Asia,64,295,320.1804545,1770,44.76666667,79237,50,42,40,8,2,14,3,male
763 ms,763,15500 KB,15500,Indonesia,Asia,65,285,326.5538222,1716.374827,36.47058824,62597.19956,42,33,29,9,4,11,3,male
748 ms,748,15200 KB,15200,India,Asia,51,292,238.9889445,1656.3482,37.56818182,62225.99033,55,47,47,8,0,11,3,male
779 ms,779,14200 KB,14200,China,Asia,49,297,227.3200108,1667.568824,46.4,77375.19342,60,56,56,4,0,11,3,male
748 ms,748,14200 KB,14200,India,Asia,57,295,276.504106,1720.702554,52.9375,91089.69146,51,41,36,10,5,12,3,male
218 ms,218,14100 KB,14100,China,Asia,64,304,320.0450916,1824,37.79032258,68929.54839,48,35,34,13,1,12,3,male
748 ms,748,14200 KB,14200,India,Asia,49,315,229.4868683,1768.633601,47.05882353,83229.81651,65,59,59,6,0,15,3,male
311 ms,311,15900 KB,15900,China,Asia,54,307,257.6220106,1766.750463,41.7826087,73819.44327,45,38,38,7,0,11,3,male
264 ms,264,13400 KB,13400,Vietnam,Asia,60,306,295.1851693,1807.508522,56.88461538,102819.4271,51,38,30,13,8,12,3,male
264 ms,264,14200 KB,14200,Taiwan,Asia,57,287,277.0156616,1674.039434,53.2173913,89088.01162,49,41,40,8,1,13,3,male
358 ms,358,24600 KB,24600,India,Asia,59,289,288.6764386,1700.083841,53.30769231,90627.54631,55,36,29,19,7,10,3,male
248 ms,248,14000 KB,14000,China,Asia,65,324,326.4650059,1951.247171,45.890625,89543.95223,50,41,37,9,4,12,3,male
296 ms,296,11500 KB,11500,Russia,AsiaEurope,79,374,422.3275002,2357.614,41.63265306,98153.72571,40,29,25,11,4,11,3,male
296 ms,296,14200 KB,14200,China,Asia,56,265,271.0812322,1538.949054,51,78486.40177,41,33,33,8,0,11,3,male
311 ms,311,22700 KB,22700,Mexico,North America,35,223,164.7548875,1143.830113,16,18301.2818,38,31,31,7,0,8,3,male
763 ms,763,16900 KB,16900,Russia,AsiaEurope,63,305,313.6717238,1823.070377,46.75,85228.54011,57,37,24,20,13,11,3,male
1045 ms,1045,30000 KB,30000,Bangladesh,Asia,38,251,184.2797931,1317.229806,17.5,23051.5216,45,27,23,18,4,11,3,male
156 ms,156,12100 KB,12100,China,Asia,66,388,333.1049912,2345.224918,38.08571429,89319.56617,43,39,39,4,0,11,4,male
311 ms,311,16100 KB,16100,India,Asia,51,249,242.4606049,1412.43391,37,52260.05468,59,39,28,20,11,11,3,male
280 ms,280,16900 KB,16900,Hong Kong,Asia,58,346,281.8126557,2026.861424,46.2,93640.9978,40,35,35,5,0,13,3,male
264 ms,264,16100 KB,16100,China,Asia,53,258,252.2386659,1477.803477,36.57142857,54045.38431,44,38,38,6,0,11,3,female
296 ms,296,14200 KB,14200,Syria,Asia,58,310,281.9620482,1815.974108,63.14814815,114675.402,46,31,22,15,9,11,3,male
249 ms,249,14100 KB,14100,China,Asia,57,308,276.0964047,1796.530124,48,86233.44597,41,34,33,7,1,13,3,male
296 ms,296,22700 KB,22700,India,Asia,36,218,171.2198934,1127.04365,16.5,18596.22023,41,30,27,11,3,11,3,male
296 ms,296,21100 KB,21100,India,Asia,35,235,164.7548875,1205.381509,16,19286.10414,53,41,35,12,6,15,3,male
264 ms,264,12600 KB,12600,India,Asia,54,258,257.6220106,1484.760976,51.2173913,76045.58388,41,36,36,5,0,11,3,male
763 ms,763,24700 KB,24700,India,Asia,48,289,223.0669539,1614.054163,46.5,75053.51857,63,47,39,16,8,11,3,male
1029 ms,1029,14000 KB,14000,Iran,Asia,0,0,0,0,0,0,46,35,32,11,3,11,3,male
764 ms,764,28300 KB,28300,India,Asia,51,268,242.4606049,1520.209992,35,53207.34971,60,45,39,15,6,11,3,male
264 ms,264,17800 KB,17800,Egypt,AsiaAfrica,53,256,252.9035678,1466.347636,41.25,60486.84,46,41,41,5,0,11,3,male
764 ms,764,16100 KB,16100,India,Asia,50,249,235.05865,1405.320191,31.11111111,43721.07262,59,48,45,11,3,9,3,male
249 ms,249,13400 KB,13400,Argentina,South America,53,246,251.2486429,1409.068432,30,42272.05295,53,37,26,16,11,11,3,male
732 ms,732,19700 KB,19700,India,Asia,52,290,245.8187515,1653.127518,45.02380952,74430.0985,51,41,37,10,4,11,3,male
280 ms,280,13400 KB,13400,Indonesia,Asia,54,309,258.1074956,1778.260238,55.27272727,98289.29316,50,39,35,11,4,14,3,male
1060 ms,1060,21200 KB,21200,India,Asia,34,209,158.3349731,1063.279734,15.5,16480.83587,76,47,25,29,22,12,3,male
748 ms,748,17800 KB,17800,Bangladesh,Asia,50,237,233.6452798,1337.593917,34.5,46146.99014,54,42,38,12,4,12,3,male
794 ms,794,23000 KB,23000,India,Asia,38,268,180.9737366,1406.444574,17,23909.55775,64,57,57,7,0,12,3,male
249 ms,249,12600 KB,12600,India,Asia,52,244,247.1756287,1390.907291,49.5,68849.91092,59,47,41,12,6,10,3,male
264 ms,264,15300 KB,15300,Unknown,Unknown,54,305,258.7036718,1755.240688,51.85714286,91021.76711,58,46,40,12,6,11,3,male
312 ms,312,22300 KB,22300,India,Asia,61,285,301.7363383,1690.260141,45.09615385,76224.23137,58,42,36,16,6,12,3,male
295 ms,295,13600 KB,13600,South Korea,Asia,58,263,282.5614107,1540.649002,34.98,53891.90208,45,29,24,16,5,12,3,male
483 ms,483,15900 KB,15900,Taiwan,Asia,49,273,231.5770955,1532.815787,36.26666667,55590.11922,68,49,36,19,13,11,3,male
311 ms,311,16100 KB,16100,China,Asia,54,295,256.9778536,1697.691813,40.6,68926.28761,41,31,26,10,5,15,3,male
312 ms,312,16300 KB,16300,Unknown,Unknown,64,312,320.7232379,1872,45,84240,51,40,36,11,4,12,4,male
280 ms,280,16300 KB,16300,Unknown,Unknown,64,312,320.7232379,1872,45,84240,51,40,36,11,4,12,4,male
280 ms,280,21100 KB,21100,India,Asia,44,249,212.401259,1359.398473,52.85714286,71853.91929,58,36,28,22,8,8,3,male
779 ms,779,14200 KB,14200,Russia,AsiaEurope,58,296,281.9620482,1733.962375,48.7962963,84610.9418,57,43,35,14,8,11,3,male
779 ms,779,14200 KB,14200,India,Asia,51,295,239.4453837,1673.365476,43.57142857,72910.92431,74,49,34,25,15,8,3,male
265 ms,265,12800 KB,12800,India,Asia,53,252,252.2386659,1443.435955,44.95238095,64885.88291,60,47,41,13,6,10,3,male
327 ms,327,22300 KB,22300,India,Asia,59,321,290.159225,1888.328419,41.47826087,78324.57876,50,42,42,8,0,15,3,male
1029 ms,1029,13200 KB,13200,India,Asia,55,296,264.041925,1711.282475,57.04347826,97617.50467,53,37,32,16,5,11,3,male
249 ms,249,19000 KB,19000,India,Asia,59,301,289.5640056,1770.675558,47.39583333,83922.64363,52,49,49,3,0,12,2,male
795 ms,795,24400 KB,24400,Germany,Europe,60,318,294.4134357,1878.391209,50.5,94858.75607,48,33,26,15,7,13,3,male
265 ms,265,15500 KB,15500,Peru,South America,61,301,301.3556992,1785.151939,49.74074074,88794.77976,55,40,31,15,9,11,3,male
795 ms,795,15300 KB,15300,Russia,AsiaEurope,53,308,250.9205489,1764.1995,62.22916667,109784.6647,51,40,35,11,5,10,3,male
171 ms,171,12000 KB,12000,China,Asia,75,430,392.9423377,2678.392037,39.67857143,106274.7698,38,0,0,38,0,0,3,female
249 ms,249,15900 KB,15900,China,Asia,54,327,256.9778536,1881.848213,40.02,75311.56549,45,37,37,8,0,13,3,male
826 ms,826,11600 KB,11600,India,Asia,51,327,239.4453837,1854.883087,36.42857143,67570.74102,62,54,53,8,1,13,3,male
264 ms,264,10000 KB,10000,Turkmenistan,Asia,56,316,269.6764904,1835.124155,45.26,83057.71927,57,34,24,23,10,14,3,male
249 ms,249,12800 KB,12800,India,Asia,55,258,264.041925,1491.590806,43.82608696,65370.58837,61,48,42,13,6,10,3,male
280 ms,280,15500 KB,15500,Indonesia,Asia,58,299,283.5668306,1751.536318,51.73913043,90622.96599,55,40,32,15,8,12,3,male
280 ms,280,13600 KB,13600,Vietnam,Asia,55,278,264.5725015,1607.218,36.75,59065.26151,46,39,39,7,0,14,3,male
264 ms,264,16200 KB,16200,Bangladesh,Asia,65,355,326.4650059,2137.940574,56.24242424,120242.9607,51,34,25,17,9,11,3,male
841 ms,841,27100 KB,27100,India,Asia,34,238,158.3349731,1210.816156,20.66666667,25023.5339,73,44,20,29,24,10,3,male
280 ms,280,14700 KB,14700,Iran,Asia,0,0,0,0,0,0,50,38,38,12,0,14,3,female
452 ms,452,15900 KB,15900,Poland,Europe,60,344,294.6059378,2031.970365,54.28571429,110306.9627,69,45,26,24,19,11,3,male
748 ms,748,31900 KB,31900,India,Asia,58,291,281.9620482,1704.67247,43.05555556,73395.62022,53,29,15,24,14,12,3,male
311 ms,311,19200 KB,19200,Syria,Asia,38,214,188.1173001,1123.056488,18,20215.01678,45,39,39,6,0,13,3,male
748 ms,748,13400 KB,13400,Argentina,South America,48,228,223.0669539,1273.37145,35.55882353,45279.59068,57,41,30,16,11,11,3,male
265 ms,265,14900 KB,14900,Bangladesh,Asia,68,325,345.9899115,1978.425423,50.90909091,100719.8397,53,41,35,12,6,11,3,male
561 ms,561,26100 KB,26100,India,Asia,40,244,191.1345461,1298.550455,24.5,31814.48615,61,47,47,14,0,11,3,male
1091 ms,1091,30000 KB,30000,Taiwan,Asia,41,265,197.7269405,1419.751281,18,25555.52306,48,27,23,21,4,11,3,male
295 ms,295,16100 KB,16100,China,Asia,77,361,405.7769322,2262.309941,42.14634146,95348.08728,42,32,28,10,4,15,3,female
748 ms,748,14200 KB,14200,India,Asia,56,343,269.4181505,1991.922738,52.5,104575.9438,89,60,38,29,22,13,3,male
234 ms,234,14000 KB,14000,Bangladesh,Asia,65,299,326.4650059,1800.687976,38.78787879,69844.86695,45,34,30,11,4,12,3,male
795 ms,795,16100 KB,16100,India,Asia,60,272,294.4615345,1606.674242,39.01724138,62687.99672,50,39,35,11,4,12,3,male
280 ms,280,12800 KB,12800,India,Asia,55,263,264.041925,1520.497605,43.82608696,66637.46024,62,49,43,13,6,11,3,male
810 ms,810,16100 KB,16100,India,Asia,52,290,245.3142135,1653.127518,36.81818182,60865.14954,57,41,32,16,9,11,3,male
249 ms,249,15900 KB,15900,China,Asia,66,378,332.9300119,2284.780977,60.5,138229.2491,42,36,36,6,0,14,4,male
389 ms,389,20800 KB,20800,India,Asia,39,237,190.8721876,1252.640326,24,30063.36782,57,48,48,9,0,12,3,male
280 ms,280,10900 KB,10900,Italy,Europe,63,321,313.8551855,1918.706855,42.79310345,82107.42095,50,39,34,11,5,13,4,male
795 ms,795,16100 KB,16100,India,Asia,49,300,228.6387356,1684.412953,48.22222222,81226.13574,59,42,34,17,8,12,3,male
186 ms,186,35200 KB,35200,China,Asia,71,389,365.7235111,2392.251629,47.88235294,114546.6368,44,0,0,44,0,0,3,female
826 ms,826,13400 KB,13400,Indonesia,Asia,59,239,288.3819626,1405.951689,24.88888889,34992.57537,47,38,38,9,0,12,3,male
748 ms,748,14200 KB,14200,Unknown,Unknown,72,362,372.3949821,2233.512851,42.05263158,93925.09303,46,38,37,8,1,19,4,male
748 ms,748,17800 KB,17800,India,Asia,52,250,245.3142135,1425.10993,32.72727273,46639.96133,60,45,37,15,8,12,3,male
296 ms,296,26800 KB,26800,Brazil,South America,25,48,91.82263988,222.9050971,11.25,2507.682342,49,35,30,14,5,8,3,male
919 ms,919,15500 KB,15500,Syria,Asia,57,277,275.7915183,1615.710534,42.92307692,69351.26753,64,40,24,24,16,11,3,female
280 ms,280,16100 KB,16100,Unknown,Unknown,51,304,241.523656,1724.417304,42.16666667,72712.92965,58,39,33,19,6,11,3,female
295 ms,295,14500 KB,14500,China,Asia,46,279,209.6645878,1541.073786,53.66666667,82704.29317,47,41,41,6,0,11,3,female
264 ms,264,29000 KB,29000,China,Asia,63,283,313.6717238,1691.570218,40.7,68846.90789,51,39,34,12,5,11,3,female
280 ms,280,14200 KB,14200,Taiwan,Asia,58,309,284.2247957,1810.116127,57.27272727,103670.2873,61,41,28,20,13,14,3,female
1013 ms,1013,34700 KB,34700,China,Asia,81,393,434.543206,2491.561051,48.125,119906.3756,43,29,29,14,0,12,3,female
280 ms,280,14900 KB,14900,South Georgia and the South Sandwich Islands,Antarctic,64,360,320.4063545,2160,58.53448276,126434.4828,59,48,47,11,1,12,3,female
171 ms,171,12000 KB,12000,China,Asia,67,438,339.4387425,2656.947065,54.60606061,145085.4125,58,51,51,7,0,15,4,female
265 ms,265,14800 KB,14800,China,Asia,67,358,339.4387425,2171.65993,32.96969697,71598.96982,53,29,29,24,0,8,3,female
311 ms,311,58300 KB,58300,China,Asia,60,339,294.4615345,2002.435912,39.55172414,79199.79279,56,45,43,11,2,12,3,female
311 ms,311,26600 KB,26600,Ukraine,Europe,57,344,276.0964047,2006.514165,60.8,121996.0612,53,33,29,20,4,11,3,female
1029 ms,1029,16000 KB,16000,Unknown,Unknown,58,378,281.7628977,2214.316816,49,108501.524,54,44,40,10,4,11,3,female
795 ms,795,18900 KB,18900,Bangladesh,Asia,51,268,241.523656,1520.209992,24.75,37625.19729,54,44,39,10,5,13,2,female
795 ms,795,20800 KB,20800,India,Asia,36,306,174.9737366,1581.99705,17,26893.94986,82,68,66,14,2,11,4,female
280 ms,280,16100 KB,16100,Mexico,North America,52,337,247.1756287,1921.048185,36.47368421,70067.70485,59,38,35,21,3,9,3,female
108 ms,108,12800 KB,12800,Japan,Asia,65,408,328.3421192,2457.126068,35.25,86613.69389,72,62,62,10,0,18,6,female
810 ms,810,22400 KB,22400,Russia,AsiaEurope,48,276,223.0669539,1541.44965,51.05882353,78704.60567,62,47,41,15,6,11,3,female
483 ms,483,16000 KB,16000,Egypt,AsiaAfrica,56,331,270.0391,1922.234479,46.66666667,89704.2757,52,40,34,12,6,10,3,female
1107 ms,1107,16000 KB,16000,Romania,Europe,49,342,227.3200108,1920.230767,46.4,89098.70757,54,40,34,14,6,11,3,female
780 ms,780,14200 KB,14200,Bangladesh,Asia,65,357,328.3421192,2149.985309,60.75,130611.6075,69,46,33,23,13,16,8,female
795 ms,795,14200 KB,14200,Bangladesh,Asia,66,359,335.0885565,2169.937489,62.30769231,135203.7974,69,46,33,23,13,16,8,female
795 ms,795,16100 KB,16100,Lebanon,Asia,55,312,263.0928815,1803.784231,45.17307692,81482.4838,53,36,26,17,10,11,3,female
265 ms,265,24000 KB,24000,Taiwan,Asia,66,356,333.1049912,2151.804306,40.08064516,86245.70487,55,30,26,25,4,12,3,female
187 ms,187,13800 KB,13800,China,Asia,71,475,365.8862514,2921.129882,64.69736842,188989.4162,58,0,0,58,0,0,3,female
249 ms,249,17000 KB,17000,Colombia,South America,65,328,327.3557123,1975.336643,43.60714286,86138.78717,66,39,26,27,13,13,5,female
218 ms,218,15100 KB,15100,China,Asia,71,463,365.7235111,2847.332916,33.73529412,96055.61338,76,64,64,12,0,16,4,female
296 ms,296,28600 KB,28600,Japan,Asia,39,265,175.7360429,1400.631588,15,21009.47382,66,43,34,23,9,5,2,female
327 ms,327,22300 KB,22300,Russia,AsiaEurope,55,299,265.9634675,1728.626554,30.625,52939.18823,65,50,44,15,6,14,4,female
295 ms,295,13400 KB,13400,China,Asia,83,444,447.6031056,2830.517508,47.31428571,133923.9141,48,34,34,14,0,21,8,female
234 ms,234,10600 KB,10600,China,Asia,68,468,346.6279634,2848.93261,57.63333333,164193.4827,65,40,37,25,3,14,3,female
858 ms,858,13200 KB,13200,Poland,Europe,50,298,233.1201147,1681.869145,32.45238095,54580.65819,60,45,39,15,6,13,3,female
265 ms,265,13400 KB,13400,China,Asia,83,450,447.6031056,2868.767744,47.31428571,135733.6967,50,36,36,14,0,22,8,female
717 ms,717,11200 KB,11200,China,Asia,65,439,326.5538222,2643.81947,61.41935484,162381.6862,57,20,15,37,5,5,1,female
249 ms,249,14200 KB,14200,Unknown,Unknown,61,396,305.1157897,2348.571986,46.66666667,109600.026,58,33,27,25,6,8,3,female
873 ms,873,15900 KB,15900,China,Asia,73,475,378.8670746,2940.166665,63.20833333,185843.0346,68,58,58,10,0,18,7,female
295 ms,295,24000 KB,24000,India,Asia,37,251,177.7286241,1307.572795,17,22228.73751,52,33,32,19,1,12,4,female
795 ms,795,16100 KB,16100,China,Asia,68,380,345.9474732,2313.23588,41.5,95999.28901,64,40,39,24,1,8,3,female
764 ms,764,16300 KB,16300,Egypt,AsiaAfrica,62,382,307.9068682,2274.502991,49.25925926,112040.3325,64,40,38,24,2,11,3,female
296 ms,296,20800 KB,20800,India,Asia,38,365,188.1173001,1915.493542,18,34478.88376,86,64,57,22,7,16,6,female
764 ms,764,16100 KB,16100,Romania,Europe,55,300,265.9634675,1734.407914,45.5,78915.56009,66,44,30,22,14,16,3,female
327 ms,327,28600 KB,28600,China,Asia,72,505,372.3949821,3115.812126,44.14705882,137553.9412,72,53,51,19,2,19,3,female
296 ms,296,21100 KB,21100,India,Asia,76,348,399.7943904,2174.278775,39.52325581,85934.57622,54,41,41,13,0,13,3,female
405 ms,405,15900 KB,15900,China,Asia,93,490,515.2115894,3204.187817,58.59375,187745.3799,60,40,37,20,3,17,4,female
280 ms,280,14200 KB,14200,India,Asia,70,428,359.4212455,2623.333131,57.59375,151087.5925,64,38,32,26,6,9,3,female
748 ms,748,14200 KB,14200,Taiwan,Asia,60,295,295.1851693,1742.532726,51,88869.16901,69,42,38,27,4,12,3,female
779 ms,779,13900 KB,13900,Ukraine,Europe,83,495,446.1369639,3155.644519,73.21428571,231038.2594,78,40,22,38,18,17,6,female
108 ms,108,12000 KB,12000,China,Asia,106,574,608.4972857,3861.826341,78.2,301994.8199,60,9,-1,51,10,9,2,female
109 ms,109,12000 KB,12000,China,Asia,106,574,608.4972857,3861.826341,78.2,301994.8199,60,9,-1,51,10,9,2,female
264 ms,264,15700 KB,15700,India,Asia,60,361,295.1851693,2132.387505,30.07692308,64135.65496,76,59,54,17,5,14,3,female
280 ms,280,31000 KB,31000,China,Asia,59,402,292.5692484,2364.822506,52.65,124507.9049,93,40,26,53,14,12,3,female
748 ms,748,19000 KB,19000,Unknown,Unknown,53,323,254.5835556,1850.118307,48.61111111,89936.30658,73,58,51,15,7,13,3,female
841 ms,841,14000 KB,14000,China,Asia,69,408,352.582306,2492.277978,46.75,116513.9955,87,37,24,50,13,8,3,female
312 ms,312,24600 KB,24600,India,Asia,57,373,278.3559659,2175.667975,52.28571429,113756.3541,76,44,34,32,10,12,3,female
218 ms,218,17300 KB,17300,China,Asia,68,492,346.1173001,2995.031718,48.88888889,146423.7729,91,70,70,21,0,18,4,female
779 ms,779,16100 KB,16100,Germany,Europe,51,334,240.7106228,1894.590064,48.84210526,92535.76735,82,59,51,23,8,13,4,female
826 ms,826,115500 KB,115500,Unknown,Unknown,55,443,265.9634675,2561.142353,49.875,127736.9749,98,45,28,53,17,12,3,female
763 ms,763,16100 KB,16100,China,Asia,64,442,322.2270913,2652,49.92,132387.84,76,39,39,37,0,8,3,female
265 ms,265,10300 KB,10300,Belarus,Europe,62,335,307.9068682,1994.655764,52.5,104719.4276,83,46,33,37,13,11,3,female
280 ms,280,26300 KB,26300,Belarus,Europe,37,284,181.5249056,1479.484756,17.5,25890.98323,97,41,16,56,25,11,3,female
249 ms,249,14200 KB,14200,Japan,Asia,81,482,432.75063,3055.807701,74.11842105,226491.6419,95,55,39,40,16,16,7,female
280 ms,280,13400 KB,13400,China,Asia,90,510,494.5555318,3310.845079,63.42857143,210002.1736,81,54,45,27,9,26,5,female
561 ms,561,15900 KB,15900,China,Asia,71,496,365.7235111,3050.274571,71.27941176,217421.7772,91,43,35,48,8,13,4,female
311 ms,311,17100 KB,17100,China,Asia,73,452,378.8670746,2797.800701,58.86486486,164692.1602,97,54,28,43,26,17,4,female
904 ms,904,14200 KB,14200,China,Asia,106,680,607.4046851,4574.985909,83.03571429,379887.2228,71,46,43,25,3,24,7,female
1013 ms,1013,64400 KB,64400,China,Asia,81,465,433.2506894,2948.030251,47.6,140326.24,75,51,51,24,0,19,6,female
529 ms,529,24500 KB,24500,Russia,AsiaEurope,69,462,352.4986422,2822.138299,56.61764706,159782.8302,92,51,40,41,11,12,3,female
327 ms,327,28300 KB,28300,India,Asia,41,320,204.176133,1714.416641,19,32573.91619,95,53,40,42,13,13,4,female
280 ms,280,16900 KB,16900,China,Asia,76,383,399.1845378,2392.956238,31.58536585,75582.39824,83,41,31,42,10,10,3,female
280 ms,280,17300 KB,17300,South Korea,Asia,53,385,255.6041684,2205.249375,58.23529412,128423.346,67,45,39,22,6,13,3,female
296 ms,296,16900 KB,16900,Iran,Asia,59,438,288.6764386,2576.597656,68.53846154,176596.0393,76,54,48,22,6,13,3,female
343 ms,343,26300 KB,26300,India,Asia,38,175,162.6452839,918.3873149,25.3,23235.19907,91,58,55,33,3,10,4,female
296 ms,296,9500 KB,9500,China,Asia,74,537,386.1246381,3334.476457,69.57575758,231998.7256,91,50,40,41,10,18,4,female
467 ms,467,14800 KB,14800,China,Asia,90,538,494.3950605,3492.616966,71.04651163,248138.2519,87,45,34,42,11,17,7,female
265 ms,265,22000 KB,22000,India,Asia,80,492,426.079159,3110.388623,45.90540541,142783.6507,101,47,27,54,20,12,5,female
233 ms,233,9800 KB,9800,China,Asia,86,486,466.692323,3123.164671,58.70454545,183343.9624,100,52,47,48,5,17,4,female
295 ms,295,14900 KB,14900,China,Asia,78,474,413.5983953,2979.280652,49.77272727,148286.9233,108,80,80,28,0,24,9,female
358 ms,358,25500 KB,25500,Russia,AsiaEurope,71,479,366.1306865,2945.72887,50.578125,148989.443,124,74,61,50,13,18,4,female
265 ms,265,22400 KB,22400,Japan,Asia,84,613,453.8154506,3918.49058,52.35106383,205137.1505,92,39,30,53,9,16,5,female
296 ms,296,16900 KB,16900,India,Asia,91,687,501.5981141,4470.854918,58.33333333,260799.8702,104,65,53,39,12,18,7,female
295 ms,295,24600 KB,24600,Bangladesh,Asia,89,639,487.5430078,4137.993662,84.44680851,349440.3584,111,56,31,55,25,25,9,female
358 ms,358,36400 KB,36400,India,Asia,80,520,425.8985773,3287.402609,57.47368421,188939.1394,123,83,68,40,15,22,5,female
1419 ms,1419,11000 KB,11000,Japan,Asia,84,544,453.2640759,3477.420678,61.73076923,214663.8534,105,66,54,39,12,21,8,female
249 ms,249,19500 KB,19500,India,Asia,65,445,326.9987489,2679.953677,34.75862069,93151.49332,166,91,66,75,25,17,6,female
592 ms,592,17900 KB,17900,India,Asia,75,681,392.4020294,4241.825528,63.42857143,269052.9335,119,81,80,38,1,17,7,female
295 ms,295,26600 KB,26600,Belarus,Europe,77,559,405.6268983,3503.133676,55.5,194423.919,127,65,58,62,7,18,3,female
295 ms,295,20800 KB,20800,India,Asia,91,797,503.0010296,5186.712328,134.0754717,695410.902,88,54,54,34,0,22,9,female
280 ms,280,23000 KB,23000,India,Asia,89,733,487.3483806,4746.712605,73.63636364,349530.6555,168,118,118,50,0,32,9,female
280 ms,280,47800 KB,47800,Russia,AsiaEurope,77,631,405.551932,3954.342307,52.34210526,206978.6013,143,54,42,89,12,17,5,female
343 ms,343,18400 KB,18400,China,Asia,107,1022,615.8588276,6889.77926,175.704918,1210568.1,115,66,64,49,2,38,11,female
311 ms,311,24600 KB,24600,India,Asia,50,624,255.7247662,3521.766262,29.33333333,103305.1437,208,139,114,69,25,34,12,female
265 ms,265,29900 KB,29900,Bangladesh,Asia,68,725,346.6279634,4413.41056,61.43333333,271130.5221,184,53,2,131,51,10,5,female
234 ms,234,15600 KB,15600,Bangladesh,Asia,84,636,455.7586984,4065.513881,44.64705882,181513.2374,160,38,19,122,19,10,3,female
764 ms,764,15300 KB,15300,China,Asia,116,1334,683.1336612,9148.546648,86.74285714,793571.0749,200,143,126,57,17,36,12,female
311 ms,311,39400 KB,39400,Bangladesh,Asia,8,69,24,207,0,0,226,47,-12,179,59,12,3,female
249 ms,249,10100 KB,10100,China,Asia,11,26,38.05374781,89.94522208,0,0,151,73,73,78,0,68,38,female
311 ms,311,24600 KB,24600,India,Asia,79,1357,428.0138843,8554.230475,45.83333333,392068.8968,396,271,222,125,49,67,23,female
280 ms,280,16100 KB,16100,Bangladesh,Asia,49,373,235.7693245,2094.286772,30.83333333,64573.84213,263,51,11,212,40,24,16,female
530 ms,530,19500 KB,19500,India,Asia,55,224,263.6191856,1295.024576,26.47916667,34291.17158,35,28,25,7,3,10,2,male
389 ms,389,21100 KB,21100,India,Asia,47,213,218.6033589,1183.127425,25.6,30288.06209,50,41,36,9,5,8,2,male
108 ms,108,20900 KB,20900,India,Asia,46,242,217.5786534,1336.701993,35,46784.56977,45,36,29,9,7,10,2,male
108 ms,108,21800 KB,21800,India,Asia,46,214,215.9932866,1182.042259,31.16666667,36840.31706,43,33,28,10,5,11,3,male
108 ms,108,18200 KB,18200,United States,North America,48,225,225.0683649,1256.616563,41.8,52526.57232,41,35,32,6,3,10,2,male
373 ms,373,21100 KB,21100,India,Asia,48,221,225.0683649,1234.276713,25.3,31227.20083,54,40,30,14,10,10,2,male
561 ms,561,15700 KB,15700,Bangladesh,Asia,51,211,240.7106228,1196.881747,23.57894737,28221.21172,35,33,33,2,0,10,2,male
592 ms,592,18600 KB,18600,India,Asia,41,241,188.529325,1291.170033,26.66666667,34431.20088,58,56,56,2,0,10,2,male
124 ms,124,27000 KB,27000,Unknown,Unknown,51,248,241.523656,1406.761485,27.5,38685.94083,52,43,40,9,3,9,2,male
499 ms,499,20600 KB,20600,India,Asia,41,239,192.6252211,1280.454929,31.57142857,40425.79133,56,51,50,5,1,11,2,male
530 ms,530,26400 KB,26400,India,Asia,41,235,190.4650059,1259.024721,26.8125,33757.60033,55,51,51,4,0,12,2,male
108 ms,108,11300 KB,11300,China,Asia,77,403,405.7769322,2525.514976,41.70731707,105332.4539,35,30,30,5,0,20,2,male
108 ms,108,18200 KB,18200,India,Asia,40,250,201.4212455,1330.482024,19,25279.15845,59,49,46,10,3,11,2,male
436 ms,436,16700 KB,16700,Jordan,Asia,52,258,248.0323866,1470.713447,28.33333333,41670.21434,46,30,22,16,8,10,2,male
545 ms,545,23500 KB,23500,Bangladesh,Asia,47,246,221.0794529,1366.428858,27.46153846,37524.23863,60,46,38,14,8,9,2,male
343 ms,343,16700 KB,16700,China,Asia,56,315,271.0812322,1829.3168,27.81818182,50888.26736,38,35,35,3,0,15,5,male
343 ms,343,16700 KB,16700,China,Asia,56,315,271.0812322,1829.3168,27.81818182,50888.26736,38,35,35,3,0,15,5,male
529 ms,529,18600 KB,18600,India,Asia,41,225,192.6252211,1205.449201,38.85714286,46840.31181,52,40,40,12,0,10,2,male
561 ms,561,25500 KB,25500,India,Asia,49,252,231.5770955,1414.906881,23.8,33674.78376,59,53,52,6,1,10,3,male
546 ms,546,18600 KB,18600,India,Asia,43,238,203.5249056,1291.451012,26.25,33900.58906,68,58,50,10,8,12,2,male
530 ms,530,16500 KB,16500,China,Asia,53,315,254.5835556,1804.294943,36.94444444,66658.67429,59,55,55,4,0,16,3,male
608 ms,608,24400 KB,24400,India,Asia,66,304,333.1049912,1837.495812,41.77419355,76759.90571,56,53,53,3,0,14,3,male
592 ms,592,32300 KB,32300,India,Asia,49,240,232.8278745,1347.530363,32.5,43794.73678,42,33,27,9,6,9,2,male
545 ms,545,18600 KB,18600,India,Asia,58,295,284.2247957,1728.104394,36.81818182,63625.66176,59,54,53,5,1,13,3,male
77 ms,77,17600 KB,17600,China,Asia,68,378,347.4830616,2301.060954,22.14285714,50952.06398,43,35,35,8,0,19,1,male
93 ms,93,14700 KB,14700,Vietnam,Asia,67,323,340.7366244,1959.346809,40.39285714,79143.61573,53,42,35,11,7,18,1,male
109 ms,109,10800 KB,10800,South Korea,Asia,79,406,419.2271063,2559.334984,45.80952381,117241.9169,39,33,31,6,2,21,1,male
62 ms,62,17600 KB,17600,China,Asia,68,391,347.4830616,2380.197971,22.14285714,52704.38364,43,35,35,8,0,19,1,male
561 ms,561,24500 KB,24500,China,Asia,70,407,359.0910367,2494.618188,54.52941176,136030.0624,48,44,44,4,0,14,2,male
420 ms,420,25000 KB,25000,India,Asia,38,250,188.1173001,1311.981878,18,23615.67381,67,56,50,11,6,12,2,male
374 ms,374,15300 KB,15300,Bangladesh,Asia,57,244,277.6324012,1423.225163,26.25,37359.66054,44,39,37,5,2,10,2,male
577 ms,577,17600 KB,17600,India,Asia,50,286,235.9518742,1614.14287,33.97058824,54833.3828,98,80,72,18,8,12,2,male
93 ms,93,15300 KB,15300,Iran,Asia,64,252,321.1317371,1512,33.57407407,50764,40,31,30,9,1,10,2,male
108 ms,108,15700 KB,15700,Brazil,South America,63,302,314.1308434,1805.138537,29.375,53025.94452,68,40,20,28,20,11,2,male
93 ms,93,11800 KB,11800,China,Asia,68,475,345.9899115,2891.54485,71.59090909,207008.3245,50,45,45,5,0,18,2,male
561 ms,561,25400 KB,25400,Azerbaijan,AsiaEurope,58,361,282.2114327,2114.731139,43.07692308,91096.11061,40,36,36,4,0,19,2,male
560 ms,560,19600 KB,19600,India,Asia,46,255,213.3029689,1408.508299,29.71428571,41852.81802,88,65,46,23,19,10,2,male
78 ms,78,19700 KB,19700,India,Asia,46,250,217.5786534,1380.890489,23.86363636,32953.06849,43,39,38,4,1,13,2,male
109 ms,109,16600 KB,16600,China,Asia,73,432,380.0574174,2674.004209,32.8452381,87828.30493,44,36,35,8,1,18,1,male
93 ms,93,10800 KB,10800,China,Asia,70,475,359.0498112,2911.409433,48.5,141203.3575,30,23,21,7,2,15,1,male
93 ms,93,16500 KB,16500,China,Asia,73,432,380.0574174,2674.004209,32.8452381,87828.30493,45,36,34,9,2,18,1,female
124 ms,124,15300 KB,15300,Romania,Europe,61,263,302.7888745,1559.78392,35.45833333,55307.33816,35,30,27,5,3,10,2,male
78 ms,78,11300 KB,11300,China,Asia,67,371,339.5249056,2250.51909,37.734375,84921.93127,61,48,44,13,4,18,2,male
109 ms,109,17200 KB,17200,India,Asia,47,244,222.5444556,1355.31968,35,47436.18879,47,41,37,6,4,11,3,male
92 ms,92,19700 KB,19700,India,Asia,51,271,243.5249056,1537.227268,25.15625,38670.87345,48,41,38,7,3,14,3,male
405 ms,405,9800 KB,9800,Jordan,Asia,54,299,259.4122985,1720.711363,37.4,64354.60498,53,35,26,18,9,13,2,male
124 ms,124,16700 KB,16700,Austria,Europe,71,330,365.8862514,2029.416549,38.57575758,78286.28083,62,52,47,10,5,15,2,male
560 ms,560,18600 KB,18600,Ukraine,Europe,60,288,295.6213103,1701.184492,32.2,54778.14063,62,45,35,17,10,12,2,male
296 ms,296,22600 KB,22600,India,Asia,48,290,226.2767055,1619.639125,26.71428571,43267.50234,65,53,46,12,7,14,3,male
109 ms,109,16900 KB,16900,India,Asia,87,455,474.942584,2931.539291,48.84,143176.379,53,50,50,3,0,20,6,male
124 ms,124,18200 KB,18200,India,Asia,48,265,226.2767055,1480.015063,30.35714286,44929.02869,57,50,50,7,0,13,2,male
389 ms,389,18200 KB,18200,India,Asia,53,289,255.6041684,1655.369011,31.76470588,52582.30977,67,63,63,4,0,13,2,male
389 ms,389,18200 KB,18200,Kazakhstan,AsiaEurope,62,269,307.9068682,1601.678807,33.05555556,52944.3828,43,27,22,16,5,10,2,male
468 ms,468,18500 KB,18500,India,Asia,56,257,271.7635715,1492.490215,27.5,41043.48091,51,48,48,3,0,13,2,male
577 ms,577,17600 KB,17600,India,Asia,56,257,271.7635715,1492.490215,27.5,41043.48091,51,48,48,3,0,13,2,male
483 ms,483,10800 KB,10800,Unknown,Unknown,58,370,283.5668306,2167.452968,36.52173913,79159.15188,66,61,61,5,0,22,2,male
202 ms,202,26500 KB,26500,Iran,Asia,66,308,332.9737366,1861.673389,37.1875,69230.97914,47,33,28,14,5,15,2,male
124 ms,124,22100 KB,22100,India,Asia,60,303,300.3702549,1789.78785,30.21052632,54070.43296,53,44,40,9,4,10,2,male
499 ms,499,19600 KB,19600,Hong Kong,Asia,54,250,258.1074956,1438.721876,25.45454545,36622.01138,42,37,36,5,1,11,2,male
109 ms,109,19600 KB,19600,Indonesia,Asia,61,301,302.7888745,1785.151939,39.3125,70178.78559,49,42,39,7,3,11,2,male
124 ms,124,17200 KB,17200,Vietnam,Asia,52,268,250.1173001,1527.717844,40.5,61872.5727,47,38,33,9,5,12,3,male
124 ms,124,18200 KB,18200,India,Asia,58,270,283.5668306,1581.654869,36.52173913,57764.78651,54,41,35,13,6,11,2,male
77 ms,77,21500 KB,21500,China,Asia,71,495,365.6422056,3044.124824,42.77777778,130220.8953,38,34,34,4,0,26,2,male
561 ms,561,18600 KB,18600,India,Asia,64,337,320.4063545,2022,53.10344828,107375.1724,59,55,53,4,2,15,2,male
93 ms,93,11800 KB,11800,China,Asia,88,469,480.7253082,3029.473429,36.63829787,110994.7499,43,32,32,11,0,13,2,female
124 ms,124,20800 KB,20800,Unknown,Unknown,59,310,293.5877466,1823.619345,30.52631579,55668.38001,68,47,38,21,9,12,3,male
592 ms,592,25500 KB,25500,Kazakhstan,AsiaEurope,56,307,272.5558619,1782.857961,41.4,73810.31959,51,46,46,5,0,10,2,female
77 ms,77,12700 KB,12700,India,Asia,66,336,334.0271833,2030.916424,37.32142857,75796.70226,57,50,49,7,1,16,1,male
78 ms,78,6000 KB,6000,South Korea,Asia,42,315,193.2192809,1698.579988,16,27177.27981,84,79,79,5,0,20,1,male
124 ms,124,19100 KB,19100,Serbia,Europe,51,296,241.523656,1679.037901,33.91666667,56947.36882,74,55,38,19,17,12,3,male
78 ms,78,50900 KB,50900,China,Asia,74,436,386.1246381,2707.321667,49.07575758,132863.8618,45,0,0,45,0,0,3,male
78 ms,78,50900 KB,50900,China,Asia,74,436,386.1246381,2707.321667,49.07575758,132863.8618,45,0,0,45,0,0,3,male
109 ms,109,21800 KB,21800,Bangladesh,Asia,56,271,273.4603973,1573.793184,27.26315789,42906.57207,62,43,32,19,11,13,2,male
373 ms,373,19200 KB,19200,Bangladesh,Asia,52,255,248.0323866,1453.612128,29.27777778,42558.53286,49,41,37,8,4,11,2,male
546 ms,546,24500 KB,24500,China,Asia,65,406,326.9987489,2445.081332,48.4137931,118375.6617,45,35,35,10,0,18,3,male
576 ms,576,17600 KB,17600,India,Asia,67,295,339.6973857,1789.496311,34.25806452,61304.68008,44,39,38,5,1,12,3,male
405 ms,405,25500 KB,25500,China,Asia,62,400,309.4603455,2381.678524,62.54166667,148954.1444,67,61,61,6,0,17,2,female
78 ms,78,20600 KB,20600,China,Asia,80,405,425.7903187,2560.380878,42.57692308,109013.1397,53,38,35,15,3,18,2,female
545 ms,545,16700 KB,16700,Unknown,Unknown,57,247,277.6324012,1440.723833,29.43181818,42403.12192,47,42,42,5,0,11,2,male
545 ms,545,15600 KB,15600,China,Asia,54,342,260.2355283,1968.171526,41.44736842,81575.53034,86,72,69,14,3,20,2,male
124 ms,124,19200 KB,19200,India,Asia,45,254,214.6466251,1394.930686,20,27898.61373,54,40,35,14,5,10,2,male
124 ms,124,20800 KB,20800,Vietnam,Asia,53,284,256.7497745,1626.729409,45.09375,73355.32929,50,38,32,12,6,12,3,male
405 ms,405,15300 KB,15300,India,Asia,52,278,257.71338,1584.722242,31.68181818,50206.88193,53,37,31,16,6,11,2,male
546 ms,546,18600 KB,18600,China,Asia,55,250,265.2124025,1445.339928,28.33333333,40951.29797,48,38,34,10,4,13,2,female
421 ms,421,25600 KB,25600,India,Asia,68,356,345.9899115,2167.136771,34.46969697,74700.5478,51,45,45,6,0,13,2,male
124 ms,124,6400 KB,6400,India,Asia,65,340,328.3421192,2047.605056,40.5,82928.00479,65,48,42,17,6,11,2,male
577 ms,577,15700 KB,15700,India,Asia,57,279,280.1318683,1627.376314,30,48821.28942,58,43,40,15,3,10,2,male
109 ms,109,23100 KB,23100,India,Asia,63,322,317.7671278,1924.684135,45.65909091,87879.32791,50,42,39,8,3,12,2,male
592 ms,592,25500 KB,25500,Unknown,Unknown,40,279,197.504662,1484.817938,18.5,27469.13186,68,52,44,16,8,12,3,male
93 ms,93,15400 KB,15400,Iran,Asia,54,332,258.7036718,1910.622651,33.78571429,64551.75098,38,27,22,11,5,18,3,male
77 ms,77,22100 KB,22100,Mexico,North America,45,310,214.6466251,1702.47446,38,64694.02947,47,38,37,9,1,17,3,male
327 ms,327,19700 KB,19700,Unknown,Unknown,58,295,284.2247957,1728.104394,31.90909091,55142.24019,63,50,50,13,0,13,2,male
124 ms,124,18200 KB,18200,India,Asia,57,309,279.1883364,1802.363014,37,66687.43153,63,57,57,6,0,14,3,male
280 ms,280,17700 KB,17700,Unknown,Unknown,58,295,284.2247957,1728.104394,31.90909091,55142.24019,63,50,50,13,0,13,2,male
77 ms,77,20600 KB,20600,China,Asia,79,404,419.0808777,2546.727422,44.23684211,112659.1789,56,42,39,14,3,18,2,female
108 ms,108,18200 KB,18200,India,Asia,55,263,266.8279228,1520.497605,30.31578947,46095.08528,71,47,36,24,11,13,2,male
577 ms,577,16700 KB,16700,India,Asia,52,254,249.0117739,1447.911688,26.76470588,38752.93048,57,50,49,7,1,11,3,male
124 ms,124,18100 KB,18100,India,Asia,56,290,273.4603973,1684.132927,30.18421053,50834.22283,66,60,60,6,0,15,2,male
530 ms,530,31000 KB,31000,India,Asia,32,241,149.2067179,1205,15,18075,74,67,66,7,1,11,2,male
358 ms,358,15800 KB,15800,Unknown,Unknown,59,299,290.159225,1758.910272,30.52173913,53685.00047,63,50,50,13,0,13,2,male
577 ms,577,16600 KB,16600,India,Asia,72,344,373.2397178,2122.4542,42.32258065,89827.73907,57,51,49,6,2,16,2,male
124 ms,124,17700 KB,17700,India,Asia,53,252,256.7497745,1443.435955,27.75,40055.34774,58,54,54,4,0,13,2,male
389 ms,389,15300 KB,15300,Ukraine,Europe,56,291,273.4603973,1689.940282,44.78947368,75691.5358,57,43,38,14,5,14,2,male
467 ms,467,22700 KB,22700,Taiwan,Asia,58,369,284.9884404,2161.594987,38.76190476,83787.53903,52,49,48,3,1,16,1,female
576 ms,576,17600 KB,17600,China,Asia,70,407,359.2147805,2494.618188,49.33333333,123067.8306,76,51,35,25,16,18,2,male
186 ms,186,16700 KB,16700,Unknown,Unknown,62,315,310.9846194,1875.571838,36.36363636,68202.61228,45,33,26,12,7,10,3,male
358 ms,358,15800 KB,15800,Unknown,Unknown,60,305,296.7916995,1801.601632,31.36956522,56515.45988,63,50,50,13,0,13,2,male
576 ms,576,18600 KB,18600,India,Asia,53,277,254.5835556,1586.633966,28.19444444,44734.26321,59,54,53,5,1,14,3,male
561 ms,561,19600 KB,19600,Bangladesh,Asia,46,257,215.9932866,1419.555423,32.58333333,46253.84752,51,42,38,9,4,13,2,male
124 ms,124,26700 KB,26700,Unknown,Unknown,53,311,255.6041684,1781.383261,30.70588235,54698.94485,66,48,45,18,3,12,3,female
560 ms,560,15700 KB,15700,India,Asia,57,266,277.6324012,1551.548744,34.20454545,53070.01953,47,42,42,5,0,10,2,male
109 ms,109,21800 KB,21800,India,Asia,53,289,254.5835556,1655.369011,28.19444444,46672.20963,62,52,46,10,6,14,3,male
405 ms,405,30900 KB,30900,India,Asia,39,275,194.7497745,1453.48561,18.5,26889.48379,78,64,61,14,3,12,3,male
296 ms,296,10800 KB,10800,China,Asia,75,435,392.4020294,2709.53613,46.28571429,125412.8152,51,40,36,11,4,24,2,male
93 ms,93,10800 KB,10800,South Korea,Asia,70,423,359.4212455,2592.686716,42.52631579,110257.414,62,56,56,6,0,21,4,male
139 ms,139,17600 KB,17600,Peru,South America,67,338,340.3026944,2050.338146,47.82758621,98062.72445,76,57,41,19,16,15,3,male
342 ms,342,10800 KB,10800,China,Asia,75,435,392.4020294,2709.53613,46.28571429,125412.8152,51,40,36,11,4,24,2,male
342 ms,342,10800 KB,10800,China,Asia,75,435,392.4020294,2709.53613,46.28571429,125412.8152,52,40,35,12,5,24,2,male
124 ms,124,18600 KB,18600,Kenya,Africa,62,334,310.1726115,1988.701568,54.26086957,107908.6764,68,60,59,8,1,14,2,male
124 ms,124,15300 KB,15300,India,Asia,61,319,306.0981941,1891.905211,46.125,87264.12784,63,57,54,6,3,13,2,male
561 ms,561,17600 KB,17600,India,Asia,51,257,241.523656,1457.813313,24.75,36080.87949,58,54,52,4,2,14,3,male
108 ms,108,11700 KB,11700,China,Asia,63,443,314.4992626,2647.935006,42,111213.2703,67,61,61,6,0,25,2,female
483 ms,483,16600 KB,16600,India,Asia,63,312,314.9612072,1864.911336,38.42307692,71655.63172,62,51,51,11,0,13,2,male
124 ms,124,17200 KB,17200,India,Asia,47,269,227.9505705,1494.184401,21.11111111,31543.89291,57,45,41,12,4,11,2,male
327 ms,327,23500 KB,23500,China,Asia,49,322,229.4868683,1807.93657,27.29411765,49346.03343,76,61,61,15,0,14,3,female
561 ms,561,19600 KB,19600,India,Asia,53,282,253.6843594,1615.273568,30.42105263,49138.32223,57,52,52,5,0,12,2,male
514 ms,514,31200 KB,31200,Ukraine,Europe,38,278,188.1173001,1458.923849,18,26260.62928,59,46,41,13,5,16,2,male
139 ms,139,14600 KB,14600,China,Asia,65,444,326.7316235,2673.931309,30.91666667,82669.04297,48,44,44,4,0,30,5,male
530 ms,530,18600 KB,18600,India,Asia,46,334,215.9932866,1844.869693,19.83333333,36589.91558,91,85,85,6,0,14,1,male
109 ms,109,19200 KB,19200,India,Asia,56,325,272.5558619,1887.39035,27.9,52658.19076,71,44,35,27,9,13,2,male
93 ms,93,19200 KB,19200,India,Asia,53,293,254.5835556,1678.280693,30.13888889,50581.51534,54,42,39,12,3,13,2,male
561 ms,561,17600 KB,17600,India,Asia,47,241,222.5444556,1338.655913,24.79166667,33187.51118,59,46,38,13,8,12,2,male
93 ms,93,31700 KB,31700,India,Asia,60,308,295.6213103,1819.322303,41.3,75138.01113,79,66,64,13,2,10,2,male
93 ms,93,19300 KB,19300,Vietnam,Asia,64,348,322.2270913,2088,39,81432,53,33,24,20,9,18,3,male
389 ms,389,18200 KB,18200,China,Asia,57,312,278.3559659,1819.861684,42.85714286,77994.07219,72,53,43,19,10,14,3,female
561 ms,561,17600 KB,17600,India,Asia,61,303,301.7363383,1797.013413,35.67307692,64104.99772,79,75,73,4,2,12,3,male
93 ms,93,19200 KB,19200,India,Asia,0,0,0,0,0,0,56,45,43,11,2,13,2,male
343 ms,343,41000 KB,41000,Bangladesh,Asia,41,278,208.1306865,1489.399457,19.5,29043.28942,49,43,43,6,0,14,2,male
576 ms,576,15700 KB,15700,China,Asia,47,266,221.0794529,1477.520635,32.69230769,48303.55921,57,54,53,3,1,13,2,male
498 ms,498,19300 KB,19300,Vietnam,Asia,66,353,335.7560369,2133.671124,41,87480.51609,53,32,23,21,9,18,3,male
576 ms,576,18600 KB,18600,India,Asia,72,298,372.2346001,1838.63765,28.5,52401.17304,50,47,46,3,1,13,2,male
171 ms,171,17700 KB,17700,United States,North America,54,292,260.2355283,1680.427151,27.63157895,46432.85548,64,54,48,10,6,14,3,male
93 ms,93,12000 KB,12000,China,Asia,66,431,333.6312234,2605.133865,35.72413793,93066.16154,66,61,61,5,0,21,1,male
124 ms,124,23100 KB,23100,Indonesia,Asia,45,316,214.6466251,1735.425578,28,48591.9162,52,41,37,11,4,10,2,male
109 ms,109,32800 KB,32800,India,Asia,38,266,188.1173001,1395.948719,18,25127.07693,67,64,64,3,0,9,2,male
124 ms,124,18200 KB,18200,India,Asia,57,312,279.1883364,1819.861684,45.325,82485.23085,66,57,56,9,1,12,4,male
124 ms,124,21800 KB,21800,India,Asia,57,301,279.1883364,1755.699894,45.325,79577.09771,66,56,55,10,1,12,4,male
561 ms,561,90000 KB,90000,India,Asia,0,0,0,0,0,0,80,61,50,19,11,11,3,male
108 ms,108,19200 KB,19200,India,Asia,44,264,204.5187537,1441.289947,25.5,36752.89366,67,56,49,11,7,14,3,male
93 ms,93,18700 KB,18700,Unknown,Unknown,62,333,310.1726115,1982.747371,44.93478261,89094.3221,70,47,42,23,5,13,2,male
561 ms,561,31000 KB,31000,India,Asia,32,241,149.2067179,1205,15,18075,74,67,66,7,1,11,2,female
529 ms,529,16500 KB,16500,China,Asia,73,398,379.6596322,2463.550174,67.265625,165712.2422,46,40,39,6,1,19,2,male
93 ms,93,21500 KB,21500,China,Asia,62,381,311.8982981,2268.548794,29.28571429,66436.07183,45,38,38,7,0,14,3,male
405 ms,405,19600 KB,19600,Ukraine,Europe,45,289,206.8830545,1587.145545,29.89285714,47444.31504,58,36,31,22,5,13,2,male
389 ms,389,18200 KB,18200,India,Asia,59,322,290.159225,1894.211062,32.08695652,60779.46799,68,58,54,10,4,13,3,male
124 ms,124,23100 KB,23100,India,Asia,61,306,308.3880345,1814.805625,40.61111111,73701.27289,71,47,37,24,10,11,3,male
93 ms,93,18200 KB,18200,India,Asia,53,289,254.5835556,1655.369011,28.19444444,46672.20963,57,52,51,5,1,14,3,male
545 ms,545,18600 KB,18600,Bangladesh,Asia,55,281,267.8084246,1624.56208,34.94444444,56769.41933,52,43,39,9,4,11,2,male
390 ms,390,18200 KB,18200,India,Asia,53,287,254.5835556,1643.91317,28.19444444,46349.21856,58,52,50,6,2,14,3,male
187 ms,187,9400 KB,9400,Iran,Asia,71,385,365.8862514,2367.652641,66.21212121,156767.3037,58,46,43,12,3,13,1,male
389 ms,389,17200 KB,17200,India,Asia,58,328,285.8598074,1921.417766,35.15,67537.83449,86,63,49,23,14,12,3,male
140 ms,140,16200 KB,16200,Egypt,AsiaAfrica,73,346,378.8670746,2141.679297,33.40277778,71538.03764,53,41,39,12,2,13,2,male
124 ms,124,6400 KB,6400,Sweden,Europe,38,240,184.2797931,1259.502603,17.5,22041.29556,69,49,38,20,11,8,2,male
186 ms,186,15700 KB,15700,China,Asia,83,553,446.8336245,3525.396806,47.05434783,165885.2475,55,13,10,42,3,9,2,male
404 ms,404,27000 KB,27000,India,Asia,65,340,327.8032081,2047.605056,40.11111111,82131.71393,60,55,52,5,3,12,3,male
187 ms,187,15700 KB,15700,China,Asia,83,553,446.8336245,3525.396806,47.05434783,165885.2475,55,13,10,42,3,9,2,male
93 ms,93,18200 KB,18200,India,Asia,53,289,254.5835556,1655.369011,28.19444444,46672.20963,62,52,46,10,6,14,3,male
156 ms,156,17700 KB,17700,India,Asia,53,289,254.5835556,1655.369011,28.19444444,46672.20963,62,52,46,10,6,14,3,male
108 ms,108,21800 KB,21800,India,Asia,53,289,254.5835556,1655.369011,28.19444444,46672.20963,62,52,46,10,6,14,3,male
108 ms,108,18200 KB,18200,India,Asia,53,289,254.5835556,1655.369011,28.19444444,46672.20963,62,52,46,10,6,14,3,male
607 ms,607,19300 KB,19300,Iran,Asia,78,516,412.5946318,3243.267545,84,272434.4738,47,35,32,12,3,18,3,male
156 ms,156,17700 KB,17700,India,Asia,53,289,254.5835556,1655.369011,28.19444444,46672.20963,62,52,46,10,6,14,3,male
576 ms,576,29400 KB,29400,India,Asia,51,334,243.5249056,1894.590064,38.28125,72527.2759,85,80,77,5,3,15,2,male
108 ms,108,18200 KB,18200,Vietnam,Asia,53,289,254.5835556,1655.369011,28.19444444,46672.20963,62,52,46,10,6,14,3,male
93 ms,93,18200 KB,18200,India,Asia,53,289,254.5835556,1655.369011,28.19444444,46672.20963,62,52,46,10,6,14,3,male
140 ms,140,17700 KB,17700,India,Asia,53,289,254.5835556,1655.369011,28.19444444,46672.20963,62,52,46,10,6,14,3,male
108 ms,108,18200 KB,18200,Unknown,Unknown,53,289,254.5835556,1655.369011,28.19444444,46672.20963,62,52,46,10,6,14,3,male
108 ms,108,18200 KB,18200,India,Asia,53,289,254.5835556,1655.369011,28.19444444,46672.20963,62,52,46,10,6,14,3,male
93 ms,93,18200 KB,18200,India,Asia,53,289,254.5835556,1655.369011,28.19444444,46672.20963,62,52,46,10,6,14,3,male
108 ms,108,18200 KB,18200,India,Asia,53,289,254.5835556,1655.369011,28.19444444,46672.20963,62,52,46,10,6,14,3,male
108 ms,108,18200 KB,18200,India,Asia,53,289,254.5835556,1655.369011,28.19444444,46672.20963,62,52,46,10,6,14,3,male
93 ms,93,18200 KB,18200,India,Asia,53,289,254.5835556,1655.369011,28.19444444,46672.20963,62,52,46,10,6,14,3,male
93 ms,93,18200 KB,18200,India,Asia,53,289,254.5835556,1655.369011,28.19444444,46672.20963,62,52,46,10,6,14,3,male
108 ms,108,18200 KB,18200,India,Asia,53,289,254.5835556,1655.369011,28.19444444,46672.20963,62,52,46,10,6,14,3,male
109 ms,109,18200 KB,18200,Romania,Europe,53,289,254.5835556,1655.369011,28.19444444,46672.20963,62,52,46,10,6,14,3,male
109 ms,109,18200 KB,18200,Ukraine,Europe,53,289,254.5835556,1655.369011,28.19444444,46672.20963,62,52,46,10,6,14,3,male
109 ms,109,18200 KB,18200,Singapore,Asia,53,289,254.5835556,1655.369011,28.19444444,46672.20963,62,52,46,10,6,14,3,male
108 ms,108,21800 KB,21800,India,Asia,53,289,254.5835556,1655.369011,28.19444444,46672.20963,62,52,46,10,6,14,3,male
108 ms,108,21800 KB,21800,India,Asia,53,289,254.5835556,1655.369011,28.19444444,46672.20963,62,52,46,10,6,14,3,male
109 ms,109,18200 KB,18200,India,Asia,53,289,254.5835556,1655.369011,28.19444444,46672.20963,62,52,46,10,6,14,3,male
93 ms,93,18200 KB,18200,India,Asia,53,289,254.5835556,1655.369011,28.19444444,46672.20963,62,52,46,10,6,14,3,male
109 ms,109,18200 KB,18200,India,Asia,53,289,254.5835556,1655.369011,28.19444444,46672.20963,62,52,46,10,6,14,3,male
93 ms,93,18200 KB,18200,India,Asia,53,289,254.5835556,1655.369011,28.19444444,46672.20963,62,52,46,10,6,14,3,male
108 ms,108,21800 KB,21800,India,Asia,53,289,254.5835556,1655.369011,28.19444444,46672.20963,62,52,46,10,6,14,3,male
109 ms,109,18200 KB,18200,Iran,Asia,53,289,254.5835556,1655.369011,28.19444444,46672.20963,62,52,46,10,6,14,3,male
62 ms,62,11600 KB,11600,China,Asia,73,450,378.8670746,2785.421051,41.83783784,116535.9943,77,0,-11,77,11,0,3,male
124 ms,124,16200 KB,16200,Unknown,Unknown,55,304,271.4804827,1757.533353,38.66666667,67957.95631,65,49,40,16,9,12,3,male
93 ms,93,18300 KB,18300,India,Asia,48,343,229.1368501,1915.642138,21,40228.48489,93,87,87,6,0,14,1,male
124 ms,124,15300 KB,15300,India,Asia,59,279,290.8572701,1641.257411,36.15909091,59346.37592,49,44,44,5,0,10,2,male
171 ms,171,18600 KB,18600,Brazil,South America,69,309,352.7497745,1887.534057,26.59375,50196.60883,59,44,36,15,8,11,3,male
390 ms,390,18500 KB,18500,India,Asia,64,415,320.7232379,2490,50.14285714,124855.7143,75,70,70,5,0,19,2,male
561 ms,561,17600 KB,17600,India,Asia,53,358,252.9035678,2050.595523,28.05,57519.20441,54,47,42,7,5,14,2,male
124 ms,124,27000 KB,27000,Taiwan,Asia,64,392,321.6326782,2352,48.96153846,115157.5385,56,37,37,19,0,10,3,male
608 ms,608,16600 KB,16600,Ukraine,Europe,80,455,426.079159,2876.477283,70.55813953,202958.8855,61,44,34,17,10,17,3,male
109 ms,109,21100 KB,21100,India,Asia,0,0,0,0,0,0,61,40,37,21,3,12,2,male
93 ms,93,17200 KB,17200,Bangladesh,Asia,67,340,339.9564924,2062.470325,38.23333333,78855.11542,63,51,50,12,1,9,2,male
592 ms,592,26400 KB,26400,India,Asia,39,288,187.5249056,1522.195839,21.875,33298.03398,60,57,57,3,0,16,3,male
155 ms,155,18200 KB,18200,Vietnam,Asia,49,264,232.8278745,1482.283399,38.75,57438.48171,67,49,33,18,16,12,4,male
592 ms,592,17600 KB,17600,Bangladesh,Asia,57,287,278.3559659,1674.039434,36.85714286,61700.31057,63,57,53,6,4,12,4,male
280 ms,280,12700 KB,12700,Syria,Asia,58,439,284.2247957,2571.653657,38.45454545,98891.77244,75,69,68,6,1,28,2,male
93 ms,93,18200 KB,18200,India,Asia,53,289,254.5835556,1655.369011,28.19444444,46672.20963,64,52,44,12,8,14,3,male
124 ms,124,23100 KB,23100,India,Asia,59,304,289.0701413,1788.323487,42.16,75395.71821,64,51,42,13,9,12,3,male
420 ms,420,18200 KB,18200,India,Asia,50,288,239.420269,1625.430583,25.71428571,41796.78641,60,45,41,15,4,13,2,male
358 ms,358,21800 KB,21800,India,Asia,58,300,284.9884404,1757.394299,29.95238095,52638.14351,64,55,55,9,0,12,3,female
109 ms,109,12000 KB,12000,China,Asia,67,474,339.5249056,2875.326276,38.28125,110071.084,55,0,0,55,0,0,3,female
124 ms,124,21800 KB,21800,India,Asia,60,284,297.5287411,1677.556929,30.22727273,50707.97081,58,52,52,6,0,13,3,male
576 ms,576,7700 KB,7700,Armenia,Europe,56,357,271.0812322,2073.225707,44.81818182,92918.20669,64,53,50,11,3,15,2,male
390 ms,390,18200 KB,18200,India,Asia,50,260,242.4407955,1467.402609,28.5,41820.97437,69,65,64,4,1,12,3,male
467 ms,467,19400 KB,19400,Croatia,Europe,56,420,269.6764904,2439.089067,45.88,111905.4064,87,72,62,15,10,17,2,male
560 ms,560,17600 KB,17600,India,Asia,51,263,240.7106228,1491.847865,27.78947368,41457.66698,56,51,51,5,0,10,2,male
436 ms,436,26000 KB,26000,China,Asia,52,385,254.2364029,2194.669291,28.5,62548.07481,60,51,51,9,0,19,2,male
545 ms,545,21500 KB,21500,Georgia,AsiaEurope,58,345,283.0128366,2021.003443,38.95833333,78734.92581,64,52,50,12,2,14,1,male
124 ms,124,19200 KB,19200,Egypt,AsiaAfrica,60,306,296.7916995,1807.508522,41.82608696,75601.00863,58,40,31,18,9,11,4,male
545 ms,545,21500 KB,21500,India,Asia,45,318,208.1057163,1746.409285,40.61538462,70931.08479,89,56,31,33,25,16,3,male
140 ms,140,16700 KB,16700,China,Asia,69,344,353.7585727,2101.332413,43.44827586,91299.27036,63,49,42,14,7,12,2,male
124 ms,124,19600 KB,19600,China,Asia,81,550,433.2506894,3486.917502,44,153424.3701,55,41,38,14,3,17,2,female
561 ms,561,18600 KB,18600,Unknown,Unknown,53,321,256.7497745,1838.662466,37,68030.51124,100,54,19,46,35,14,3,male
108 ms,108,27000 KB,27000,India,Asia,42,280,201.6270751,1509.848878,21,31706.82645,69,51,47,18,4,14,3,male
561 ms,561,18500 KB,18500,Peru,South America,49,336,229.4868683,1886.542508,22.58823529,42613.66605,75,66,64,9,2,11,1,male
561 ms,561,14600 KB,14600,India,Asia,51,341,244.720659,1934.297042,34.8,67313.53705,81,79,79,2,0,17,2,male
109 ms,109,19200 KB,19200,Unknown,Unknown,59,351,289.5640056,2064.80771,35.72916667,73773.85882,74,43,31,31,12,14,3,male
608 ms,608,23500 KB,23500,Egypt,AsiaAfrica,45,293,209.4845559,1609.112957,41.25,66375.90949,54,46,41,8,5,17,3,male
374 ms,374,12700 KB,12700,India,Asia,42,287,199.17639,1547.5951,32.5,50296.84076,60,46,37,14,9,14,2,male
577 ms,577,15700 KB,15700,India,Asia,44,273,200.5096868,1490.424832,33.21428571,49503.3962,50,43,38,7,5,10,2,male
374 ms,374,15200 KB,15200,Iran,Asia,62,340,307.9068682,2024.426746,46.66666667,94473.24812,50,42,38,8,4,13,2,female
77 ms,77,11800 KB,11800,China,Asia,66,380,333.6312234,2296.869765,45.93103448,105497.6044,70,0,0,70,0,0,2,female
124 ms,124,15300 KB,15300,Poland,Europe,65,310,327.8032081,1866.934022,38,70943.49284,65,44,29,21,15,10,2,male
327 ms,327,22500 KB,22500,China,Asia,51,330,242.4606049,1871.900363,27,50541.3098,83,67,67,16,0,13,3,female
139 ms,139,20200 KB,20200,India,Asia,61,316,302.7888745,1874.112999,33.14583333,62119.0371,45,30,29,15,1,9,2,male
108 ms,108,27000 KB,27000,India,Asia,49,254,231.5770955,1426.1363,34,48488.63421,69,51,38,18,13,13,2,male
405 ms,405,22100 KB,22100,Iran,Asia,62,353,310.1726115,2101.831298,47.47826087,99791.29465,77,48,35,29,13,9,2,female
436 ms,436,16600 KB,16600,China,Asia,75,404,392.2479866,2516.442751,52,130855.023,58,0,-5,58,5,0,2,male
62 ms,62,13700 KB,13700,Unknown,Unknown,77,520,405.551932,3258.729001,56.02564103,182572.3812,56,48,45,8,3,26,1,male
374 ms,374,19200 KB,19200,Bangladesh,Asia,48,271,226.2767055,1513.524838,36.42857143,55135.54766,67,50,45,17,5,14,3,male
592 ms,592,17600 KB,17600,India,Asia,63,439,314.1308434,2624.025886,56.25,147601.4561,67,62,59,5,3,19,3,male
560 ms,560,25700 KB,25700,India,Asia,51,356,246.0527434,2019.383422,23.78571429,48032.4771,52,30,29,22,1,10,2,male
109 ms,109,27000 KB,27000,India,Asia,49,303,234.2230164,1701.257083,30.46153846,51822.90806,70,52,50,18,2,13,3,male
109 ms,109,19600 KB,19600,Tajikistan,Asia,53,282,255.6041684,1615.273568,41.29411765,66701.29676,78,57,44,21,13,13,3,male
186 ms,186,18700 KB,18700,Bangladesh,Asia,61,313,301.7363383,1856.320787,40.38461538,74966.801,59,52,47,7,5,11,3,male
93 ms,93,6800 KB,6800,China,Asia,79,411,420.1071259,2590.853888,37.77777778,97876.70242,51,38,36,13,2,21,3,male
124 ms,124,23100 KB,23100,India,Asia,40,307,201.4212455,1633.831925,19,31042.80658,76,58,52,18,6,12,2,female
62 ms,62,16500 KB,16500,Unknown,Unknown,96,658,540.5307358,4332.905325,57.9,250875.2183,34,29,29,5,0,24,2,female
607 ms,607,19500 KB,19500,India,Asia,62,353,310.1726115,2101.831298,33.06521739,69497.50877,56,50,46,6,4,15,2,male
124 ms,124,18200 KB,18200,India,Asia,62,333,309.4603455,1982.747371,38,75344.40011,71,61,57,10,4,13,3,male
374 ms,374,18200 KB,18200,India,Asia,55,295,265.9634675,1705.501115,27.125,46261.71776,81,66,56,15,10,12,3,male
108 ms,108,44500 KB,44500,India,Asia,70,350,359.4212455,2145.249056,33.84375,72603.27274,62,44,41,18,3,10,3,male
514 ms,514,10800 KB,10800,China,Asia,58,370,283.5668306,2167.452968,36.52173913,79159.15188,73,61,60,12,1,22,2,male
499 ms,499,10800 KB,10800,China,Asia,58,370,283.5668306,2167.452968,36.52173913,79159.15188,73,61,60,12,1,22,2,male
701 ms,701,13100 KB,13100,India,Asia,50,369,239.420269,2082.582934,27,56229.73922,112,75,45,37,30,17,2,male
389 ms,389,18200 KB,18200,India,Asia,59,294,290.8572701,1729.497057,33.63636364,58173.9919,59,54,53,5,1,13,2,female
483 ms,483,20500 KB,20500,Bangladesh,Asia,60,301,295.1851693,1777.974069,39.23076923,69751.29041,59,49,44,10,5,11,3,male
576 ms,576,21500 KB,21500,India,Asia,57,293,278.3559659,1709.036774,33.42857143,57130.65788,76,54,46,22,8,9,2,male
93 ms,93,18200 KB,18200,Malaysia,Asia,53,296,254.5835556,1695.464455,28.19444444,47802.67837,67,56,49,11,7,14,3,male
592 ms,592,30300 KB,30300,Kuwait,Asia,72,451,372.2746801,2782.636176,35.94285714,100015.8945,81,71,70,10,1,8,2,male
358 ms,358,15700 KB,15700,India,Asia,50,247,235.05865,1394.032479,29.33333333,40891.61938,62,48,36,14,12,9,2,male
561 ms,561,22500 KB,22500,Lebanon,Asia,62,327,310.1726115,1947.022193,39.84782609,77584.60175,59,44,36,15,8,12,2,male
452 ms,452,16600 KB,16600,China,Asia,75,402,392.2479866,2503.985114,52,130207.2259,59,0,-5,59,5,0,2,male
592 ms,592,20600 KB,20600,Unknown,Unknown,59,305,290.159225,1794.20613,43.82608696,78633.03387,62,51,46,11,5,14,2,male
93 ms,93,10000 KB,10000,Poland,Europe,72,399,372.5956925,2461.800076,44.31818182,109102.5033,60,41,33,19,8,16,3,male
93 ms,93,10000 KB,10000,Poland,Europe,73,400,379.3421297,2475.929824,45.45454545,112542.2647,60,41,33,19,8,16,3,male
577 ms,577,39600 KB,39600,Bangladesh,Asia,57,330,278.3559659,1924.853705,44.57142857,85793.47941,58,54,52,4,2,10,2,male
109 ms,109,31900 KB,31900,Turkey,AsiaEurope,46,291,219.336581,1607.356529,30.6,49185.10979,56,36,36,20,0,10,2,male
561 ms,561,17600 KB,17600,India,Asia,68,391,347.0121354,2380.197971,55.13793103,131239.1916,73,67,65,6,2,17,3,male
93 ms,93,11800 KB,11800,China,Asia,77,520,405.6268983,3258.729001,64.32432432,209615.5412,53,6,6,47,0,4,1,male
109 ms,109,27900 KB,27900,India,Asia,65,386,327.8032081,2324.633976,40.11111111,93243.6517,65,46,44,19,2,14,2,female
561 ms,561,21500 KB,21500,India,Asia,55,269,264.5725015,1555.185763,28.5,44322.79424,80,64,50,16,14,10,2,male
124 ms,124,18900 KB,18900,Egypt,AsiaAfrica,53,279,256.7497745,1598.089807,26.59375,42499.2008,57,53,51,4,2,12,2,male
545 ms,545,17600 KB,17600,India,Asia,61,439,301.7363383,2603.593691,53.84615385,140193.5064,69,63,63,6,0,16,1,male
93 ms,93,18200 KB,18200,India,Asia,56,285,270.5069309,1655.096153,29.41304348,48681.4151,59,40,38,19,2,11,3,male
109 ms,109,29900 KB,29900,India,Asia,34,255,162,1297.303025,16,20756.84839,83,70,68,13,2,9,2,male
109 ms,109,24500 KB,24500,China,Asia,66,467,333.1049912,2822.732054,54.75806452,154567.3439,75,49,36,26,13,21,4,male
93 ms,93,20400 KB,20400,India,Asia,62,329,310.1726115,1958.930586,43.23913043,84702.45513,82,54,39,28,15,13,2,male
390 ms,390,18900 KB,18900,India,Asia,58,287,284.2247957,1681.240546,36,60524.65964,68,51,47,17,4,11,3,male
545 ms,545,25100 KB,25100,Ukraine,Europe,73,407,380.0574174,2519.258595,44.03225806,110928.6446,74,52,44,22,8,17,2,male
77 ms,77,10800 KB,10800,China,Asia,93,550,517.9616502,3596.537346,61.11607143,219806.2333,46,0,-2,46,2,0,2,male
577 ms,577,26400 KB,26400,Unknown,Unknown,56,251,273.4603973,1457.646085,28.23684211,41159.32236,52,28,28,24,0,9,2,male
405 ms,405,74100 KB,74100,India,Asia,40,253,197.504662,1346.447808,24.66666667,33212.37926,58,48,45,10,3,11,3,male
561 ms,561,19300 KB,19300,Vietnam,Asia,82,412,439.3544556,2619.311426,34.28571429,89804.96317,38,22,22,16,0,14,3,male
576 ms,576,21500 KB,21500,India,Asia,69,361,352.582306,2205.177329,34.90909091,76980.73585,73,55,51,18,4,9,2,female
93 ms,93,33700 KB,33700,South Korea,Asia,50,395,240.8554909,2229.323195,24.19230769,53932.47268,59,46,39,13,7,24,1,male
389 ms,389,18600 KB,18600,India,Asia,64,347,321.6326782,2082,35.80769231,74551.61538,80,62,57,18,5,15,3,male
109 ms,109,22600 KB,22600,Moldova,Asia,67,405,340.3026944,2456.766122,73.37931034,180275.8037,74,65,65,9,0,17,3,male
561 ms,561,21300 KB,21300,Bangladesh,Asia,57,317,277.6324012,1849.026134,31.81818182,58832.64973,65,48,42,17,6,12,3,male
93 ms,93,19200 KB,19200,India,Asia,66,381,335.0885565,2302.914159,33.84615385,77944.78694,74,51,46,23,5,10,2,male
93 ms,93,23100 KB,23100,Egypt,AsiaAfrica,54,305,263.4212455,1755.240688,34.4375,60446.1012,48,40,40,8,0,9,2,male
93 ms,93,20200 KB,20200,Unknown,Unknown,52,316,251.3531335,1801.338951,32.06666667,57762.93569,73,49,39,24,10,13,3,female
109 ms,109,30400 KB,30400,South Korea,Asia,72,551,372.3949821,3399.628676,59.23529412,201378.0045,54,45,43,9,2,22,1,male
124 ms,124,15300 KB,15300,Unknown,Unknown,66,311,334.0271833,1879.806571,42.75,80361.73092,63,42,33,21,9,13,3,male
109 ms,109,25000 KB,25000,India,Asia,44,274,217.740327,1495.884264,23.4,35003.69177,72,49,43,23,6,10,2,male
156 ms,156,16100 KB,16100,Kazakhstan,AsiaEurope,71,378,366.1306865,2324.604411,44.484375,103408.5744,64,39,32,25,7,13,4,male
389 ms,389,75100 KB,75100,China,Asia,41,376,204.176133,2014.439554,19,38274.35152,50,35,31,15,4,19,2,male
109 ms,109,26000 KB,26000,India,Asia,37,315,181.5249056,1640.97781,17.5,28717.11168,77,58,58,19,0,13,2,male
577 ms,577,30400 KB,30400,China,Asia,66,466,333.3240179,2816.68766,64.8,182521.3603,53,49,49,4,0,19,3,male
530 ms,530,21500 KB,21500,India,Asia,49,262,228.6387356,1471.053979,29.27777778,43069.1915,72,67,64,5,3,11,3,male
420 ms,420,23000 KB,23000,India,Asia,49,323,235.7693245,1813.55128,33.91666667,61509.61423,87,61,50,26,11,16,2,male
124 ms,124,15300 KB,15300,Brazil,South America,53,308,256.7497745,1764.1995,39.3125,69355.09284,73,42,28,31,14,9,2,male
389 ms,389,50500 KB,50500,China,Asia,51,274,243.5249056,1554.244544,32.8125,50998.64909,64,57,54,7,3,12,2,male
171 ms,171,17700 KB,17700,Malaysia,Asia,55,341,267.8084246,1971.443662,37,72943.41551,78,53,45,25,8,15,4,male
108 ms,108,20200 KB,20200,Unknown,Unknown,53,324,258.0246044,1855.846227,32.93333333,61119.20242,73,51,43,22,8,14,3,female
109 ms,109,8400 KB,8400,Croatia,Europe,62,289,310.1726115,1720.762734,37.30434783,64191.93154,70,40,22,30,18,8,2,female
93 ms,93,18600 KB,18600,Tunisia,Africa,72,323,373.2397178,1992.885775,42.32258065,84344.06895,60,52,49,8,3,13,2,female
124 ms,124,16100 KB,16100,China,Asia,66,344,333.3240179,2079.271577,55.2,114775.7911,48,45,45,3,0,12,1,female
639 ms,639,17600 KB,17600,India,Asia,69,368,352.582306,2247.937,30.54545455,68664.25746,56,48,44,8,4,12,2,female
109 ms,109,16100 KB,16100,China,Asia,66,344,333.3240179,2079.271577,55.2,114775.7911,48,45,45,3,0,12,1,female
61 ms,61,11800 KB,11800,China,Asia,94,545,522.4078007,3572.250924,40.48,144604.7174,46,32,32,14,0,21,3,female
109 ms,109,36400 KB,36400,Kazakhstan,AsiaEurope,53,342,256.7497745,1958.948795,26.59375,52095.79453,72,44,36,28,8,10,2,female
545 ms,545,22500 KB,22500,India,Asia,56,287,272.5558619,1666.710863,36.9,61501.63083,69,57,50,12,7,12,3,female
733 ms,733,32100 KB,32100,China,Asia,53,397,259.4336554,2273.98442,36.21428571,82350.72151,52,37,32,15,5,16,2,female
93 ms,93,10800 KB,10800,China,Asia,69,456,353.0013311,2785.487152,64.96774194,180966.8105,74,0,-6,74,6,0,2,female
78 ms,78,11800 KB,11800,China,Asia,82,487,439.460071,3096.127826,51.69767442,160062.6083,60,0,-3,60,3,0,2,female
639 ms,639,19600 KB,19600,China,Asia,80,450,428.700868,2844.867643,33.98387097,96679.61489,43,30,30,13,0,22,8,female
139 ms,139,12300 KB,12300,Finland,Europe,83,529,446.8336245,3372.395859,67.9673913,229212.949,74,57,47,17,10,16,3,female
93 ms,93,18200 KB,18200,India,Asia,0,0,0,0,0,0,83,71,71,12,0,14,3,female
482 ms,482,25400 KB,25400,China,Asia,57,302,280.1318683,1761.532784,38,66938.2458,62,45,43,17,2,12,3,female
436 ms,436,17500 KB,17500,Romania,Europe,64,354,320.7232379,2124,27.64285714,58713.42857,67,55,52,12,3,21,1,female
514 ms,514,19500 KB,19500,Egypt,AsiaAfrica,60,346,296.1564001,2043.784146,37.5,76641.90548,68,57,49,11,8,16,2,female
155 ms,155,35200 KB,35200,Japan,Asia,70,431,359.2147805,2641.72098,38.12121212,100705.6059,50,48,48,2,0,26,3,female
530 ms,530,27300 KB,27300,India,Asia,45,314,211.0274844,1724.441872,20.09090909,34645.60489,87,82,81,5,1,18,4,female
576 ms,576,21500 KB,21500,India,Asia,64,319,320.7232379,1914,35.35714286,67673.57143,72,55,52,17,3,12,3,female
140 ms,140,15700 KB,15700,Finland,Europe,77,535,406.0022373,3352.730799,59.58333333,199766.8768,64,53,53,11,0,17,2,female
109 ms,109,17600 KB,17600,China,Asia,103,658,588.8198034,4399.717347,73.07258065,321498.7006,56,34,34,22,0,20,3,female
140 ms,140,1000 KB,1000,Bangladesh,Asia,63,380,314.9612072,2271.366371,35.57692308,80808.22666,58,51,50,7,1,19,1,female
639 ms,639,30200 KB,30200,India,Asia,49,331,235.7693245,1858.468958,26.20833333,48707.37395,72,61,55,11,6,18,2,female
1154 ms,1154,19500 KB,19500,China,Asia,77,499,405.551932,3127.126484,73.89473684,231078.1886,79,55,35,24,20,21,3,female
93 ms,93,19200 KB,19200,Russia,AsiaEurope,56,279,272.5558619,1620.252023,28.8,46663.25827,85,55,36,30,19,14,3,female
529 ms,529,11700 KB,11700,India,Asia,79,539,419.0808777,3397.737823,57.46341463,195245.6174,90,69,68,21,1,18,2,female
93 ms,93,11800 KB,11800,China,Asia,84,504,453.2640759,3221.727981,51.13333333,164737.6908,69,0,-3,69,3,0,2,female
405 ms,405,42100 KB,42100,India,Asia,70,487,359.7107722,2984.960829,41.51612903,123924.0189,79,60,56,19,4,20,2,female
93 ms,93,28800 KB,28800,China,Asia,86,641,469.3966019,4119.235708,40.53846154,166987.4783,85,76,75,9,1,21,1,female
109 ms,109,30900 KB,30900,India,Asia,67,378,340.3026944,2292.981714,41.93103448,96147.09532,86,61,58,25,3,11,3,female
546 ms,546,17500 KB,17500,China,Asia,63,424,316.1697866,2534.366688,40.625,102958.6467,85,64,60,21,4,19,3,female
436 ms,436,21100 KB,21100,China,Asia,62,382,308.3287327,2274.502991,29.07692308,66135.54849,88,0,-12,88,12,0,3,female
62 ms,62,11800 KB,11800,China,Asia,93,566,516.0824975,3701.163887,35.08653846,129861.0291,81,53,51,28,2,19,3,female
78 ms,78,11800 KB,11800,China,Asia,86,595,466.9609738,3823.627529,77.39130435,295915.5218,60,54,54,6,0,21,4,female
109 ms,109,8400 KB,8400,Croatia,Europe,77,352,405.551932,2205.908862,33.86842105,74710.65015,74,45,28,29,17,8,2,female
109 ms,109,13700 KB,13700,China,Asia,81,550,432.6080183,3486.917502,47.35714286,165130.4503,96,61,59,35,2,23,2,female
499 ms,499,13900 KB,13900,China,Asia,74,451,385.5385456,2800.463468,64.38888889,180318.7311,80,63,52,17,11,21,3,female
124 ms,124,27000 KB,27000,India,Asia,37,296,181.5249056,1541.998196,17.5,26984.96843,75,54,49,21,5,12,2,female
576 ms,576,19600 KB,19600,India,Asia,56,288,273.4603973,1672.518218,34.07894737,56997.66031,79,68,60,11,8,11,2,female
1684 ms,1684,24500 KB,24500,China,Asia,67,566,339.6973857,3433.406482,37.74193548,129583.4059,95,80,80,15,0,24,4,female
374 ms,374,21100 KB,21100,Kazakhstan,AsiaEurope,57,324,277.0156616,1889.856365,41.39130435,78223.61996,75,60,55,15,5,14,3,female
577 ms,577,30300 KB,30300,India,Asia,47,381,219.7679748,2116.298352,23.57142857,49884.17545,85,73,67,12,6,17,1,female
124 ms,124,14900 KB,14900,South Korea,Asia,85,503,459.8067162,3223.923641,62.45238095,201341.7074,75,50,46,25,4,20,1,female
233 ms,233,17600 KB,17600,Unknown,Unknown,76,529,398.842491,3305.153655,79,261107.1387,62,41,39,21,2,23,3,female
358 ms,358,67000 KB,67000,China,Asia,67,407,339.9564924,2468.898301,47.48333333,117231.521,83,50,42,33,8,13,2,female
561 ms,561,23400 KB,23400,India,Asia,55,373,267.8084246,2156.447173,49.33333333,106384.7272,64,53,52,11,1,18,1,female
530 ms,530,20600 KB,20600,Bangladesh,Asia,58,462,283.0128366,2706.38722,32.58333333,88183.11691,80,76,76,4,0,23,3,female
109 ms,109,32600 KB,32600,India,Asia,41,363,208.1306865,1944.791378,19.5,37923.43186,100,53,30,47,23,11,2,female
78 ms,78,34300 KB,34300,China,Asia,78,516,412.2983693,3243.267545,44.175,143271.3438,58,53,53,5,0,23,4,female
373 ms,373,21800 KB,21800,India,Asia,64,453,322.9162238,2718,57.5,156285,82,52,44,30,8,13,3,female
779 ms,779,9800 KB,9800,Iran,Asia,67,453,339.9564924,2747.938403,45.63333333,125397.5891,102,69,51,33,18,14,4,female
405 ms,405,18200 KB,18200,Belarus,Europe,52,266,252.7242144,1516.316965,29.85714286,45272.89224,89,51,32,38,19,13,2,female
405 ms,405,18200 KB,18200,Belarus,Europe,52,266,252.7242144,1516.316965,29.85714286,45272.89224,89,51,32,38,19,13,2,female
218 ms,218,233900 KB,233900,China,Asia,103,717,590.1306865,4794.220878,56.3671875,270236.7471,88,73,73,15,0,31,4,female
546 ms,546,17500 KB,17500,India,Asia,67,416,340.3026944,2523.493103,49.13793103,123999.2301,93,83,77,10,6,23,4,female
217 ms,217,32300 KB,32300,Unknown,Unknown,43,371,221.6596322,2013.144224,20.5,41269.45659,98,82,76,16,6,19,2,female
686 ms,686,20700 KB,20700,Bangladesh,Asia,69,447,354.26557,2730.510432,47.58928571,129943.0411,84,65,54,19,11,19,8,female
529 ms,529,27300 KB,27300,Georgia,AsiaEurope,54,356,259.4122985,2048.739951,55.25,113192.8823,79,73,70,6,3,16,1,female
545 ms,545,26300 KB,26300,China,Asia,49,383,239.3499675,2150.43387,25.35,54513.49861,79,69,65,10,4,17,4,female
358 ms,358,15600 KB,15600,China,Asia,76,489,399.1845378,3055.236554,39.82857143,121685.7073,85,16,5,69,11,10,1,female
140 ms,140,23100 KB,23100,India,Asia,60,431,300.3702549,2545.869847,45.31578947,115368.102,93,67,64,26,3,13,3,female
576 ms,576,22500 KB,22500,Russia,AsiaEurope,59,523,288.6764386,3076.622315,82.5,253821.341,79,64,57,15,7,19,2,female
389 ms,389,22000 KB,22000,China,Asia,67,513,341.2590864,3111.903755,37.03703704,115255.6946,94,63,62,31,1,19,2,female
93 ms,93,17600 KB,17600,China,Asia,74,476,386.9094701,2955.699802,61.72580645,182442.9539,88,63,55,25,8,20,5,female
171 ms,171,19600 KB,19600,China,Asia,91,627,502.5535519,4080.387239,57.75,235642.3631,67,56,55,11,1,22,3,female
93 ms,93,14700 KB,14700,Serbia,Europe,74,458,385.8508604,2843.929641,40.58823529,115430.0854,77,61,58,16,3,22,2,female
577 ms,577,18600 KB,18600,Russia,AsiaEurope,64,516,320.4063545,3096,80.86206897,250348.9655,85,78,74,7,4,27,2,female
670 ms,670,14900 KB,14900,Armenia,Europe,78,520,412.2983693,3268.409154,68.42105263,223627.9947,87,73,68,14,5,22,2,female
389 ms,389,21800 KB,21800,India,Asia,64,502,322.9162238,3012,57.5,173190,85,47,41,38,6,12,3,female
109 ms,109,15700 KB,15700,Ukraine,Europe,71,430,365.8862514,2644.391261,50.09090909,132459.9623,76,59,51,17,8,12,1,female
623 ms,623,26000 KB,26000,China,Asia,90,605,494.3950605,3927.571123,59.46808511,233565.1338,78,58,58,20,0,19,5,female
436 ms,436,28700 KB,28700,India,Asia,57,310,277.0156616,1808.195904,30.30434783,54796.19762,68,52,43,16,9,10,3,female
358 ms,358,11800 KB,11800,China,Asia,80,584,426.3322913,3692.006007,74.86363636,276396.9952,68,58,58,10,0,21,3,female
108 ms,108,26400 KB,26400,India,Asia,78,403,412.2613731,2533.017094,43,108919.7351,68,46,30,22,16,15,1,female
421 ms,421,26000 KB,26000,China,Asia,74,515,386.1246381,3197.868483,50.31818182,160910.9278,105,42,21,63,21,14,3,female
546 ms,546,28000 KB,28000,China,Asia,84,582,453.2640759,3720.32874,46.73076923,173853.8238,67,47,44,20,3,37,10,female
389 ms,389,26000 KB,26000,China,Asia,74,514,386.1246381,3191.65903,50.31818182,160598.4794,105,42,21,63,21,14,3,female
420 ms,420,26000 KB,26000,China,Asia,74,515,386.1246381,3197.868483,50.31818182,160910.9278,105,42,21,63,21,14,3,female
404 ms,404,26000 KB,26000,China,Asia,73,513,379.6596322,3175.379999,51.25,162738.2249,106,42,20,64,22,14,3,female
405 ms,405,26600 KB,26600,India,Asia,50,340,242.4407955,1918.911105,22.16666667,42535.86282,82,60,58,22,2,12,3,female
77 ms,77,15900 KB,15900,China,Asia,66,532,334.5126491,3215.617671,35.38888889,113797.1365,68,41,36,27,5,26,2,female
109 ms,109,30700 KB,30700,Belarus,Europe,43,366,221.6596322,1986.0129,20.5,40713.26445,114,54,25,60,29,14,3,female
78 ms,78,11400 KB,11400,China,Asia,86,542,466.7930215,3483.035497,67.42222222,234833.9933,77,39,29,38,10,18,2,female
592 ms,592,21300 KB,21300,Unknown,Unknown,21,52,75.60964047,228.400506,14.4,3288.967286,104,87,83,17,4,27,3,female
639 ms,639,19400 KB,19400,India,Asia,74,435,386.1246381,2701.112214,34.16666667,92288.00065,78,50,41,28,9,12,2,female
156 ms,156,15200 KB,15200,Russia,AsiaEurope,64,484,325.5680503,2904,46.07142857,133791.4286,165,98,38,67,60,21,7,female
389 ms,389,26000 KB,26000,India,Asia,50,443,240.8554909,2500.228292,35.57692308,88950.42962,91,47,35,44,12,9,2,female
421 ms,421,25700 KB,25700,China,Asia,144,852,900.2346001,6108.776101,56.5,345145.8497,61,45,45,16,0,46,10,female
389 ms,389,21500 KB,21500,Bangladesh,Asia,62,414,310.1726115,2465.037273,50.86956522,125395.3743,89,76,76,13,0,22,2,female
342 ms,342,15300 KB,15300,China,Asia,82,616,440.5905816,3916.252035,48.34285714,189322.8127,86,59,53,27,6,28,6,female
530 ms,530,24400 KB,24400,South Korea,Asia,89,683,487.7378322,4422.925933,67.90625,300344.3142,104,96,93,8,3,30,2,female
436 ms,436,28300 KB,28300,India,Asia,63,437,315.5176503,2612.071327,51.68,134991.8462,94,72,67,22,5,20,2,female
732 ms,732,55400 KB,55400,India,Asia,49,597,237.4749933,3351.981777,24.18181818,81057.01388,85,53,42,32,11,9,2,female
436 ms,436,43100 KB,43100,Russia,AsiaEurope,77,599,405.551932,3753.805138,85.18421053,319764.9271,100,70,58,30,12,23,6,female
296 ms,296,9800 KB,9800,Iran,Asia,61,362,303.4631705,2146.926916,49.56521739,106412.8993,81,54,43,27,11,11,1,female
217 ms,217,97900 KB,97900,Unknown,Unknown,92,624,508.9533246,4070.702661,90.03921569,366522.8749,89,66,56,23,10,21,5,female
655 ms,655,117500 KB,117500,South Korea,Asia,92,733,508.6701412,4781.770914,72.24,345435.1308,101,76,65,25,11,27,2,female
78 ms,78,14300 KB,14300,Lithuania,Europe,75,569,392.9423377,3544.197835,100.5454545,356352.9823,89,67,49,22,18,27,3,female
62 ms,62,18500 KB,18500,China,Asia,82,718,439.3192644,4564.722339,86,392566.1212,70,55,51,15,4,32,3,female
62 ms,62,11800 KB,11800,China,Asia,105,668,600.8285737,4485.116006,79.4137931,356180.0745,79,57,49,22,8,27,5,female
421 ms,421,15700 KB,15700,China,Asia,95,558,530.851908,3665.979429,50.90909091,186631.68,91,71,71,20,0,19,2,female
577 ms,577,15700 KB,15700,Ukraine,Europe,75,465,392.4020294,2896.400691,36.57142857,105925.511,96,54,48,42,6,11,3,female
140 ms,140,12700 KB,12700,China,Asia,81,752,433.6087556,4767.567202,66.95652174,319219.717,115,103,102,12,1,29,3,female
202 ms,202,24500 KB,24500,Russia,AsiaEurope,72,440,372.3949821,2714.767001,42.47058824,115297.7514,91,52,43,39,9,13,2,female
124 ms,124,29400 KB,29400,Vietnam,Asia,80,647,425.7903187,4090.287477,50.46153846,206402.1989,113,82,82,31,0,33,6,female
108 ms,108,6900 KB,6900,China,Asia,85,511,460.4869215,3275.198768,40.0212766,131077.6358,125,77,67,48,10,13,2,female
62 ms,62,12800 KB,12800,China,Asia,104,831,594.2093292,5568.065406,107.1610169,596679.5513,77,8,-2,69,10,11,3,female
62 ms,62,12800 KB,12800,China,Asia,104,831,594.2093292,5568.065406,107.1610169,596679.5513,77,8,-2,69,10,11,3,female
156 ms,156,27400 KB,27400,Bulgaria,Europe,75,502,392.9423377,3126.866983,80.18181818,250717.8799,104,73,51,31,22,23,4,female
93 ms,93,13700 KB,13700,China,Asia,95,758,533.19324,4979.950551,49.72881356,247647.0325,124,92,91,32,1,25,3,female
249 ms,249,48000 KB,48000,China,Asia,62,651,307.9068682,3876.181798,82.96296296,321579.527,106,68,58,38,10,19,3,female
78 ms,78,15000 KB,15000,China,Asia,85,620,459.8067162,3973.82238,54.69767442,217358.8428,116,80,80,36,0,20,3,female
638 ms,638,75300 KB,75300,Georgia,AsiaEurope,56,529,273.4603973,3072.090754,114.8947368,352967.0587,94,74,67,20,7,17,2,female
234 ms,234,112700 KB,112700,China,Asia,97,670,545.3518546,4421.941604,49.8245614,220321.301,93,70,67,23,3,28,4,female
390 ms,390,5900 KB,5900,Israel,Asia,76,456,398.9944238,2849.054946,47.77777778,136121.5141,81,59,54,22,5,7,2,female
78 ms,78,14800 KB,14800,China,Asia,82,505,439.3192644,3210.563762,45,144475.3693,80,66,61,14,5,20,1,female
592 ms,592,15600 KB,15600,India,Asia,60,425,296.7916995,2510.428503,40.2173913,100962.8855,122,76,49,46,27,14,3,female
358 ms,358,15300 KB,15300,China,Asia,83,614,447.1829761,3914.274211,46.34722222,181415.7367,93,59,53,34,6,28,6,female
607 ms,607,29300 KB,29300,Vietnam,Asia,85,557,459.8067162,3570.030751,56.82142857,202854.2473,95,72,70,23,2,18,2,female
233 ms,233,35500 KB,35500,South Korea,Asia,73,807,379.3421297,4995.188419,52.12121212,260355.2752,77,60,56,17,4,47,3,female
639 ms,639,75300 KB,75300,Georgia,AsiaEurope,56,539,273.4603973,3130.164303,114.8947368,359639.4039,96,74,67,22,7,17,2,female
358 ms,358,16600 KB,16600,Antarctica,Antarctica,111,730,645.065676,4959.923582,82.6171875,409774.9366,85,56,56,29,0,28,6,female
124 ms,124,28000 KB,28000,India,Asia,79,473,419.7398968,2981.688294,45.88571429,136816.8971,107,52,25,55,27,13,4,female
109 ms,109,6900 KB,6900,China,Asia,85,535,460.4869215,3429.024151,40.0212766,137233.924,129,81,71,48,10,14,2,female
155 ms,155,33800 KB,33800,Croatia,Europe,81,642,432.536756,4070.183702,53.65853659,218400.1011,123,89,81,34,8,28,5,female
124 ms,124,22100 KB,22100,India,Asia,79,643,419.0078103,4053.331021,69.225,280591.8399,109,93,92,16,1,27,2,female
374 ms,374,13300 KB,13300,Russia,AsiaEurope,80,556,425.7903187,3514.992021,69.38461538,243886.3694,95,68,54,27,14,21,1,female
171 ms,171,45000 KB,45000,China,Asia,109,868,631.6688991,5874.783994,70.06153846,411596.4047,76,0,-3,76,3,0,1,female
1029 ms,1029,7800 KB,7800,Syria,Asia,59,415,290.159225,2441.296865,32.86956522,80244.36654,102,68,51,34,17,16,5,female
327 ms,327,16600 KB,16600,China,Asia,81,765,432.536756,4849.985252,99.02439024,480266.8323,104,83,75,21,8,23,4,female
389 ms,389,17000 KB,17000,China,Asia,85,456,459.8067162,2922.682267,43,125675.3375,91,47,35,44,12,19,2,female
389 ms,389,34800 KB,34800,Bangladesh,Asia,52,348,252.7242144,1983.753022,29.85714286,59229.19737,102,61,56,41,5,12,2,female
374 ms,374,17100 KB,17100,China,Asia,85,462,459.8067162,2961.138612,43,127328.9603,91,47,35,44,12,19,2,female
623 ms,623,27400 KB,27400,India,Asia,51,404,250.9308716,2291.659838,30.90909091,70833.12227,116,61,41,55,20,23,2,female
93 ms,93,9900 KB,9900,Russia,AsiaEurope,101,698,573.5532717,4647.431615,64.77966102,301059.0446,110,72,61,38,11,17,2,female
171 ms,171,20100 KB,20100,Poland,Europe,58,572,295.2391057,3350.765129,41.53846154,139185.6284,107,66,55,41,11,13,5,female
155 ms,155,26400 KB,26400,Russia,AsiaEurope,71,596,366.1306865,3665.249283,91.40625,335026.6923,105,85,79,20,6,29,2,female
124 ms,124,28000 KB,28000,India,Asia,69,559,354.8592943,3414.665171,41.22222222,140760.0865,152,75,33,77,42,15,2,female
78 ms,78,14700 KB,14700,China,Asia,130,800,787.9470571,5617.89425,94.375,530188.7699,130,92,75,38,17,26,12,female
171 ms,171,17600 KB,17600,Iran,Asia,82,630,440.20115,4005.257763,81.77777778,327541.0793,109,62,48,47,14,15,4,female
78 ms,78,23500 KB,23500,China,Asia,82,690,439.3544556,4386.710883,41.9047619,183824.0751,80,59,57,21,2,29,2,female
155 ms,155,32900 KB,32900,Russia,AsiaEurope,82,697,439.3192644,4431.213747,65,288028.8936,81,61,56,20,5,28,2,female
124 ms,124,14900 KB,14900,India,Asia,0,0,0,0,0,0,106,75,68,31,7,20,2,female
155 ms,155,127200 KB,127200,China,Asia,109,599,631.1333893,4054.142411,45,182436.4085,92,75,71,17,4,20,6,female
576 ms,576,26400 KB,26400,Iran,Asia,55,462,266.8279228,2670.988188,61.57894737,164476.641,89,63,54,26,9,16,1,female
1512 ms,1512,27500 KB,27500,Russia,AsiaEurope,79,599,419.2271063,3775.964668,54.48648649,205739.0479,123,66,52,57,14,16,3,female
358 ms,358,21500 KB,21500,Unknown,Unknown,56,444,274.4798955,2578.465585,71.77777778,185076.5298,85,65,65,20,0,16,3,female
452 ms,452,80200 KB,80200,China,Asia,79,572,419.0078103,3605.762588,51.79487179,186760.011,95,60,56,35,4,19,5,female
280 ms,280,12800 KB,12800,China,Asia,92,736,508.9533246,4801.3416,82.40196078,395639.9622,111,58,48,53,10,17,3,female
124 ms,124,29400 KB,29400,India,Asia,41,442,197.7269405,2368.037986,21.6,51149.6205,115,77,76,38,1,16,2,female
592 ms,592,31200 KB,31200,Russia,AsiaEurope,80,603,426.079159,3812.122641,73.56976744,280456.9762,107,66,52,41,14,18,4,female
1887 ms,1887,88000 KB,88000,Bangladesh,Asia,66,602,336.5164318,3638.72526,63,229239.6914,117,68,36,49,32,22,3,female
140 ms,140,26000 KB,26000,India,Asia,103,703,586.2775517,4700.609871,53.71428571,252489.9016,84,58,58,26,0,26,8,female
405 ms,405,17200 KB,17200,India,Asia,73,677,378.9461511,4190.511226,42.36842105,177545.3441,170,113,91,57,22,22,4,female
607 ms,607,28400 KB,28400,Iran,Asia,55,446,266.8279228,2578.486432,61.57894737,158780.4803,90,62,53,28,9,16,1,female
1263 ms,1263,21100 KB,21100,Russia,AsiaEurope,69,552,354.26557,3371.9055,33.67857143,113560.9602,103,89,83,14,6,25,1,female
155 ms,155,17200 KB,17200,Russia,AsiaEurope,68,462,346.3298602,2812.407833,36.40322581,102380.7174,124,57,47,67,10,14,4,female
109 ms,109,20500 KB,20500,Bangladesh,Asia,102,762,579.6081201,5084.388111,84.86842105,431503.991,119,112,107,7,5,30,4,female
139 ms,139,19200 KB,19200,Unknown,Unknown,73,579,378.9461511,3583.90842,28.09210526,100679.5326,135,79,61,56,18,19,3,female
139 ms,139,160500 KB,160500,China,Asia,89,751,487.7378322,4863.275807,54.66666667,265859.0774,124,81,55,43,26,27,6,female
389 ms,389,14300 KB,14300,Kazakhstan,AsiaEurope,79,608,419.0078103,3832.698695,68.20512821,261409.7059,99,81,75,18,6,26,3,female
483 ms,483,10800 KB,10800,Romania,Europe,55,476,265.9634675,2751.927224,21,57790.4717,99,92,92,7,0,28,1,female
155 ms,155,18500 KB,18500,Japan,Asia,87,752,473.9427998,4845.093509,104.575,506675.6537,133,92,82,41,10,28,5,female
62 ms,62,11900 KB,11900,China,Asia,106,824,608.4972857,5543.806455,53.66666667,297517.6131,119,83,81,36,2,48,9,female
140 ms,140,26000 KB,26000,Russia,AsiaEurope,84,696,453.092115,4449.052926,106.3636364,473217.4476,126,80,53,46,27,21,5,female
108 ms,108,13800 KB,13800,China,Asia,79,753,420.1071259,4746.746903,76.76470588,364382.6299,124,78,72,46,6,25,1,female
77 ms,77,47000 KB,47000,China,Asia,92,883,508.1677,5760.305207,47.5,273614.4973,108,34,32,74,2,20,5,female
514 ms,514,13700 KB,13700,China,Asia,113,727,657.9932198,4958.270106,72.875,361333.934,106,81,78,25,3,31,7,female
202 ms,202,73300 KB,73300,China,Asia,113,714,661.0808625,4869.607779,46.65441176,227188.6865,111,71,68,40,3,26,5,female
124 ms,124,10800 KB,10800,Poland,Europe,91,850,501.2172393,5531.625444,136.9565217,757592.1804,131,90,61,41,29,30,3,female
218 ms,218,18200 KB,18200,South Korea,Asia,69,734,354.26557,4483.656951,105.4285714,472705.5471,100,76,70,24,6,28,5,female
109 ms,109,26000 KB,26000,India,Asia,95,786,531.8959763,5163.906508,123.6666667,638603.1048,84,54,54,30,0,19,8,female
93 ms,93,15600 KB,15600,Japan,Asia,92,682,508.4501668,4449.069254,62.30612245,277204.2537,109,65,55,44,10,25,4,female
1528 ms,1528,74300 KB,74300,Iran,Asia,113,1061,660.5118257,7236.209879,144.5223881,1045794.332,105,50,47,55,3,28,6,female
93 ms,93,11800 KB,11800,India,Asia,79,799,419.7398968,5036.720818,78.57142857,395742.35,144,101,98,43,3,36,2,female
1310 ms,1310,22200 KB,22200,Russia,AsiaEurope,92,753,508.1990654,4912.242153,100.5319149,493837.1101,120,97,89,23,8,28,7,female
607 ms,607,28300 KB,28300,Unknown,Unknown,68,532,348.0415947,3238.530232,35.68518519,115567.551,137,82,57,55,25,22,2,female
374 ms,374,28800 KB,28800,China,Asia,100,881,564.8477751,5853.237303,79.64814815,466199.5119,133,87,87,46,0,33,3,female
530 ms,530,11800 KB,11800,Romania,Europe,68,601,346.1173001,3658.565168,59.625,218141.9481,116,85,66,31,19,35,1,female
139 ms,139,22500 KB,22500,Iran,Asia,0,0,0,0,0,0,111,75,65,36,10,16,4,female
1512 ms,1512,33800 KB,33800,Ukraine,Europe,86,779,466.9609738,5006.060244,57.39130435,287304.327,160,135,124,25,11,34,5,female
109 ms,109,47000 KB,47000,China,Asia,108,846,623.7020245,5714.634827,73.92857143,422474.789,119,88,86,31,2,26,4,female
545 ms,545,247500 KB,247500,China,Asia,13,28,40.05374781,103.6123121,5.5,569.8677166,141,113,104,28,9,45,5,female
124 ms,124,16600 KB,16600,India,Asia,88,712,480.9553238,4599.115312,66.66666667,306607.6875,142,77,59,65,18,23,9,female
529 ms,529,247500 KB,247500,China,Asia,13,28,40.05374781,103.6123121,5.5,569.8677166,141,113,104,28,9,45,5,female
124 ms,124,14000 KB,14000,Japan,Asia,93,678,516.0824975,4433.549674,70.3902439,312078.6429,121,82,71,39,11,31,7,female
499 ms,499,25500 KB,25500,Serbia,Europe,68,642,351.1753143,3908.151144,51.84782609,202629.1408,162,116,94,46,22,23,8,female
545 ms,545,37100 KB,37100,China,Asia,97,1030,546.4971854,6797.910227,70.84745763,481614.6568,199,131,109,68,22,31,9,female
233 ms,233,89000 KB,89000,China,Asia,91,730,502.1708162,4750.690087,97.25490196,462027.8987,120,78,55,42,23,27,4,female
560 ms,560,247500 KB,247500,China,Asia,13,28,40.05374781,103.6123121,5.5,569.8677166,143,113,105,30,8,45,5,female
748 ms,748,82300 KB,82300,Russia,AsiaEurope,77,659,405.7769322,4129.81233,64.34722222,265741.9518,130,75,60,55,15,16,5,female
202 ms,202,21600 KB,21600,Russia,AsiaEurope,88,739,480.5611817,4773.519966,66.19565217,315986.2673,129,86,79,43,7,28,5,female
124 ms,124,17200 KB,17200,India,Asia,98,764,550.7131734,5053.638321,58.16037736,293921.5118,132,102,96,30,6,33,16,female
155 ms,155,245600 KB,245600,China,Asia,109,884,630.6524852,5983.074943,70.82539683,423753.6571,151,107,97,44,10,27,8,female
390 ms,390,25000 KB,25000,Russia,AsiaEurope,87,781,473.6107211,5031.93887,71.86666667,361628.6735,146,88,74,58,14,21,3,female
1559 ms,1559,40400 KB,40400,Singapore,Asia,106,966,608.1416159,6499.171159,59.34745763,385709.285,161,85,44,76,41,29,8,female
124 ms,124,20100 KB,20100,Russia,AsiaEurope,82,913,440.20115,5804.44498,77.08695652,447446.9978,142,98,88,44,10,34,3,female
109 ms,109,14300 KB,14300,Bangladesh,Asia,76,747,398.842491,4667.201853,62.5,291700.1158,131,109,95,22,14,35,1,female
561 ms,561,24400 KB,24400,Bangladesh,Asia,72,523,373.6840496,3226.870776,37.1,119716.9058,127,65,55,62,10,16,2,female
124 ms,124,18900 KB,18900,Russia,AsiaEurope,71,977,368.5969538,6008.302936,105.9259259,636435.0517,162,121,115,41,6,33,2,female
124 ms,124,22000 KB,22000,India,Asia,81,703,433.2506894,4456.914552,41.25,183847.7253,164,97,71,67,26,23,3,female
202 ms,202,29800 KB,29800,Russia,AsiaEurope,89,730,487.5430078,4727.285405,98.74468085,466794.2886,131,89,77,42,12,22,4,female
467 ms,467,41700 KB,41700,Ukraine,Europe,73,792,379.6596322,4902.341051,64.703125,317196.7858,153,114,85,39,29,44,2,female
452 ms,452,106100 KB,106100,China,Asia,130,1171,787.2923715,8223.192709,62.94303797,517592.731,159,131,125,28,6,51,14,female
140 ms,140,25000 KB,25000,India,Asia,109,930,632.9053075,6294.411422,122.8656716,773367.087,119,83,77,36,6,25,9,female
109 ms,109,18200 KB,18200,India,Asia,63,657,318.7159976,3927.07291,33,129593.406,216,141,111,75,30,36,13,female
93 ms,93,10400 KB,10400,India,Asia,91,861,502.1708162,5603.211185,67.84313725,380139.4255,142,115,111,27,4,41,2,female
171 ms,171,18700 KB,18700,Russia,AsiaEurope,92,962,508.1677,6275.666602,119,746804.3256,198,114,93,84,21,32,5,female
420 ms,420,17200 KB,17200,Japan,Asia,103,728,587.7428202,4867.772384,49.09166667,238967.0593,166,88,70,78,18,25,10,female
763 ms,763,24400 KB,24400,India,Asia,78,760,412.4094067,4776.905686,42.66216216,203793.125,191,136,109,55,27,20,3,female
93 ms,93,13700 KB,13700,India,Asia,89,787,487.5430078,5096.40221,76.40425532,389386.8157,163,141,135,22,6,46,3,female
124 ms,124,18600 KB,18600,United States,North America,97,1072,545.3518546,7075.106567,118.5964912,839082.8139,179,0,-11,179,11,0,3,female
358 ms,358,20600 KB,20600,India,Asia,49,607,246.1288162,3408.128875,57,194263.3459,170,128,114,42,14,28,4,female
561 ms,561,22200 KB,22200,Bangladesh,Asia,66,373,334.5126491,2254.559007,38.27777778,86299.50864,162,75,47,87,28,12,4,female
1746 ms,1746,32900 KB,32900,Russia,AsiaEurope,88,1041,480.4627738,6724.268315,118.0111111,793538.3753,161,138,126,23,12,45,8,female
546 ms,546,20100 KB,20100,India,Asia,74,744,387.4217091,4619.833304,60.86666667,281193.8538,200,124,116,76,8,20,10,female
420 ms,420,13700 KB,13700,Bangladesh,Asia,65,838,327.3557123,5046.744227,42.94642857,216739.6405,194,124,87,70,37,44,4,female
498 ms,498,25300 KB,25300,India,Asia,84,645,453.2640759,4123.044738,38.56666667,159012.0921,157,101,82,56,19,26,3,female
1341 ms,1341,35800 KB,35800,South Korea,Asia,124,1250,742.9206911,8692.745388,125.0526316,1087050.686,132,104,99,28,5,37,11,female
405 ms,405,16800 KB,16800,Belarus,Europe,81,736,432.75063,4666.129602,67.89473684,316805.6414,179,74,61,105,13,22,4,female
124 ms,124,21600 KB,21600,Taiwan,Asia,93,1013,516.4569079,6624.167876,143.1,947918.423,173,104,78,69,26,39,4,female
139 ms,139,17600 KB,17600,Russia,AsiaEurope,81,968,432.536756,6136.974803,91.7375,562990.726,170,123,116,47,7,49,1,female
577 ms,577,23200 KB,23200,Bangladesh,Asia,78,517,413.5983953,3249.552947,51.13636364,166170.3212,172,99,72,73,27,19,4,female
576 ms,576,22200 KB,22200,Bangladesh,Asia,71,384,366.8663501,2361.502894,45.1,106503.7805,172,63,36,109,27,13,4,female
514 ms,514,27400 KB,27400,Bangladesh,Asia,119,931,705.3002761,6419.075338,66.25694444,425308.318,157,87,69,70,18,34,8,female
186 ms,186,36100 KB,36100,India,Asia,111,1192,646.0634012,8098.943713,84.20454545,681967.874,168,114,104,54,10,33,1,female
467 ms,467,31200 KB,31200,Bangladesh,Asia,114,905,668.0313232,6183.765463,62.91176471,389031.5978,156,88,72,68,16,28,8,female
108 ms,108,23500 KB,23500,South Korea,Asia,108,1071,621.7684232,7234.484515,81.42105263,589039.3444,164,100,79,64,21,29,10,female
108 ms,108,20000 KB,20000,India,Asia,84,843,453.092115,5388.723587,81.4,438642.1,158,107,106,51,1,32,2,female
373 ms,373,30700 KB,30700,China,Asia,104,1309,593.2900757,8770.875591,102,894629.3103,193,143,143,50,0,56,4,female
140 ms,140,17200 KB,17200,Unknown,Unknown,72,576,373.2397178,3553.876801,52.90322581,188011.5469,153,93,82,60,11,19,6,female
530 ms,530,31300 KB,31300,Bangladesh,Asia,114,984,668.0313232,6723.563774,67.30882353,452555.1675,169,101,85,68,16,32,8,female
327 ms,327,9800 KB,9800,Unknown,Unknown,84,950,452.9890166,6072.701552,68.69512195,417164.9737,227,151,118,76,33,47,1,female
514 ms,514,31300 KB,31300,Bangladesh,Asia,115,996,675.0131492,6818.108091,68.77205882,468895.3307,170,102,86,68,16,34,8,female
77 ms,77,23500 KB,23500,China,Asia,107,1022,615.8588276,6889.77926,175.704918,1210568.1,180,120,117,60,3,46,12,female
155 ms,155,10400 KB,10400,France,Europe,99,1462,557.3718925,9692.119379,92.96875,901064.2235,219,101,47,118,54,59,30,female
342 ms,342,248500 KB,248500,Bangladesh,Asia,84,636,455.7586984,4065.513881,44.64705882,181513.2374,211,79,57,132,22,18,3,female
327 ms,327,248500 KB,248500,Bangladesh,Asia,84,636,455.7586984,4065.513881,44.64705882,181513.2374,211,79,58,132,21,18,3,female
234 ms,234,21600 KB,21600,India,Asia,87,916,474.2088866,5901.736242,73.23076923,432188.6848,272,175,157,97,18,42,11,female
421 ms,421,27700 KB,27700,Bangladesh,Asia,8,69,24,207,0,0,225,58,3,167,55,11,2,female
233 ms,233,21600 KB,21600,India,Asia,87,913,474.2088866,5882.407412,72.61538462,427153.2767,277,180,162,97,18,42,11,female
140 ms,140,28300 KB,28300,India,Asia,133,1288,811.3210823,9087.203777,85.54216867,777339.1183,310,218,183,92,35,50,15,female
405 ms,405,16700 KB,16700,India,Asia,67,465,341.8710649,2820.731474,56.76923077,160130.756,209,99,90,110,9,21,2,female
1029 ms,1029,26400 KB,26400,Bangladesh,Asia,80,780,425.7903187,4931.103914,35.67073171,175896.0847,337,103,-52,234,155,18,2,female
561 ms,561,17600 KB,17600,China,Asia,164,1616,1052.071719,11889.80404,85.40952381,1015502.501,263,176,154,87,22,56,26,female
93 ms,93,16600 KB,16600,South Korea,Asia,142,1462,874.2613731,10452.93029,89.02564103,930578.8195,199,111,80,88,31,60,33,female
576 ms,576,17600 KB,17600,Russia,AsiaEurope,115,656,677.5639846,4490.641473,51.95833333,233326.2466,99,60,52,39,8,30,11,female
670 ms,670,213300 KB,213300,China,Asia,309,7406,2358.546156,61258.45518,550,33692150.35,133,86,84,47,2,76,14,female
139 ms,139,16000 KB,16000,China,Asia,153,1877,966.216349,13622.11698,79.13265306,1077954.257,411,265,221,146,44,73,43,female
343 ms,343,15600 KB,15600,Bangladesh,Asia,49,373,235.7693245,2094.286772,30.83333333,64573.84213,276,60,15,216,45,27,17,female
108 ms,108,115600 KB,115600,China,Asia,11,26,38.05374781,89.94522208,0,0,188,103,102,85,1,83,41,female
93 ms,93,119500 KB,119500,China,Asia,11,26,38.05374781,89.94522208,0,0,190,104,103,86,1,83,41,female
545 ms,545,29400 KB,29400,China,Asia,159,2006,1021.070351,14669.64321,94.43636364,1385347.76,327,225,194,102,31,62,18,female
109 ms,109,13700 KB,13700,China,Asia,176,3507,1165.513992,26160.22669,98.55426357,2578201.876,381,141,84,240,57,130,92,female
265 ms,265,17400 KB,17400,Bangladesh,Asia,46,238,210.3683172,1314.607746,23.88235294,31395.92616,37,32,32,5,0,9,2,male
202 ms,202,21000 KB,21000,China,Asia,47,243,217.5800856,1349.765091,24.21875,32689.6233,45,40,40,5,0,9,2,male
1434 ms,1434,21000 KB,21000,India,Asia,56,229,269.4181505,1329.884277,28.84615385,38362.04646,42,34,34,8,0,8,2,male
249 ms,249,17400 KB,17400,Kyrgyzstan,Asia,48,241,222.2653679,1345.975963,25,33649.39907,38,32,32,6,0,9,2,male
156 ms,156,18000 KB,18000,Unknown,Unknown,51,267,238.9889445,1514.537566,27.02272727,40926.9356,40,36,36,4,0,10,3,male
233 ms,233,18000 KB,18000,India,Asia,51,267,238.9889445,1514.537566,27.02272727,40926.9356,40,36,36,4,0,10,3,female
233 ms,233,18000 KB,18000,Unknown,Unknown,51,267,238.9889445,1514.537566,27.02272727,40926.9356,40,36,36,4,0,10,3,male
1403 ms,1403,23100 KB,23100,India,Asia,52,223,248.0323866,1271.198057,23.61111111,30014.39857,43,39,39,4,0,12,2,male
296 ms,296,14800 KB,14800,Brazil,South America,67,286,339.5249056,1734.901508,30.62857143,53137.55477,54,36,25,18,11,10,2,male
1419 ms,1419,17400 KB,17400,India,Asia,54,235,258.1074956,1352.398563,29.09090909,39342.50365,50,35,28,15,7,8,2,male
1512 ms,1512,17400 KB,17400,India,Asia,54,235,258.1074956,1352.398563,29.09090909,39342.50365,50,35,28,15,7,8,2,male
265 ms,265,21800 KB,21800,China,Asia,71,313,365.6422056,1924.870848,30.625,58949.16973,37,32,32,5,0,11,2,male
748 ms,748,17400 KB,17400,India,Asia,60,242,295.6213103,1429.467524,30.8,44027.59974,52,40,34,12,6,10,3,male
451 ms,451,30500 KB,30500,India,Asia,51,267,238.9889445,1514.537566,27.02272727,40926.9356,40,36,36,4,0,10,3,male
265 ms,265,18900 KB,18900,China,Asia,73,331,379.6596322,2048.831929,31.6097561,64763.07756,50,40,39,10,1,12,3,male
1528 ms,1528,21800 KB,21800,Hungary,Europe,62,297,308.3287327,1768.396304,40.15384615,71007.91314,51,43,40,8,3,13,3,male
343 ms,343,36900 KB,36900,India,Asia,40,211,197.504662,1122.926828,18.5,20774.14632,38,32,32,6,0,11,2,male
265 ms,265,22100 KB,22100,India,Asia,63,321,313.8551855,1918.706855,35.17241379,67485.55147,53,40,32,13,8,14,3,male
311 ms,311,14400 KB,14400,United States,North America,71,239,365.6422056,1469.789562,27.22222222,40010.93806,47,34,29,13,5,8,2,male
1419 ms,1419,17400 KB,17400,India,Asia,54,225,257.6220106,1294.849688,28.30434783,36649.87595,49,41,41,8,0,9,2,male
1419 ms,1419,21000 KB,21000,Kazakhstan,AsiaEurope,66,262,332.9300119,1583.631259,37,58594.35659,50,35,28,15,7,9,2,male
358 ms,358,22100 KB,22100,India,Asia,65,317,326.5538222,1909.090597,30.70967742,58627.55639,55,43,36,12,7,12,3,male
249 ms,249,17400 KB,17400,Canada,North America,63,260,313.5800856,1554.09278,35.359375,54951.7494,51,41,37,10,4,8,2,male
155 ms,155,13300 KB,13300,China,Asia,75,389,393.7950768,2423.010471,35.22727273,85356.05067,45,41,41,4,0,12,4,male
311 ms,311,25100 KB,25100,India,Asia,61,311,300.8814489,1844.459312,32.55172414,60040.33071,58,44,36,14,8,16,4,male
218 ms,218,21900 KB,21900,China,Asia,66,344,332.9300119,2079.271577,36.5,75893.41256,54,44,44,10,0,12,2,male
358 ms,358,31600 KB,31600,Unknown,Unknown,65,311,326.5538222,1872.95639,40.03225806,74978.67354,51,42,39,9,3,18,2,male
280 ms,280,24600 KB,24600,Bulgaria,Europe,70,346,359.4212455,2120.731924,36.21052632,76792.81914,55,40,32,15,8,12,2,male
249 ms,249,21800 KB,21800,India,Asia,80,341,425.7903187,2155.77748,52.79268293,113809.277,57,40,29,17,11,16,3,male
249 ms,249,21800 KB,21800,India,Asia,68,333,347.0121354,2027.125126,57.82758621,117223.753,69,51,37,18,14,16,3,male
1528 ms,1528,18400 KB,18400,India,Asia,66,331,332.9737366,2000.694454,45.6875,91406.72784,60,50,50,10,0,12,4,male
1482 ms,1482,33100 KB,33100,Kyrgyzstan,Asia,75,335,392.2479866,2086.654261,47.53846154,99196.33335,51,44,44,7,0,13,3,male
296 ms,296,26000 KB,26000,North Korea,Asia,39,228,194.7497745,1205.071706,18.5,22293.82656,44,36,36,8,0,10,2,male
1528 ms,1528,15000 KB,15000,Bangladesh,Asia,69,341,352.4986422,2083.00684,54.55882353,113646.4026,60,43,36,17,7,11,3,male
233 ms,233,17900 KB,17900,India,Asia,65,322,327.8032081,1939.202436,54.88888889,106440.667,62,51,46,11,5,13,4,male
810 ms,810,26000 KB,26000,India,Asia,43,241,201.5030616,1307.729806,32.11111111,41992.6571,58,48,48,10,0,12,2,male
1496 ms,1496,14900 KB,14900,Vietnam,Asia,64,294,320.1804545,1764,37.4,65973.6,59,46,40,13,6,14,2,male
1591 ms,1591,22600 KB,22600,Ukraine,Europe,43,221,203.5249056,1199.204511,19.6875,23609.33881,51,35,28,16,7,14,3,male
1435 ms,1435,21800 KB,21800,Indonesia,Asia,61,271,300.8814489,1607.229818,34.20689655,54978.34414,51,42,39,9,3,13,2,male
1590 ms,1590,22600 KB,22600,Ukraine,Europe,43,223,203.5249056,1210.05704,19.6875,23822.99798,51,35,28,16,7,14,3,male
249 ms,249,17400 KB,17400,Romania,Europe,67,292,339.4387425,1771.298044,25.72058824,45558.82762,48,32,27,16,5,8,2,male
1450 ms,1450,30100 KB,30100,Bangladesh,Asia,59,238,288.6764386,1400.069046,31.73076923,44425.2678,45,39,39,6,0,9,2,male
1513 ms,1513,40100 KB,40100,India,Asia,35,237,164.7548875,1215.640075,16,19450.2412,67,44,32,23,12,12,3,male
296 ms,296,16300 KB,16300,Brazil,South America,64,341,320.4063545,2046,54.9137931,112353.6207,50,38,32,12,6,14,4,male
234 ms,234,26300 KB,26300,Cuba,North America,79,356,419.2271063,2244.145946,39.64285714,88964.35716,64,46,30,18,16,13,1,male
265 ms,265,24600 KB,24600,India,Asia,64,331,320,1986,35.5,70503,58,46,41,12,5,12,2,male
249 ms,249,20400 KB,20400,Poland,Europe,57,266,277.6324012,1551.548744,26.25,40728.15452,65,41,27,24,14,14,2,male
295 ms,295,30700 KB,30700,India,Asia,69,286,353.0013311,1747.037995,35.5483871,62104.38291,58,52,52,6,0,13,2,male
1591 ms,1591,13000 KB,13000,Ukraine,Europe,43,230,203.5249056,1248.040894,19.6875,24570.80509,52,36,29,16,7,16,3,male
545 ms,545,31800 KB,31800,Bangladesh,Asia,68,300,346.1173001,1826.238852,31.55555556,57627.98156,49,42,41,7,1,12,2,male
265 ms,265,23300 KB,23300,Bangladesh,Asia,68,300,346.1173001,1826.238852,31.55555556,57627.98156,49,42,41,7,1,12,2,male
249 ms,249,22100 KB,22100,Bangladesh,Asia,74,307,385.5385456,1906.302183,33.15789474,63208.96713,46,38,38,8,0,11,2,male
732 ms,732,21000 KB,21000,Kazakhstan,AsiaEurope,68,282,345.9899115,1716.664521,39.24242424,67366.07742,56,40,32,16,8,10,3,male
1590 ms,1590,22600 KB,22600,Ukraine,Europe,43,230,203.5249056,1248.040894,19.6875,24570.80509,52,36,29,16,7,16,3,male
233 ms,233,18700 KB,18700,Egypt,AsiaAfrica,64,299,321.1317371,1794,50.7037037,90962.44444,42,30,28,12,2,14,2,male
280 ms,280,27600 KB,27600,Unknown,Unknown,73,344,379.3421297,2129.299648,49.09090909,104529.2555,63,51,48,12,3,13,3,male
826 ms,826,26000 KB,26000,India,Asia,37,236,177.7286241,1229.430994,22.66666667,27867.10254,66,56,55,10,1,9,2,male
1512 ms,1512,34000 KB,34000,India,Asia,39,262,187.5249056,1384.775381,17.5,24233.56917,69,48,40,21,8,9,2,female
1512 ms,1512,44800 KB,44800,India,Asia,34,257,158.3349731,1307.47795,15.5,20265.90823,68,48,39,20,9,13,3,male
1606 ms,1606,32300 KB,32300,India,Asia,59,308,288.0881667,1811.854059,31.03448276,56229.95356,59,47,42,12,5,11,2,male
546 ms,546,30500 KB,30500,China,Asia,70,400,359.4212455,2451.713207,55.15789474,135231.339,50,36,33,14,3,11,2,male
233 ms,233,15500 KB,15500,Iran,Asia,0,0,0,0,0,0,56,44,38,12,6,14,5,female
1482 ms,1482,18700 KB,18700,United Arab Emirates,Asia,59,305,288.0881667,1794.20613,40.11666667,71977.56925,57,42,34,15,8,15,3,male
187 ms,187,14100 KB,14100,China,Asia,64,354,320.0450916,2124,35.12903226,74614.06452,75,57,51,18,6,13,3,male
295 ms,295,70700 KB,70700,Serbia,Europe,68,297,348.0415947,1807.976464,41.75925926,75499.75789,46,33,29,13,4,14,2,female
561 ms,561,59900 KB,59900,India,Asia,36,224,186.1173001,1158.0632,0,0,74,60,52,14,8,13,2,male
390 ms,390,32800 KB,32800,Brazil,South America,86,417,466.9609738,2679.752403,47.82608696,128162.0714,68,48,35,20,13,15,3,male
1481 ms,1481,18900 KB,18900,India,Asia,57,337,275.7915183,1965.683935,28.61538462,56248.80183,68,63,62,5,1,11,2,male
1465 ms,1465,17200 KB,17200,India,Asia,50,233,232.4238875,1315.018492,27.58695652,36277.35797,57,37,24,20,13,9,2,male
1528 ms,1528,21700 KB,21700,United States,North America,64,344,321.1317371,2064,58.92592593,121623.1111,62,49,42,13,7,16,3,male
311 ms,311,36900 KB,36900,India,Asia,39,230,194.7497745,1215.64251,18.5,22489.38644,65,56,56,9,0,13,2,male
1528 ms,1528,22100 KB,22100,Kazakhstan,AsiaEurope,78,400,412.2613731,2514.160888,64.5,162163.3772,53,47,47,6,0,16,3,female
810 ms,810,21800 KB,21800,China,Asia,70,354,359.2147805,2169.766188,49.89393939,108258.1827,57,40,31,17,9,14,3,male
1466 ms,1466,19700 KB,19700,Armenia,Europe,58,295,282.5614107,1728.104394,32.34,55886.89609,74,50,41,24,9,13,4,male
202 ms,202,14900 KB,14900,China,Asia,64,337,320.4063545,2022,35,70770,52,31,31,21,0,7,2,female
779 ms,779,33000 KB,33000,India,Asia,86,433,466.7930215,2782.572639,69.24444444,192677.6965,45,40,40,5,0,17,6,male
265 ms,265,21800 KB,21800,Brazil,South America,86,377,467.4994455,2422.701813,52.64583333,127545.1558,56,33,24,23,9,13,3,male
795 ms,795,13000 KB,13000,Ukraine,Europe,45,243,216.7497745,1334.520302,20.8125,27774.70379,53,37,30,16,7,16,3,male
1450 ms,1450,14900 KB,14900,China,Asia,72,397,374.2108333,2449.460226,30.68604651,75164.25041,61,55,54,6,1,15,5,male
1372 ms,1372,18600 KB,18600,China,Asia,72,397,374.2108333,2449.460226,30.68604651,75164.25041,61,55,54,6,1,15,5,male
842 ms,842,22600 KB,22600,Ukraine,Europe,45,243,216.7497745,1334.520302,20.8125,27774.70379,53,37,30,16,7,16,3,male
280 ms,280,20500 KB,20500,Egypt,AsiaAfrica,54,249,259.4122985,1432.966988,28.9,41412.74595,47,39,39,8,0,10,2,male
1450 ms,1450,39700 KB,39700,India,Asia,70,285,359.0910367,1746.84566,40.23529412,70284.8489,57,45,39,12,6,14,3,male
327 ms,327,36900 KB,36900,India,Asia,61,313,300.7868035,1856.320787,30,55689.6236,65,52,49,13,3,9,2,male
1528 ms,1528,28600 KB,28600,Turkey,AsiaEurope,61,324,301.0709438,1921.558897,34.76785714,66808.48524,64,46,43,18,3,11,2,male
1450 ms,1450,24900 KB,24900,India,Asia,61,315,300.7868035,1868.182261,34.61666667,64670.24261,59,46,46,13,0,11,2,male
280 ms,280,21800 KB,21800,Russia,AsiaEurope,83,361,446.2065082,2301.389235,55.34883721,127379.2181,47,36,31,11,5,13,3,male
248 ms,248,21800 KB,21800,China,Asia,69,383,352.582306,2339.564867,58.36363636,136545.5131,58,41,32,17,9,14,3,male
249 ms,249,21800 KB,21800,Brazil,South America,91,400,503.0010296,2603.117856,50.54716981,131580.2403,55,32,23,23,9,11,3,male
202 ms,202,18800 KB,18800,Turkmenistan,Asia,69,378,352.4986422,2309.022245,38.85714286,89722.00722,64,45,39,19,6,14,3,male
280 ms,280,26000 KB,26000,India,Asia,76,333,399.4510684,2080.559862,43.85294118,91238.66924,60,42,38,18,4,10,2,male
233 ms,233,18700 KB,18700,Bangladesh,Asia,78,326,412.2983693,2049.041123,38,77863.56269,54,40,32,14,8,12,2,male
327 ms,327,33700 KB,33700,India,Asia,76,359,398.8804611,2243.005977,55.02564103,123422.8417,57,40,32,17,8,11,3,male
1466 ms,1466,20200 KB,20200,India,Asia,57,304,276.0964047,1773.198564,34.56,61281.74238,79,54,41,25,13,12,2,male
280 ms,280,21800 KB,21800,Iran,Asia,63,313,316.1697866,1870.888616,33.3125,62323.97702,69,46,39,23,7,12,2,male
218 ms,218,15600 KB,15600,Jordan,Asia,83,337,446.1369639,2148.388288,41.97619048,90181.15601,57,47,42,10,5,12,2,male
248 ms,248,19700 KB,19700,Hungary,Europe,66,335,333.1049912,2024.87203,53.06451613,107448.8545,79,58,48,21,10,12,2,male
1497 ms,1497,23300 KB,23300,India,Asia,62,355,308.8461793,2113.73969,68.08,143903.3981,63,51,44,12,7,12,4,male
420 ms,420,22700 KB,22700,China,Asia,98,448,552.134363,2963.39001,62.57894737,185445.8275,48,35,30,13,5,12,3,male
1528 ms,1528,32800 KB,32800,Brazil,South America,72,408,372.2746801,2517.329401,52.97297297,133350.4223,61,51,46,10,5,17,4,male
1497 ms,1497,21800 KB,21800,China,Asia,64,344,321.1317371,2064,58.92592593,121623.1111,63,49,41,14,8,16,3,male
468 ms,468,22700 KB,22700,China,Asia,98,448,552.134363,2963.39001,62.57894737,185445.8275,48,35,30,13,5,12,3,male
296 ms,296,20500 KB,20500,Indonesia,Asia,59,313,288.1860234,1841.267274,29.89285714,55040.7396,63,44,39,19,5,9,2,male
1466 ms,1466,18700 KB,18700,United Arab Emirates,Asia,58,307,281.8126557,1798.400166,34.53333333,62104.75238,63,46,36,17,10,15,3,male
468 ms,468,18800 KB,18800,India,Asia,58,324,282.5614107,1897.985842,36.96,70149.55674,87,68,59,19,9,13,2,male
826 ms,826,43900 KB,43900,China,Asia,61,293,302.2137048,1737.70604,35.28,61306.26909,51,44,43,7,1,15,2,male
249 ms,249,15200 KB,15200,India,Asia,59,367,290.8572701,2158.929999,28.59090909,61725.77134,67,51,49,16,2,13,2,male
794 ms,794,19700 KB,19700,Romania,Europe,62,303,309.4603455,1804.121482,37.20833333,67128.35348,79,41,8,38,33,12,3,male
1482 ms,1482,22100 KB,22100,South Korea,Asia,71,300,366.8663501,1844.924136,41.68333333,76902.58773,52,35,32,17,3,13,2,male
1544 ms,1544,55400 KB,55400,India,Asia,71,290,365.7235111,1783.426665,41.35294118,73749.93796,60,48,42,12,6,14,3,male
1512 ms,1512,22100 KB,22100,Belarus,Europe,67,312,339.6973857,1892.619827,47.03225806,89014.18414,58,46,39,12,7,13,4,male
295 ms,295,22000 KB,22000,Egypt,AsiaAfrica,71,329,365.6422056,2023.266802,41.14285714,83242.97701,54,38,32,16,6,10,2,male
1544 ms,1544,19400 KB,19400,India,Asia,75,331,392.2479866,2061.738987,36,74222.60352,73,49,32,24,17,11,2,male
265 ms,265,18700 KB,18700,Bangladesh,Asia,77,411,406.0022373,2575.649268,50,128782.4634,52,39,33,13,6,18,3,male
1528 ms,1528,21800 KB,21800,India,Asia,64,343,321.1317371,2058,58.24074074,119859.4444,62,50,44,12,6,16,3,male
1466 ms,1466,19500 KB,19500,Bangladesh,Asia,77,321,406.3031211,2011.63848,40.3255814,81120.49125,64,28,5,36,23,13,2,male
1512 ms,1512,17100 KB,17100,India,Asia,69,298,352.582306,1820.340288,40.33333333,73420.39162,65,48,37,17,11,12,3,male
1466 ms,1466,19500 KB,19500,Bangladesh,Asia,77,322,406.3031211,2017.905266,40.3255814,81373.20306,64,28,5,36,23,13,2,male
842 ms,842,21800 KB,21800,India,Asia,80,363,426.079159,2294.859898,37.43023256,85897.13969,69,47,35,22,12,11,2,male
1465 ms,1465,21800 KB,21800,India,Asia,64,358,321.1317371,2148,58.92592593,126572.8889,68,50,41,18,9,17,3,male
1512 ms,1512,21800 KB,21800,Syria,Asia,71,313,365.6422056,1924.870848,42.29166667,81405.9963,64,50,43,14,7,17,3,male
264 ms,264,18900 KB,18900,Vietnam,Asia,61,318,301.7363383,1885.974473,42.40384615,79972.57142,53,45,44,8,1,15,3,male
1450 ms,1450,18900 KB,18900,Brazil,South America,70,343,359.0910367,2102.344075,40.76470588,85701.43787,82,53,36,29,17,13,3,male
1450 ms,1450,21800 KB,21800,Israel,Asia,64,358,321.1317371,2148,58.92592593,126572.8889,68,50,41,18,9,17,3,male
842 ms,842,57300 KB,57300,India,Asia,64,343,320.4063545,2058,37.4137931,76997.58621,78,67,64,11,3,14,2,male
779 ms,779,19700 KB,19700,Iran,Asia,68,323,346.3298602,1966.250498,41.17741935,80965.1213,72,51,43,21,8,16,5,male
794 ms,794,36100 KB,36100,China,Asia,68,403,346.1173001,2453.247525,39.375,96596.6213,68,56,56,12,0,17,5,male
1606 ms,1606,20900 KB,20900,India,Asia,65,303,326.4650059,1824.777447,35.578125,64922.16012,64,47,36,17,11,13,2,male
265 ms,265,23700 KB,23700,India,Asia,74,363,385.5385456,2254.031572,52.77777778,118962.7774,58,43,39,15,4,15,3,male
280 ms,280,32800 KB,32800,Brazil,South America,73,417,378.8670746,2581.156841,54.48648649,140638.1673,63,53,48,10,5,17,4,male
217 ms,217,30300 KB,30300,Russia,AsiaEurope,61,356,301.3556992,2111.342492,52.88888889,111666.5585,63,48,42,15,6,12,3,male
1482 ms,1482,17300 KB,17300,India,Asia,60,329,295.6213103,1943.367006,34.3,66657.4883,82,67,62,15,5,14,2,male
217 ms,217,34300 KB,34300,India,Asia,74,346,386.4773318,2148.470865,44.625,95875.51233,91,76,71,15,5,16,3,male
811 ms,811,18700 KB,18700,Colombia,South America,74,315,385.4995491,1955.97781,38.5,75305.14569,50,34,34,16,0,15,2,male
1872 ms,1872,34600 KB,34600,China,Asia,73,403,379.1044231,2494.499297,37.05128205,92424.39704,62,54,54,8,0,11,3,male
1606 ms,1606,26400 KB,26400,India,Asia,72,301,372.2346001,1857.147425,32.5,60357.29133,55,41,33,14,8,15,2,male
468 ms,468,19800 KB,19800,Iran,Asia,0,0,0,0,0,0,60,50,47,10,3,15,2,male
218 ms,218,14900 KB,14900,Singapore,Asia,67,339,339.5249056,2056.404236,44.296875,91092.28137,57,44,41,13,3,11,2,male
1575 ms,1575,21800 KB,21800,India,Asia,62,415,307.5796744,2470.991469,66.17857143,163526.6854,82,59,41,23,18,16,3,male
623 ms,623,42000 KB,42000,Egypt,AsiaAfrica,68,440,346.3298602,2678.48365,51.91935484,139065.1431,77,64,57,13,7,20,4,male
374 ms,374,30400 KB,30400,Russia,AsiaEurope,72,404,372.2346001,2492.649701,58.5,145820.0075,66,54,47,12,7,14,3,male
155 ms,155,27400 KB,27400,China,Asia,83,485,446.1369639,3091.894124,55.64285714,172041.8231,57,7,7,50,0,4,1,male
748 ms,748,19700 KB,19700,Brazil,South America,79,374,419.4466845,2357.614,47.30232558,111520.625,64,46,37,18,9,14,4,male
265 ms,265,19000 KB,19000,China,Asia,71,398,365.8862514,2447.599354,44.90909091,109919.4619,66,53,53,13,0,14,4,male
857 ms,857,21900 KB,21900,China,Asia,87,393,474.2088866,2532.076794,47.53125,120352.7751,58,42,38,16,4,12,3,male
296 ms,296,38500 KB,38500,Ukraine,Europe,49,331,243.6596322,1858.468958,28.1875,52385.59376,58,48,48,10,0,20,3,male
826 ms,826,51500 KB,51500,India,Asia,15,23,58.60335893,89.8584837,0,0,63,54,50,9,4,10,2,male
234 ms,234,40400 KB,40400,Unknown,Unknown,70,349,359.4212455,2139.119773,54.03125,115579.3152,53,50,49,3,1,11,1,male
342 ms,342,34600 KB,34600,Taiwan,Asia,71,300,366.4572094,1844.924136,44.51612903,82128.88089,64,48,38,16,10,13,2,male
1481 ms,1481,21800 KB,21800,India,Asia,64,344,321.1317371,2064,58.92592593,121623.1111,63,49,41,14,8,16,3,male
1419 ms,1419,20200 KB,20200,Jordan,Asia,73,333,378.8670746,2061.211578,49.33333333,101686.4379,59,46,38,13,8,14,3,male
1418 ms,1418,21000 KB,21000,Ukraine,Europe,64,311,320.0450916,1866,43.68181818,81510.27273,57,37,31,20,6,8,2,male
1544 ms,1544,28600 KB,28600,Tajikistan,Asia,77,380,405.6268983,2381.378885,52.97297297,126148.7193,87,61,44,26,17,17,4,male
1559 ms,1559,19000 KB,19000,India,Asia,73,376,379.6596322,2327.374034,55.09375,128223.7632,78,53,38,25,15,16,3,male
264 ms,264,34900 KB,34900,India,Asia,59,324,290.159225,1905.976348,36,68615.14853,80,62,58,18,4,16,4,male
764 ms,764,15200 KB,15200,India,Asia,81,386,432.6080183,2447.182101,54.32142857,132934.4277,67,48,40,19,8,14,3,male
265 ms,265,34000 KB,34000,India,Asia,55,310,271.4804827,1792.221511,28,50182.20231,80,73,73,7,0,13,2,male
296 ms,296,36400 KB,36400,India,Asia,78,421,412.2613731,2646.154334,49,129661.5624,65,52,47,13,5,14,3,male
327 ms,327,15800 KB,15800,Russia,AsiaEurope,94,419,526.6008455,2746.372729,43.00847458,118117.3017,50,36,33,14,3,13,2,male
343 ms,343,71300 KB,71300,Ukraine,Europe,66,303,333.3240179,1831.451418,37.8,69228.86361,63,47,38,16,9,13,3,male
264 ms,264,17400 KB,17400,Unknown,Unknown,72,283,372.3949821,1746.088775,34,59367.01836,61,39,30,22,9,9,3,male
780 ms,780,19600 KB,19600,Iran,Asia,75,369,392.4020294,2298.434097,55.42857143,127398.9185,68,55,49,13,6,16,3,male
218 ms,218,30700 KB,30700,India,Asia,84,367,453.8154506,2345.980494,41.72340426,97882.29253,54,47,47,7,0,14,2,male
1559 ms,1559,21800 KB,21800,India,Asia,64,358,321.1317371,2148,58.92592593,126572.8889,68,50,41,18,9,17,3,female
1575 ms,1575,25400 KB,25400,India,Asia,64,358,321.1317371,2148,58.92592593,126572.8889,68,50,41,18,9,17,3,female
1497 ms,1497,21800 KB,21800,Bangladesh,Asia,64,364,321.1317371,2184,58.92592593,128694.2222,69,50,41,19,9,17,3,female
249 ms,249,18200 KB,18200,South Africa,Africa,75,328,392.17102,2043.05253,50.83783784,103864.3732,59,45,38,14,7,10,4,female
374 ms,374,32100 KB,32100,China,Asia,72,475,372.2746801,2930.714376,49.18918919,144159.4639,64,56,56,8,0,20,3,female
327 ms,327,32000 KB,32000,Iran,Asia,0,0,0,0,0,0,67,55,49,12,6,20,5,female
295 ms,295,24900 KB,24900,Cuba,North America,85,408,460.0105131,2615.031502,51.11111111,133657.1657,81,56,40,25,16,12,2,female
295 ms,295,18700 KB,18700,Ukraine,Europe,68,371,347.4830616,2258.448714,59.28571429,133893.7452,63,42,39,21,3,16,3,female
1621 ms,1621,21700 KB,21700,Unknown,Unknown,57,315,277.0156616,1837.360354,40.65217391,74692.69267,77,65,64,12,1,12,3,female
1513 ms,1513,13300 KB,13300,China,Asia,84,447,453.092115,2857.365888,53.63636364,153258.7158,64,24,24,40,0,8,2,female
187 ms,187,14900 KB,14900,China,Asia,87,523,473.9427998,3369.659448,48.5106383,163464.3307,51,0,0,51,0,0,2,female
920 ms,920,26000 KB,26000,India,Asia,61,302,303.4631705,1791.082676,36.34782609,65101.96161,77,49,41,28,8,9,2,female
1559 ms,1559,28000 KB,28000,India,Asia,52,277,249.0117739,1579.021802,38.08823529,60142.15393,62,44,39,18,5,11,2,female
342 ms,342,71300 KB,71300,Ukraine,Europe,81,386,432.536756,2447.182101,42.025,102842.8278,77,59,59,18,0,15,4,female
265 ms,265,41600 KB,41600,India,Asia,65,367,326.5538222,2210.208987,26.87096774,59390.4544,72,41,33,31,8,13,2,female
1528 ms,1528,28200 KB,28200,China,Asia,83,500,446.5546348,3187.519716,70.08888889,223409.7152,80,64,56,16,8,18,5,female
264 ms,264,21800 KB,21800,China,Asia,62,365,307.5796744,2173.281653,49.78571429,108198.3795,57,51,51,6,0,11,2,female
264 ms,264,32200 KB,32200,China,Asia,85,519,460.0105131,3326.473896,47.55555556,158192.3142,88,83,83,5,0,22,4,female
217 ms,217,11500 KB,11500,China,Asia,89,461,487.3483806,2985.313112,64.04444444,191192.7197,70,27,21,43,6,9,3,female
311 ms,311,80900 KB,80900,Vietnam,Asia,77,527,406.6799972,3302.596507,52.875,174624.7903,37,29,29,8,0,21,4,female
826 ms,826,57200 KB,57200,China,Asia,78,464,412.4094067,2916.42663,51.8902439,151334.0891,64,52,46,12,6,21,4,female
264 ms,264,18200 KB,18200,China,Asia,94,488,522.16205,3198.63936,41.2173913,131839.5701,48,33,33,15,0,20,8,female
295 ms,295,18200 KB,18200,China,Asia,94,488,522.16205,3198.63936,41.2173913,131839.5701,49,33,33,16,0,20,8,female
841 ms,841,31200 KB,31200,India,Asia,53,374,258.0246044,2142.24225,40.53333333,86832.2192,66,52,47,14,5,14,3,female
1528 ms,1528,21800 KB,21800,Egypt,AsiaAfrica,63,400,314.1308434,2390.911969,45.625,109085.3586,90,57,46,33,11,14,3,female
483 ms,483,57300 KB,57300,Kazakhstan,AsiaEurope,70,471,359.7107722,2886.892301,56.61290323,163435.3545,83,61,54,22,7,21,3,female
280 ms,280,22900 KB,22900,India,Asia,64,410,323.7015572,2460,32.08695652,78933.91304,94,72,64,22,8,19,5,female
810 ms,810,41600 KB,41600,India,Asia,39,389,190.8721876,2056.021463,18,37008.38634,58,36,34,22,2,12,2,female
249 ms,249,21800 KB,21800,Russia,AsiaEurope,71,352,366.1306865,2164.710986,53.625,116082.6266,87,59,39,28,20,16,3,female
233 ms,233,20000 KB,20000,Unknown,Unknown,56,366,274.4798955,2125.491901,27.44444444,58332.94441,86,50,35,36,15,12,2,female
280 ms,280,18900 KB,18900,China,Asia,100,529,564.385619,3514.599924,43.5,152885.0967,50,35,35,15,0,21,8,female
1481 ms,1481,21800 KB,21800,Bangladesh,Asia,60,368,295.6213103,2173.735739,56.7,123250.8164,80,61,54,19,7,15,3,female
264 ms,264,19700 KB,19700,Singapore,Asia,72,372,372.3949821,2295.212101,36.88235294,84652.82277,72,48,41,24,7,13,2,female
1138 ms,1138,41400 KB,41400,Bangladesh,Asia,90,538,495.0699333,3492.616966,62,216542.2519,87,64,53,23,11,22,7,female
311 ms,311,34900 KB,34900,India,Asia,59,390,294.7182822,2294.230789,30.75,70547.59677,74,46,41,28,5,14,3,female
264 ms,264,28600 KB,28600,India,Asia,72,510,372.8771238,3146.661751,55.625,175033.0599,82,64,58,18,6,15,3,female
748 ms,748,15800 KB,15800,Kazakhstan,AsiaEurope,77,433,405.7769322,2713.518572,45.65853659,123895.287,68,46,40,22,6,15,2,female
763 ms,763,21800 KB,21800,Bangladesh,Asia,61,382,302.2137048,2265.541663,58.32,132126.3898,82,62,55,20,7,15,3,female
296 ms,296,27600 KB,27600,India,Asia,74,384,385.6555921,2384.430092,50.14285714,119562.1375,72,57,57,15,0,15,3,female
1512 ms,1512,46200 KB,46200,China,Asia,89,612,487.7378322,3963.14886,65.77083333,260659.6031,85,17,17,68,0,5,1,female
280 ms,280,17400 KB,17400,India,Asia,72,377,372.3949821,2326.061726,37.13157895,86370.3446,87,50,34,37,16,11,4,female
77 ms,77,17200 KB,17200,China,Asia,108,584,622.8406536,3944.854301,73.58196721,290270.1399,63,6,-4,57,10,7,1,female
77 ms,77,17200 KB,17200,China,Asia,108,584,622.8406536,3944.854301,73.58196721,290270.1399,63,6,-4,57,10,7,1,female
763 ms,763,29900 KB,29900,South Korea,Asia,91,479,503.0010296,3117.233633,52.33962264,163154.832,89,62,58,27,4,16,3,female
686 ms,686,29900 KB,29900,South Korea,Asia,91,480,503.0010296,3123.741427,52.33962264,163495.4475,89,62,58,27,4,16,3,female
295 ms,295,19700 KB,19700,India,Asia,74,506,386.4773318,3141.983403,42.28571429,132861.0125,84,68,66,16,2,18,4,female
327 ms,327,42900 KB,42900,Bangladesh,Asia,93,574,516.8946117,3753.477158,59.58333333,223644.6806,100,76,64,24,12,24,7,female
483 ms,483,70600 KB,70600,China,Asia,86,618,466.692323,3971.431618,53.93181818,214186.528,98,75,71,23,4,26,5,female
233 ms,233,17900 KB,17900,Russia,AsiaEurope,67,367,339.6973857,2226.254733,56.90322581,126681.0758,85,51,43,34,8,12,3,female
764 ms,764,35900 KB,35900,India,Asia,50,365,246.0964047,2060.007509,32,65920.2403,80,59,57,21,2,16,4,female
436 ms,436,41600 KB,41600,China,Asia,75,442,392.4020294,2753.137861,35.875,98768.82077,77,67,67,10,0,21,3,female
1434 ms,1434,23600 KB,23600,Russia,AsiaEurope,64,344,320.0450916,2064,47.37096774,97773.67742,74,53,42,21,11,10,2,female
343 ms,343,24700 KB,24700,Poland,Europe,64,398,320.0450916,2388,31.40322581,74990.90323,85,69,62,16,7,12,2,female
265 ms,265,24700 KB,24700,China,Asia,99,531,557.4885414,3520.188365,56.49038462,198856.7947,75,45,42,30,3,15,5,female
1481 ms,1481,18900 KB,18900,Georgia,AsiaEurope,63,450,313.8551855,2689.775966,59.20689655,159253.2873,82,61,54,21,7,19,2,female
155 ms,155,33300 KB,33300,China,Asia,86,602,466.7930215,3868.611382,61.5,237919.6,93,60,49,33,11,26,5,female
342 ms,342,28500 KB,28500,India,Asia,45,300,227.6596322,1647.555929,20.5,33774.89654,85,68,68,17,0,12,2,female
405 ms,405,37400 KB,37400,China,Asia,93,571,517.3960298,3733.859681,52.50909091,196061.5774,78,65,61,13,4,20,4,female
452 ms,452,37400 KB,37400,China,Asia,93,577,517.3960298,3773.094634,52.50909091,198121.7691,78,65,61,13,4,20,4,female
1497 ms,1497,140000 KB,140000,Unknown,Unknown,66,491,336.5164318,2967.797513,50.75,150615.7238,105,66,63,39,3,17,3,female
421 ms,421,40600 KB,40600,Mexico,North America,75,524,392.17102,3263.900994,50.63157895,165256.4608,103,70,60,33,10,16,6,female
280 ms,280,18200 KB,18200,Russia,AsiaEurope,80,442,426.079159,2794.292218,37.43023256,104591.0076,91,47,39,44,8,11,3,female
826 ms,826,22300 KB,22300,India,Asia,0,0,0,0,0,0,86,68,68,18,0,13,2,female
811 ms,811,19600 KB,19600,Iran,Asia,66,357,334.0271833,2157.848701,44.10714286,95176.5409,91,57,45,34,12,14,2,female
327 ms,327,29900 KB,29900,India,Asia,89,622,487.5430078,4027.906194,58.53191489,235761.0626,121,87,82,34,5,23,4,female
311 ms,311,31300 KB,31300,Unknown,Unknown,83,653,446.3456778,4162.900749,54.95454545,228770.3184,91,68,68,23,0,24,5,female
842 ms,842,27500 KB,27500,China,Asia,77,515,407.6639356,3227.395068,48.96774194,158038.2488,91,48,48,43,0,13,5,female
1668 ms,1668,36000 KB,36000,Russia,AsiaEurope,46,433,231.2692727,2391.702327,24.6,58835.87724,116,71,54,45,17,17,2,female
405 ms,405,56300 KB,56300,China,Asia,79,562,421.065676,3542.72478,71.96875,254965.474,87,13,13,74,0,5,2,female
1544 ms,1544,33800 KB,33800,Bangladesh,Asia,60,513,296.1564001,3030.234876,36.75,111361.1317,106,97,92,9,5,29,4,female
295 ms,295,30700 KB,30700,India,Asia,46,430,217.5786534,2375.131641,27.04545455,64236.51484,111,88,78,23,10,18,2,female
389 ms,389,22900 KB,22900,China,Asia,97,611,544.8715078,4032.546747,60.40178571,243573.0245,84,70,70,14,0,21,4,female
826 ms,826,32600 KB,32600,China,Asia,77,533,407.6639356,3340.197226,48.96774194,163561.9158,92,49,49,43,0,13,5,female
436 ms,436,52600 KB,52600,India,Asia,89,563,487.5430078,3645.837922,59.87234043,218284.8492,92,78,78,14,0,25,4,female
280 ms,280,34900 KB,34900,Unknown,Unknown,58,289,283.5668306,1692.956508,42.71428571,72313.42797,108,54,48,54,6,16,4,female
1684 ms,1684,49800 KB,49800,China,Asia,105,823,603.0459669,5525.824061,76.33333333,421804.57,133,74,56,59,18,19,4,female
701 ms,701,66400 KB,66400,India,Asia,50,470,250.4773318,2652.612409,31.5,83557.29089,108,75,68,33,7,18,4,female
810 ms,810,21800 KB,21800,Germany,Europe,43,133,191.698301,721.6932124,32.88235294,23730.97092,93,73,67,20,6,18,4,female
888 ms,888,66400 KB,66400,India,Asia,50,467,250.4773318,2635.680841,31.5,83023.94648,108,75,68,33,7,18,4,female
1528 ms,1528,64100 KB,64100,Russia,AsiaEurope,60,512,297.5287411,3024.327985,69.95454545,211565.4895,98,82,74,16,8,24,3,female
811 ms,811,35300 KB,35300,India,Asia,58,391,285.8598074,2290.470569,38.95,89213.82867,106,87,84,19,3,9,3,female
436 ms,436,31700 KB,31700,China,Asia,97,560,543.5562547,3695.951192,63.60576923,235083.8186,104,74,51,30,23,26,3,female
265 ms,265,51000 KB,51000,China,Asia,86,619,467.1963626,3977.857883,60.85897436,242088.3509,129,68,49,61,19,25,5,female
373 ms,373,28900 KB,28900,Ukraine,Europe,66,529,333.6312234,3197.484489,69.53448276,222335.4301,108,64,56,44,8,20,3,female
467 ms,467,35400 KB,35400,China,Asia,80,593,426.6582949,3748.90336,49.38888889,185154.1715,103,79,79,24,0,23,4,female
249 ms,249,28900 KB,28900,Russia,AsiaEurope,97,510,543.5562547,3365.95555,53.65384615,180596.4612,91,66,57,25,9,24,7,female
264 ms,264,28900 KB,28900,Russia,AsiaEurope,97,512,543.5562547,3379.155375,53.65384615,181304.6826,91,66,57,25,9,24,7,female
467 ms,467,76700 KB,76700,China,Asia,85,574,459.8067162,3678.990397,55.6744186,204825.6514,113,33,33,80,0,9,1,female
249 ms,249,21800 KB,21800,Russia,AsiaEurope,90,487,494.5555318,3161.532458,49.875,157681.4313,89,43,36,46,7,9,3,female
1544 ms,1544,49900 KB,49900,Bangladesh,Asia,66,554,333.3240179,3348.594342,52.2,174796.6247,132,98,70,34,28,26,4,female
280 ms,280,35300 KB,35300,Belarus,Europe,45,439,212.7441865,2410.923509,24.5,59067.62598,156,70,17,86,53,20,6,female
951 ms,951,23300 KB,23300,Bangladesh,Asia,91,638,501.8524417,4151.97298,72.57,301308.6792,109,39,13,70,26,12,2,female
436 ms,436,35900 KB,35900,Syria,Asia,81,580,432.9647657,3677.113002,57.18181818,210264.0071,112,69,53,43,16,19,3,female
233 ms,233,30300 KB,30300,Japan,Asia,97,673,544.8715078,4441.741343,61.86607143,274793.0872,93,44,37,49,7,17,4,female
373 ms,373,74100 KB,74100,India,Asia,85,539,460.0105131,3454.661715,48.88888889,168894.5727,94,78,78,16,0,17,3,female
342 ms,342,59600 KB,59600,South Korea,Asia,94,596,522.6230769,3906.534956,63.23529412,247030.8869,113,94,81,19,13,26,6,female
264 ms,264,53800 KB,53800,Russia,AsiaEurope,63,499,320.925614,2982.662682,32.42105263,96701.06379,138,65,46,73,19,19,6,female
249 ms,249,23300 KB,23300,India,Asia,81,685,432.536756,4342.797252,59.45,258179.2966,124,88,88,36,0,21,6,female
1543 ms,1543,32300 KB,32300,China,Asia,114,739,665.3547617,5049.50572,76.02459016,383886.6029,98,74,70,24,4,31,7,female
889 ms,889,35200 KB,35200,Iran,Asia,74,582,385.6555921,3613.901859,80.22857143,289938.1834,115,81,68,34,13,23,5,female
248 ms,248,30300 KB,30300,Japan,Asia,96,675,536.6378566,4444.849688,68.11538462,302762.6461,99,50,44,49,6,17,4,female
436 ms,436,26200 KB,26200,Japan,Asia,84,738,452.9890166,4717.530258,82.85365854,390864.6411,152,115,98,37,17,28,5,female
1637 ms,1637,63900 KB,63900,Unknown,Unknown,60,477,304.2149912,2817.586814,33,92980.36487,118,69,52,49,17,18,4,female
265 ms,265,25300 KB,25300,Iran,Asia,48,502,244.9390249,2803.651175,25.8,72334.20032,113,56,26,57,30,22,6,female
811 ms,811,24300 KB,24300,China,Asia,100,740,565.4268669,4916.45358,70.71428571,347663.5032,110,85,84,25,1,25,8,female
374 ms,374,33900 KB,33900,China,Asia,88,701,480.9553238,4528.061565,80.83333333,366018.3098,121,94,82,27,12,27,9,female
280 ms,280,37400 KB,37400,Russia,AsiaEurope,90,552,495.424379,3583.502909,45.11764706,161679.2195,128,68,45,60,23,12,3,female
265 ms,265,21800 KB,21800,Bulgaria,Europe,108,694,624.7832923,4687.891927,62.18461538,291514.7564,130,81,67,49,14,32,14,female
467 ms,467,31600 KB,31600,South Korea,Asia,107,804,615.8588276,5420.139457,93.50819672,506827.4666,88,62,57,26,5,26,10,female
327 ms,327,43600 KB,43600,Japan,Asia,84,792,452.9890166,5062.715399,82.85365854,419464.4929,162,122,105,40,17,29,6,female
607 ms,607,41300 KB,41300,United States,North America,95,668,530.851908,4388.663546,53.09090909,232998.1374,149,81,59,68,22,18,6,female
295 ms,295,33700 KB,33700,Bangladesh,Asia,91,642,501.4075845,4178.004159,85.55208333,357436.96,129,62,44,67,18,25,8,female
545 ms,545,93800 KB,93800,Belarus,Europe,112,780,653.0138619,5309.736839,64.12121212,340466.7622,134,97,96,37,1,28,5,female
295 ms,295,34800 KB,34800,India,Asia,52,535,259.6966127,3049.735249,29.4,89662.21633,125,110,108,15,2,32,9,female
389 ms,389,37500 KB,37500,India,Asia,87,675,473.7434822,4348.98686,69.9673913,304287.2654,114,91,86,23,5,31,7,female
1512 ms,1512,21700 KB,21700,Bangladesh,Asia,82,478,439.6362367,3038.909858,34.97727273,106292.7789,105,55,47,50,8,13,3,female
889 ms,889,19500 KB,19500,Vietnam,Asia,63,318,314.1308434,1900.775016,38.125,72467.04747,133,57,55,76,2,14,2,female
327 ms,327,36900 KB,36900,India,Asia,52,536,259.6966127,3055.435689,29.4,89829.80925,131,112,110,19,2,32,9,female
826 ms,826,21000 KB,21000,Unknown,Unknown,99,583,558.5412601,3864.91491,58.35714286,225545.3915,125,63,34,62,29,19,6,female
249 ms,249,30700 KB,30700,India,Asia,88,685,480.7253082,4424.710659,65.42553191,289489.0484,163,110,108,53,2,28,9,female
264 ms,264,27500 KB,27500,India,Asia,119,821,703.680997,5660.645384,75.36231884,426599.3622,169,115,97,54,18,32,12,female
920 ms,920,20900 KB,20900,China,Asia,110,1039,637.6343112,7045.832742,115.2619048,812116.1025,158,5,-9,153,14,1,1,female
810 ms,810,38000 KB,38000,India,Asia,0,0,0,0,0,0,225,153,114,72,39,37,10,female
451 ms,451,46400 KB,46400,India,Asia,95,746,529.5086837,4901.112284,72.90196078,357300.6955,149,118,110,31,8,36,6,female
498 ms,498,112100 KB,112100,Iran,Asia,0,0,0,0,0,0,124,84,72,40,12,22,4,female
233 ms,233,24400 KB,24400,India,Asia,80,753,426.6582949,4760.411855,55.92857143,266243.0345,185,133,125,52,8,23,9,female
311 ms,311,22100 KB,22100,India,Asia,80,580,426.6582949,3666.718295,46.92857143,172073.8514,130,78,77,52,1,14,3,female
405 ms,405,34300 KB,34300,Bangladesh,Asia,124,1033,744.345223,7183.684789,64.87179487,466018.526,187,96,48,91,48,31,8,female
264 ms,264,29600 KB,29600,India,Asia,93,508,515.2115894,3321.892676,45.86666667,152364.1441,184,54,16,130,38,17,4,female
233 ms,233,115800 KB,115800,China,Asia,70,1098,368.6313714,6729.952753,41.25,277610.551,191,143,128,48,15,51,19,female
514 ms,514,42200 KB,42200,China,Asia,110,988,638.08385,6699.983397,76.1875,510454.9851,140,79,64,61,15,21,5,female
842 ms,842,30700 KB,30700,China,Asia,101,565,575.2908578,3761.889488,39,146713.69,132,51,41,81,10,18,4,female
1668 ms,1668,77100 KB,77100,Bangladesh,Asia,104,732,594.2093292,4904.721874,41.18644068,202008.0365,133,70,61,63,9,17,2,female
374 ms,374,30900 KB,30900,India,Asia,77,792,406.0022373,4963.29494,46.2,229304.2262,241,171,142,70,29,41,14,female
312 ms,312,51500 KB,51500,China,Asia,127,1214,764.7353731,8484.26321,98.7012987,837407.7973,172,23,23,149,0,9,4,female
327 ms,327,43600 KB,43600,Japan,Asia,98,1269,550.2415647,8394.066792,92.5,776451.1783,261,193,165,68,28,46,17,female
467 ms,467,21900 KB,21900,Bangladesh,Asia,93,739,518.5920309,4832.438361,50.52631579,244165.3067,189,49,31,140,18,13,4,female
358 ms,358,141800 KB,141800,China,Asia,153,1665,967.9654031,12083.55076,86.92,1050302.232,139,66,61,73,5,51,34,female
436 ms,436,30300 KB,30300,China,Asia,138,1309,848.3780137,9305.058514,114.4176471,1064662.901,199,123,84,76,39,56,21,female
311 ms,311,30300 KB,30300,China,Asia,144,1313,894.3150596,9414.111527,113.0898876,1064640.815,199,123,84,76,39,55,20,female
296 ms,296,141800 KB,141800,China,Asia,161,1719,1032.100893,12601.84611,88.06542056,1109786.878,141,68,63,73,5,53,34,female
327 ms,327,141800 KB,141800,China,Asia,161,1719,1032.100893,12601.84611,88.06542056,1109786.878,141,68,63,73,5,53,34,female
483 ms,483,15300 KB,15300,India,Asia,108,1044,621.7684232,7052.102552,89.47368421,630977.5968,295,169,146,126,23,42,12,female
311 ms,311,32000 KB,32000,South Korea,Asia,143,1433,881.4725755,10260.09563,96.42857143,989366.3639,207,109,70,98,39,55,33,female
296 ms,296,25400 KB,25400,India,Asia,125,1567,746.422204,10915.38397,116.0955882,1267227.923,295,195,159,100,36,52,24,female
265 ms,265,20000 KB,20000,India,Asia,16,253,55.30296891,1012,7,7084,256,83,72,173,11,26,8,female
280 ms,280,53200 KB,53200,China,Asia,6,14,15.509775,36.18947501,0,0,190,108,108,82,0,81,40,female
280 ms,280,25400 KB,25400,India,Asia,136,2041,829.6185035,14465.51166,154.012987,2227876.659,369,249,206,120,43,72,29,female
405 ms,405,44000 KB,44000,India,Asia,135,2045,821.9184309,14472.0879,156.0394737,2258216.978,370,250,207,120,43,72,29,female
358 ms,358,34600 KB,34600,Bangladesh,Asia,49,373,235.7693245,2094.286772,30.83333333,64573.84213,285,68,23,217,45,34,18,female
233 ms,233,17200 KB,17200,China,Asia,71,321,366.1306865,1974.068825,29.12820513,57501.08168,105,38,38,67,0,13,3,female
31 ms,31,0 KB,0,India,Asia,27,124,128.3819626,589.6060503,0,0,13,9,9,4,0,5,2,male
31 ms,31,0 KB,0,China,Asia,43,135,193.2092968,732.5457419,28,20511.28077,17,10,8,7,2,6,2,male
31 ms,31,0 KB,0,India,Asia,56,149,269.2634114,865.2958834,23.62962963,20446.62124,14,10,10,4,0,5,2,male
31 ms,31,0 KB,0,China,Asia,55,169,263.0928815,977.0497916,25.65384615,25065.08504,17,13,13,4,0,6,2,male
31 ms,31,300 KB,300,China,Asia,32,121,145.6363364,605,14.5,8772.5,20,15,15,5,0,7,2,male
31 ms,31,0 KB,0,China,Asia,32,123,145.6363364,615,14.5,8917.5,20,15,15,5,0,7,2,male
31 ms,31,0 KB,0,India,Asia,28,130,134.6059378,624.9561399,0,0,15,11,11,4,0,5,2,male
46 ms,46,0 KB,0,India,Asia,29,128,126.9663202,621.8215674,13,8083.680376,18,15,15,3,0,6,2,male
31 ms,31,0 KB,0,China,Asia,45,162,205.8100768,889.6802016,26,23131.68524,26,21,21,5,0,7,2,male
31 ms,31,0 KB,0,United States,North America,31,122,142.8814489,604.4119499,14.5,8763.973273,24,19,19,5,0,7,2,male
31 ms,31,300 KB,300,South Korea,Asia,42,160,185.583273,862.7707876,16.91176471,14590.97656,23,17,15,6,2,5,2,male
30 ms,30,0 KB,0,Iran,Asia,44,152,197.8688309,829.833606,29.38235294,24382.46389,30,24,24,6,0,7,3,male
31 ms,31,0 KB,0,China,Asia,54,177,256.9778536,1018.615088,16.81034483,17123.27087,23,18,18,5,0,5,2,male
31 ms,31,0 KB,0,China,Asia,54,177,256.9778536,1018.615088,16.81034483,17123.27087,23,18,18,5,0,5,2,male
31 ms,31,0 KB,0,Unknown,Unknown,45,177,202.2777659,972.0579981,21.14285714,20552.08339,26,22,21,4,1,6,2,male
31 ms,31,3600 KB,3600,Vietnam,Asia,54,159,257.6220106,915.0271128,37.06521739,33915.67886,28,20,17,8,3,6,3,male
31 ms,31,0 KB,0,Vietnam,Asia,41,130,181.6849315,696.4817606,23.14285714,16118.57789,27,17,15,10,2,6,2,male
31 ms,31,0 KB,0,Iran,Asia,29,129,140.8814489,626.6795484,0,0,19,13,11,6,2,6,2,male
31 ms,31,0 KB,0,China,Asia,47,169,216.6935862,938.7255159,25.58823529,24020.32938,17,13,13,4,0,7,2,male
31 ms,31,200 KB,200,China,Asia,31,121,142.8814489,599.4577536,14.5,8692.137427,33,28,28,5,0,6,2,male
46 ms,46,3900 KB,3900,Russia,AsiaEurope,27,100,114.7939875,475.4887502,12,5705.865003,27,17,12,10,5,5,2,male
31 ms,31,0 KB,0,Egypt,AsiaAfrica,32,112,142.6059378,560,17.5,9800,27,22,21,5,1,5,2,male
31 ms,31,0 KB,0,China,Asia,41,160,181.6849315,857.2083207,19.28571429,16531.87476,23,19,19,4,0,7,2,male
31 ms,31,0 KB,0,China,Asia,44,178,200.5096868,971.7788281,31.07142857,30194.55645,30,25,25,5,0,6,2,male
31 ms,31,0 KB,0,China,Asia,36,119,171.2198934,615.2210752,16.5,10151.14774,19,15,15,4,0,6,3,male
31 ms,31,0 KB,0,China,Asia,39,151,170.317149,798.095735,18,14365.72323,34,27,24,7,3,5,2,male
31 ms,31,800 KB,800,South Korea,Asia,34,128,172.9737366,651.1952437,0,0,39,34,34,5,0,8,2,male
46 ms,46,0 KB,0,Bulgaria,Europe,36,145,171.2198934,749.6391252,22,16492.06075,31,27,27,4,0,8,3,male
31 ms,31,0 KB,0,China,Asia,37,109,171.6096405,567.8304169,19.2,10902.344,31,26,25,5,1,7,2,male
30 ms,30,0 KB,0,Mexico,North America,33,133,143.8917376,670.9044179,18,12076.27952,30,22,17,8,5,6,2,male
31 ms,31,0 KB,0,Indonesia,Asia,37,115,177.7286241,599.087137,17,10184.48133,36,29,26,7,3,6,2,male
46 ms,46,0 KB,0,China,Asia,34,118,162,600.3206153,16,9605.129844,37,33,33,4,0,5,2,male
31 ms,31,0 KB,0,China,Asia,42,167,186.2114327,900.5170096,21.9375,19755.0919,34,27,24,7,3,6,2,male
31 ms,31,0 KB,0,Finland,Europe,33,119,151.9616054,600.2829002,15,9004.243503,38,20,12,18,8,6,2,male
46 ms,46,0 KB,0,India,Asia,29,130,130.3819626,631.5375294,13.5,8525.756646,36,28,25,8,3,6,2,male
31 ms,31,0 KB,0,Ukraine,Europe,45,146,202.1494206,801.8105521,25.09090909,20118.15567,30,21,17,9,4,5,2,male
31 ms,31,0 KB,0,India,Asia,30,118,136.6059378,579.0130903,14,8106.183264,32,20,15,12,5,6,2,male
31 ms,31,0 KB,0,South Korea,Asia,35,128,156.3912239,656.5482262,19.33333333,12693.26571,30,22,19,8,3,6,2,male
46 ms,46,0 KB,0,China,Asia,45,140,204.8814489,768.8594335,29,22296.92357,26,23,23,3,0,6,2,female
31 ms,31,0 KB,0,Syria,Asia,30,112,136.6059378,549.5717467,14,7694.004454,29,20,15,9,5,6,2,male
31 ms,31,0 KB,0,Egypt,AsiaAfrica,50,157,232.7134334,886.0854218,25.45454545,22554.90165,25,20,18,5,2,5,2,male
31 ms,31,0 KB,0,Iran,Asia,34,131,150.1157128,666.4576322,18.66666667,12440.54247,29,21,16,8,5,6,2,male
46 ms,46,0 KB,0,China,Asia,58,214,281.8126557,1253.607933,34.06666667,42706.24358,25,18,15,7,3,5,2,male
31 ms,31,0 KB,0,China,Asia,37,126,171.6096405,656.3911241,19.2,12602.70958,37,24,16,13,8,6,3,male
31 ms,31,0 KB,0,India,Asia,34,108,152.4910893,549.4459869,14.5,7966.966809,30,24,23,6,1,5,2,male
46 ms,46,0 KB,0,Romania,Europe,43,160,190.4804869,868.2023608,24.15,20967.08701,31,24,20,7,4,7,3,male
31 ms,31,3700 KB,3700,Taiwan,Asia,41,165,185.2604657,883.9960808,19.09090909,16876.28881,27,23,23,4,0,6,2,male
31 ms,31,0 KB,0,China,Asia,31,123,142.8814489,609.3661462,14.5,8835.80912,31,22,18,9,4,6,2,male
31 ms,31,0 KB,0,United States,North America,40,131,180.4259988,697.1725804,18,12549.10645,26,21,19,5,2,6,2,male
31 ms,31,0 KB,0,South Korea,Asia,38,159,167.8252188,834.4204746,16.8,14018.26397,30,20,17,10,3,6,2,male
31 ms,31,0 KB,0,China,Asia,31,110,142.8814489,544.9615941,14.5,7901.943115,30,24,22,6,2,6,2,male
31 ms,31,0 KB,0,Ukraine,Europe,39,127,181.9747809,671.2460818,22,14767.4138,32,24,20,8,4,6,2,male
31 ms,31,0 KB,0,Bangladesh,Asia,33,109,155.5800856,549.838959,15.5,8522.503865,32,24,20,8,4,7,2,male
31 ms,31,0 KB,0,Bangladesh,Asia,32,136,139.991603,680,13.5,9180,40,28,20,12,8,6,2,male
31 ms,31,300 KB,300,India,Asia,33,127,146.2155783,640.6380532,19.6,12556.50584,31,21,15,10,6,6,2,male
31 ms,31,0 KB,0,Serbia,Europe,36,133,174.9737366,687.6000252,17,11689.20043,27,19,16,8,3,6,2,female
31 ms,31,0 KB,0,South Korea,Asia,35,132,158.8163583,677.0653582,18,12187.17645,30,14,11,16,3,5,2,male
31 ms,31,0 KB,0,China,Asia,35,174,152.3819626,892.4952449,16.875,15060.85726,44,41,40,3,1,9,2,male
31 ms,31,0 KB,0,Ukraine,Europe,32,159,160,795,0,0,28,22,22,6,0,6,2,male
31 ms,31,0 KB,0,China,Asia,51,165,242.4606049,935.9501814,32,29950.40581,32,21,18,11,3,6,2,male
31 ms,31,0 KB,0,China,Asia,53,239,250.9205489,1368.972989,51.35416667,70302.46702,26,18,15,8,3,7,2,male
31 ms,31,0 KB,0,China,Asia,33,153,151.9616054,771.7923003,15,11576.8845,32,24,24,8,0,7,2,male
46 ms,46,300 KB,300,China,Asia,48,174,220.1383297,971.7834751,30.43478261,29576.01881,24,16,12,8,4,5,2,male
31 ms,31,200 KB,200,China,Asia,32,135,145.6363364,675,14.5,9787.5,41,25,16,16,9,6,2,male
31 ms,31,0 KB,0,China,Asia,32,136,145.6363364,680,14.5,9860,41,25,16,16,9,6,2,male
31 ms,31,300 KB,300,China,Asia,57,217,275.5886804,1265.737133,40,50629.48532,33,25,21,8,4,9,2,female
31 ms,31,0 KB,0,Iran,Asia,44,172,197.8688309,939.0222384,27,25353.60044,29,16,11,13,5,6,2,male
31 ms,31,0 KB,0,South Korea,Asia,35,136,158.8163583,697.5824903,18,12556.48483,30,14,11,16,3,5,2,male
31 ms,31,200 KB,200,China,Asia,33,136,151.9616054,686.0376002,15,10290.564,28,22,20,6,2,8,2,male
31 ms,31,300 KB,300,China,Asia,32,139,149.2067179,695,15,10425,29,25,25,4,0,6,2,male
31 ms,31,0 KB,0,China,Asia,32,139,149.2067179,695,15,10425,29,25,25,4,0,6,2,male
46 ms,46,0 KB,0,India,Asia,42,179,187.9089067,965.2248187,32,30887.1942,33,24,19,9,5,5,2,male
31 ms,31,0 KB,0,Vietnam,Asia,48,143,220.6206284,798.6496376,28.28571429,22590.37546,33,24,21,9,3,5,2,male
31 ms,31,0 KB,0,Croatia,Europe,32,128,145.6363364,640,14.5,9280,41,26,19,15,7,6,2,male
31 ms,31,0 KB,0,India,Asia,32,152,145.6363364,760,19.33333333,14693.33333,33,25,25,8,0,7,2,male
31 ms,31,0 KB,0,South Korea,Asia,32,132,139.991603,660,13.5,8910,39,35,35,4,0,7,2,male
46 ms,46,0 KB,0,Bangladesh,Asia,30,155,136.6059378,760.5680423,14,10647.95259,29,23,21,6,2,6,2,male
31 ms,31,0 KB,0,China,Asia,44,182,197.8688309,993.6165546,36.52941176,36296.22826,29,14,11,15,3,5,2,male
31 ms,31,0 KB,0,Singapore,Asia,41,196,179.5259683,1050.080193,29.64705882,31131.78925,34,23,16,11,7,8,3,male
31 ms,31,0 KB,0,Argentina,South America,38,127,175.509775,666.4867942,21.33333333,14218.38494,39,27,20,12,7,10,3,male
31 ms,31,3700 KB,3700,China,Asia,56,269,269.6764904,1562.178474,46.77419355,73069.6383,19,14,14,5,0,6,2,male
31 ms,31,0 KB,0,India,Asia,29,139,126.9663202,675.2593583,13,8778.371658,35,21,14,14,7,7,2,male
31 ms,31,0 KB,0,Iran,Asia,37,149,169.0898606,776.2085515,18.08333333,14036.43797,41,25,19,16,6,6,2,male
31 ms,31,200 KB,200,Cuba,North America,27,130,118.0964047,618.1353753,12.5,7726.692191,37,23,14,14,9,5,2,male
31 ms,31,0 KB,0,China,Asia,42,172,186.9853215,927.4785967,15.3,14190.42253,31,27,27,4,0,8,2,female
31 ms,31,0 KB,0,Indonesia,Asia,49,165,227.3200108,926.4271243,23.2,21493.10928,29,20,16,9,4,6,2,male
31 ms,31,0 KB,0,Indonesia,Asia,33,139,143.8917376,701.1707826,13.5,9465.805565,30,20,13,10,7,7,2,male
31 ms,31,0 KB,0,Romania,Europe,27,133,114.7939875,632.4000378,12,7588.800453,22,11,6,11,5,6,2,male
31 ms,31,0 KB,0,China,Asia,29,126,130.3819626,612.1056054,13.5,8263.425673,31,22,19,9,3,7,2,female
46 ms,46,3900 KB,3900,Japan,Asia,36,183,153.05865,946.0962753,14,13245.34785,31,22,17,9,5,7,2,female
31 ms,31,0 KB,0,China,Asia,52,158,246.4385619,900.6694755,27.2,24498.20973,30,18,14,12,4,6,2,female
31 ms,31,0 KB,0,China,Asia,42,175,191.6338334,943.655549,28.18181818,26593.92911,40,22,16,18,6,6,2,female
31 ms,31,200 KB,200,China,Asia,29,160,126.9663202,777.2769592,13,10104.60047,42,20,18,22,2,6,2,female
31 ms,31,0 KB,0,India,Asia,35,160,179.5249056,820.6852827,0,0,35,25,20,10,5,11,4,female
31 ms,31,0 KB,0,Bangladesh,Asia,48,211,224,1178.427088,23,27103.82302,33,29,28,4,1,7,2,female
46 ms,46,0 KB,0,India,Asia,33,147,155.5800856,741.5259355,15.5,11493.652,43,36,34,7,2,7,2,female
31 ms,31,0 KB,0,China,Asia,72,292,372.3949821,1801.6181,35.20588235,63427.55489,39,30,29,9,1,14,3,female
31 ms,31,0 KB,0,China,Asia,39,169,181.9747809,893.232975,19.25,17194.73477,30,22,22,8,0,8,2,female
30 ms,30,0 KB,0,China,Asia,60,285,294.4134357,1683.46382,34,57237.76987,46,40,40,6,0,10,4,female
31 ms,31,0 KB,0,Russia,AsiaEurope,34,134,162,681.7200207,16,10907.52033,47,31,20,16,11,6,2,female
31 ms,31,0 KB,0,China,Asia,76,306,399.4510684,1911.865819,31.97619048,61134.1856,34,15,15,19,0,7,2,female
31 ms,31,0 KB,0,China,Asia,49,212,231.5770955,1190.318487,39.66666667,47215.96665,34,27,27,7,0,8,4,female
30 ms,30,0 KB,0,China,Asia,47,214,227.9505705,1188.682014,31.66666667,37641.59712,31,13,12,18,1,6,2,female
31 ms,31,0 KB,0,China,Asia,49,214,231.5770955,1201.547907,26.06666667,31320.34877,36,24,24,12,0,8,3,female
31 ms,31,0 KB,0,Finland,Europe,37,308,169.0898606,1604.511637,20.66666667,33159.90716,38,30,30,8,0,7,3,female
31 ms,31,0 KB,0,China,Asia,52,256,248.0323866,1459.312568,45.33333333,66155.50308,38,20,13,18,7,5,2,female
31 ms,31,0 KB,0,Ukraine,Europe,58,284,284.2247957,1663.666603,49.09090909,81670.90595,46,29,26,17,3,13,2,female
31 ms,31,0 KB,0,China,Asia,64,177,320,1062,27.5,29205,33,22,22,11,0,13,6,female
31 ms,31,0 KB,0,Unknown,Unknown,111,568,655.5163002,3859.228212,49.8961039,192560.4518,19,17,17,2,0,16,6,female
31 ms,31,0 KB,0,Ukraine,Europe,58,290,284.2247957,1698.814489,49.09090909,83396.34762,49,32,29,17,3,15,2,female
31 ms,31,0 KB,0,Iran,Asia,35,156,156.3912239,800.1681506,19.33333333,15469.91758,46,26,20,20,6,7,2,female
31 ms,31,0 KB,0,Bulgaria,Europe,42,197,194.994331,1062.286532,22,23370.30371,66,45,30,21,15,9,4,female
31 ms,31,0 KB,0,Russia,AsiaEurope,52,206,244.4783673,1174.290582,31.32,36778.78103,53,36,30,17,6,8,3,female
46 ms,46,0 KB,0,China,Asia,61,253,302.2137048,1500.476546,28.8,43213.72454,47,26,26,21,0,7,2,female
31 ms,31,15800 KB,15800,China,Asia,101,524,575.9898807,3488.902817,56.3968254,196763.043,45,39,39,6,0,24,8,female
31 ms,31,0 KB,0,Iran,Asia,28,169,124.2114327,812.4429818,13,10561.75876,49,26,19,23,7,6,2,female
31 ms,31,0 KB,0,India,Asia,43,264,203.5249056,1432.533895,19.6875,28203.01106,50,24,18,26,6,6,3,female
31 ms,31,0 KB,0,China,Asia,53,291,252.2386659,1666.824852,32,53338.39527,71,28,18,43,10,6,3,female
31 ms,31,100 KB,100,China,Asia,79,410,419.0078103,2584.550107,47.17948718,121937.7486,54,44,44,10,0,25,8,female
31 ms,31,200 KB,200,Singapore,Asia,52,341,247.1756287,1943.849944,29.52631579,57394.72729,55,31,18,24,13,9,3,female
31 ms,31,0 KB,0,Russia,AsiaEurope,69,388,352.4986422,2370.107489,65.88235294,156148.2581,66,46,38,20,8,11,5,female
31 ms,31,0 KB,0,India,Asia,49,253,228.6387356,1420.521591,27.55555556,39143.26161,54,33,28,21,5,7,3,female
31 ms,31,0 KB,0,Belarus,Europe,38,171,173.2315701,897.3956048,19.92857143,17883.81241,57,29,20,28,9,8,2,female
31 ms,31,0 KB,0,Unknown,Unknown,74,372,386.1246381,2309.916652,40.37878788,93271.63451,56,38,34,18,4,13,5,female
31 ms,31,0 KB,0,Unknown,Unknown,35,271,168.4650059,1390.035698,16.5,22935.58901,77,43,28,34,15,11,4,female
31 ms,31,0 KB,0,Lithuania,Europe,45,347,212.7441865,1905.673024,35,66698.55585,67,47,32,20,15,9,2,female
31 ms,31,0 KB,0,Iran,Asia,69,393,352.4986422,2400.650112,39.11764706,93907.78377,81,53,41,28,12,11,5,female
46 ms,46,35200 KB,35200,Russia,AsiaEurope,61,367,300.7868035,2176.580603,44.03225806,95839.7588,87,49,49,38,0,7,2,female
31 ms,31,0 KB,0,China,Asia,81,395,435.1207824,2504.240751,38.28125,95865.46625,54,33,30,21,3,17,6,female
31 ms,31,300 KB,300,China,Asia,15,40,50.10571634,156.2756238,6.5,1015.791555,68,45,42,23,3,22,10,female
31 ms,31,200 KB,200,Cuba,North America,92,532,511.3291757,3470.534961,52.07142857,180715.7133,88,49,25,39,24,11,5,female
31 ms,31,200 KB,200,Ukraine,Europe,56,364,271.0812322,2113.877192,30.13636364,63704.57173,67,20,11,47,9,7,3,female
31 ms,31,0 KB,0,India,Asia,47,269,222.5444556,1494.184401,21.875,32685.28377,63,37,31,26,6,11,4,female
31 ms,31,0 KB,0,China,Asia,61,269,304.2381821,1595.368344,27.47727273,43836.37108,63,19,12,44,7,7,1,female
46 ms,46,0 KB,0,Unknown,Unknown,38,285,178.0746464,1495.659341,23.1,34549.73078,85,57,45,28,12,13,6,female
31 ms,31,0 KB,0,India,Asia,68,437,347.0121354,2660.221262,59.17241379,157411.7133,77,46,45,31,1,15,5,female
31 ms,31,0 KB,0,Russia,AsiaEurope,69,374,352.582306,2284.588147,49.5,113087.1133,76,34,24,42,10,10,3,female
31 ms,31,3700 KB,3700,India,Asia,68,380,345.9899115,2313.23588,71.06060606,164379.9436,67,28,16,39,12,5,2,female
46 ms,46,200 KB,200,China,Asia,42,408,210.885574,2200.065508,19.5,42901.27742,89,46,38,43,8,9,3,female
31 ms,31,0 KB,0,Iran,Asia,0,0,0,0,0,0,50,17,10,33,7,7,2,female
31 ms,31,0 KB,0,Russia,AsiaEurope,46,332,219.336581,1833.822569,27,49513.20937,105,35,18,70,17,10,4,female
31 ms,31,1800 KB,1800,China,Asia,64,624,324.5848274,3744,34.36363636,128657.4545,86,44,33,42,11,19,4,female
31 ms,31,0 KB,0,Russia,AsiaEurope,51,288,241.523656,1633.658498,24.75,40433.04784,72,18,12,54,6,6,3,female
46 ms,46,0 KB,0,Bulgaria,Europe,89,529,487.5430078,3425.662985,65.23404255,223469.8449,73,50,40,23,10,23,14,female
46 ms,46,0 KB,0,India,Asia,47,331,227.9505705,1838.56891,21.11111111,38814.23254,103,51,40,52,11,7,2,female
31 ms,31,0 KB,0,Taiwan,Asia,41,327,204.176133,1751.919506,19,33286.4706,72,42,38,30,4,8,1,female
31 ms,31,200 KB,200,China,Asia,71,504,370.1802547,3099.472548,66.24,205309.0616,74,42,39,32,3,19,8,female
31 ms,31,300 KB,300,China,Asia,106,607,608.4972857,4083.847716,32.58333333,133065.3714,85,61,55,24,6,33,12,female
31 ms,31,0 KB,0,Russia,AsiaEurope,81,551,432.75063,3493.257352,71.13953488,248508.7032,95,52,44,43,8,14,4,female
31 ms,31,0 KB,0,India,Asia,81,659,436.5004103,4177.961152,102.6470588,428855.4241,62,33,33,29,0,14,7,female
31 ms,31,0 KB,0,India,Asia,45,457,212.7441865,2509.776865,24.5,61489.53319,151,108,91,43,17,26,11,female
31 ms,31,100 KB,100,China,Asia,62,561,314.0400072,3340.30413,43,143633.0776,127,86,84,41,2,12,6,female
31 ms,31,0 KB,0,China,Asia,73,546,378.8670746,3379.644209,52.41666667,177149.684,84,31,19,53,12,6,3,female
31 ms,31,0 KB,0,China,Asia,107,1025,615.8588276,6910.003661,175.704918,1214121.627,71,27,24,44,3,33,9,female
31 ms,31,40700 KB,40700,India,Asia,49,414,241.4064488,2324.489875,28.88888889,67151.92974,143,63,56,80,7,15,3,female
31 ms,31,0 KB,0,Japan,Asia,101,648,572.0586342,4314.521041,51.43636364,221923.2732,126,85,63,41,22,28,21,female
46 ms,46,200 KB,200,Russia,AsiaEurope,98,821,550.7131734,5430.676782,84.48113208,458789.7225,142,66,55,76,11,12,4,female
31 ms,31,0 KB,0,Russia,AsiaEurope,134,1115,815.0172944,7878.689447,117.3311688,924415.8417,156,95,83,61,12,40,18,female
31 ms,31,0 KB,0,India,Asia,86,704,469.3966019,4524.090387,70.35294118,318283.0649,150,81,65,69,16,37,20,female
31 ms,31,0 KB,0,China,Asia,113,1809,659.9956879,12337.70374,236.4242424,2916932.261,170,141,124,29,17,70,51,female
31 ms,31,0 KB,0,China,Asia,113,1809,659.9956879,12337.70374,236.4242424,2916932.261,170,141,124,29,17,70,51,female
46 ms,46,3700 KB,3700,Russia,AsiaEurope,96,587,536.9091685,3865.372988,40.16037736,155234.8378,138,55,40,83,15,17,9,female
31 ms,31,200 KB,200,India,Asia,18,58,63.35824644,241.8556501,7.5,1813.917376,126,33,24,93,9,13,6,female
31 ms,31,200 KB,200,India,Asia,18,58,63.35824644,241.8556501,7.5,1813.917376,128,35,26,93,9,13,6,female
31 ms,31,0 KB,0,China,Asia,6,14,15.509775,36.18947501,0,0,138,55,55,83,0,68,37,female
31 ms,31,22400 KB,22400,China,Asia,146,2134,907.0722046,15343.08561,71.86046512,1102561.268,152,59,53,93,6,85,24,female
31 ms,31,0 KB,0,South Korea,Asia,133,1761,808.7626042,12424.35237,110.7341772,1375800.437,141,102,97,39,5,58,46,female
31 ms,31,300 KB,300,China,Asia,78,541,412.2983693,3400.4026,44.73684211,152123.2742,239,85,68,154,17,25,10,female
155 ms,155,15900 KB,15900,India,Asia,81,341,433.2506894,2161.888851,45.2,97717.37606,15,12,12,3,0,14,1,male
77 ms,77,9000 KB,9000,China,Asia,76,253,399.1845378,1580.725661,27.74390244,43855.49852,34,25,22,9,3,11,2,male
62 ms,62,9000 KB,9000,India,Asia,75,267,392.4020294,1663.09459,29.3125,48749.46018,34,25,22,9,3,11,2,male
77 ms,77,12600 KB,12600,India,Asia,75,267,392.4020294,1663.09459,29.3125,48749.46018,34,25,22,9,3,11,2,male
109 ms,109,8100 KB,8100,India,Asia,67,218,339.9564924,1322.407444,22.2972973,29486.11192,29,22,21,7,1,10,2,male
31 ms,31,500 KB,500,China,Asia,77,323,405.551932,2024.172053,45.30769231,91710.56454,27,18,16,9,2,12,1,female
93 ms,93,12600 KB,12600,Iran,Asia,75,267,392.4020294,1663.09459,29.3125,48749.46018,34,25,22,9,3,11,2,male
62 ms,62,16100 KB,16100,China,Asia,58,303,287.9357738,1774.968242,22.22222222,39443.7387,25,16,16,9,0,7,1,male
62 ms,62,31300 KB,31300,China,Asia,80,344,426.6582949,2174.743265,29.94444444,65121.47887,42,35,33,7,2,14,1,male
62 ms,62,4200 KB,4200,Egypt,AsiaAfrica,55,268,264.5725015,1549.404403,30,46482.1321,49,44,44,5,0,13,2,male
93 ms,93,15800 KB,15800,Unknown,Unknown,98,370,554.5247521,2447.442642,44.8852459,109854.0648,25,20,20,5,0,14,2,male
62 ms,62,19500 KB,19500,China,Asia,67,322,339.5249056,1953.280719,31.08571429,60719.12636,56,49,49,7,0,16,2,female
202 ms,202,31500 KB,31500,Mexico,North America,40,229,197.504662,1218.721534,18.5,22546.34837,27,19,19,8,0,5,1,male
46 ms,46,4100 KB,4100,Belarus,Europe,54,320,263.4212455,1841.564001,21.375,39363.43051,32,26,26,6,0,18,1,male
265 ms,265,15800 KB,15800,China,Asia,67,375,339.4387425,2274.783446,40.27941176,91626.93911,45,34,29,11,5,20,3,male
78 ms,78,31300 KB,31300,Unknown,Unknown,98,434,553.8346812,2870.784072,39.58333333,113635.2029,41,35,35,6,0,15,1,female
46 ms,46,35200 KB,35200,China,Asia,66,357,333.3240179,2157.848701,30,64735.46102,38,31,31,7,0,15,2,male
93 ms,93,31500 KB,31500,China,Asia,58,352,284.2247957,2062.00931,40.90909091,84354.92633,41,36,36,5,0,21,1,female
62 ms,62,15900 KB,15900,China,Asia,63,346,316.1697866,2068.138854,30.0625,62173.42428,38,26,26,12,0,7,1,female
623 ms,623,110000 KB,110000,Japan,Asia,53,311,258.0246044,1781.383261,38,67692.56393,54,45,45,9,0,10,2,male
46 ms,46,4000 KB,4000,Iran,Asia,75,346,392.9423377,2155.171267,45.18181818,97374.55633,51,43,42,8,1,18,2,male
124 ms,124,15900 KB,15900,Unknown,Unknown,98,370,554.5247521,2447.442642,44.8852459,109854.0648,25,20,20,5,0,14,2,male
62 ms,62,700 KB,700,Jordan,Asia,75,370,392.9423377,2304.662915,44.39285714,102310.5716,36,23,19,13,4,14,2,male
77 ms,77,700 KB,700,Finland,Europe,80,351,425.8985773,2218.996761,48.63157895,107913.3162,40,37,37,3,0,13,1,male
514 ms,514,4000 KB,4000,China,Asia,84,417,453.8154506,2665.596365,42.5106383,113316.2029,39,31,31,8,0,18,2,male
529 ms,529,4000 KB,4000,China,Asia,84,417,453.8154506,2665.596365,42.5106383,113316.2029,39,31,31,8,0,18,2,male
61 ms,61,15900 KB,15900,Mexico,North America,68,376,346.1173001,2288.886028,52.3125,119737.3504,47,35,31,12,4,18,3,male
140 ms,140,4200 KB,4200,Romania,Europe,61,428,302.2137048,2538.35558,79.2,201037.762,58,50,50,8,0,18,2,male
904 ms,904,31300 KB,31300,India,Asia,71,343,366.1306865,2109.363262,34.734375,73267.41455,60,54,54,6,0,16,2,male
78 ms,78,15800 KB,15800,China,Asia,95,443,532.5126722,2910.446034,32.85344828,95618.18825,46,28,28,18,0,12,1,male
46 ms,46,500 KB,500,South Korea,Asia,83,398,446.2065082,2537.265694,50.23255814,127453.3465,46,30,26,16,4,13,1,male
62 ms,62,15800 KB,15800,Iran,Asia,0,0,0,0,0,0,49,38,33,11,5,16,4,female
46 ms,46,700 KB,700,Finland,Europe,79,357,419.0808777,2250.449727,47.47368421,106837.1397,43,37,37,6,0,13,1,male
202 ms,202,15700 KB,15700,China,Asia,95,384,531.8959763,2522.824554,33.66666667,84935.0933,44,37,35,7,2,15,1,male
295 ms,295,16000 KB,16000,Egypt,AsiaAfrica,63,356,314.9612072,2127.911653,64.03846154,136268.1885,59,50,48,9,2,17,3,male
108 ms,108,31600 KB,31600,Bangladesh,Asia,65,339,326.7316235,2041.582689,37.33333333,76219.08704,52,44,44,8,0,14,3,male
46 ms,46,4000 KB,4000,Poland,Europe,71,333,367.3587806,2047.865791,47.79310345,97873.86159,67,39,28,28,11,14,1,male
77 ms,77,20400 KB,20400,Iran,Asia,62,362,308.3287327,2155.419064,43.61538462,94009.4315,48,40,40,8,0,19,3,male
124 ms,124,19800 KB,19800,Iran,Asia,80,346,425.7903187,2187.387121,44.15384615,96581.55441,56,41,36,15,5,12,1,male
140 ms,140,31800 KB,31800,India,Asia,74,279,385.6555921,1732.437489,33.42857143,57912.91035,40,31,31,9,0,12,2,male
109 ms,109,4100 KB,4100,Finland,Europe,59,318,288.6764386,1870.68049,41.25,77165.5702,55,31,24,24,7,16,2,male
46 ms,46,700 KB,700,Finland,Europe,72,361,372.8771238,2227.342926,51.25,114151.3249,41,35,35,6,0,13,1,male
233 ms,233,43800 KB,43800,Russia,AsiaEurope,66,393,334.0271833,2375.446889,63.10714286,149907.6662,53,45,45,8,0,17,3,male
62 ms,62,700 KB,700,Finland,Europe,78,367,412.2983693,2306.742614,46.31578947,106838.6053,42,37,37,5,0,13,1,male
171 ms,171,15900 KB,15900,Bangladesh,Asia,63,342,315.5176503,2044.229734,50.92,104092.178,55,39,37,16,2,15,3,male
61 ms,61,20400 KB,20400,India,Asia,63,367,314.9612072,2193.661732,44.82692308,98335.10571,56,44,40,12,4,19,3,male
61 ms,61,700 KB,700,Finland,Europe,72,361,372.8771238,2227.342926,51.25,114151.3249,45,39,39,6,0,13,1,male
156 ms,156,15900 KB,15900,India,Asia,61,313,301.7363383,1856.320787,34.32692308,63721.78085,85,49,25,36,24,14,2,male
108 ms,108,35500 KB,35500,Hong Kong,Asia,73,362,380.5361023,2240.71649,39.41666667,88321.57499,48,36,36,12,0,14,2,male
77 ms,77,32900 KB,32900,Ukraine,Europe,78,353,412.4094067,2218.746983,47.37804878,105119.9028,51,40,35,11,5,10,1,male
77 ms,77,15800 KB,15800,China,Asia,59,387,288.6764386,2276.58286,64.09615385,145920.2052,57,43,37,14,6,15,2,male
171 ms,171,15900 KB,15900,Bangladesh,Asia,60,293,297.5287411,1730.718945,44.90909091,77725.01442,45,41,41,4,0,17,2,male
62 ms,62,16500 KB,16500,China,Asia,64,383,322.9162238,2298,27.5,63195,63,54,54,9,0,17,2,female
77 ms,77,4200 KB,4200,Bangladesh,Asia,58,321,282.2114327,1880.411899,35.07692308,65959.06355,47,41,39,6,2,17,3,male
109 ms,109,16400 KB,16400,Bulgaria,Europe,87,361,473.9427998,2325.902602,54.04255319,125697.7151,41,32,28,9,4,12,1,male
373 ms,373,31800 KB,31800,India,Asia,49,293,237.4749933,1645.109984,25.90909091,42623.30414,60,50,49,10,1,17,3,male
46 ms,46,16000 KB,16000,India,Asia,71,329,367.3587806,2023.266802,42.72413793,86442.32993,43,39,39,4,0,19,2,male
46 ms,46,21400 KB,21400,China,Asia,77,381,405.551932,2387.645672,35.92105263,85766.74585,65,56,56,9,0,18,1,female
171 ms,171,9000 KB,9000,Lebanon,Asia,58,346,284.2247957,2026.861424,38.45454545,77942.03477,60,48,47,12,1,16,2,male
62 ms,62,15900 KB,15900,China,Asia,60,386,295.6213103,2280.05977,40.6,92570.42666,66,57,57,9,0,18,2,male
171 ms,171,59200 KB,59200,South Korea,Asia,107,483,618.5896441,3256.128554,43.17424242,140580.8836,45,36,34,9,2,21,1,male
155 ms,155,16000 KB,16000,India,Asia,60,324,298.3693524,1913.832553,44.57142857,85302.25093,69,54,46,15,8,14,2,male
62 ms,62,16000 KB,16000,China,Asia,68,440,345.9899115,2678.48365,41.89393939,112212.2317,50,45,45,5,0,16,1,male
31 ms,31,800 KB,800,Ukraine,Europe,42,261,214.8771238,1407.394847,20,28147.89695,47,34,30,13,4,14,1,male
452 ms,452,9900 KB,9900,Syria,Asia,63,313,314.9612072,1870.888616,41.98076923,78541.34325,65,41,26,24,15,15,2,male
202 ms,202,4200 KB,4200,Brazil,South America,47,255,227.9505705,1416.420157,23.22222222,32892.42365,56,43,37,13,6,16,2,male
171 ms,171,4100 KB,4100,China,Asia,78,381,413.1887278,2394.738245,58.23529412,139458.2861,55,35,31,20,4,20,3,female
280 ms,280,15800 KB,15800,China,Asia,97,411,544.452116,2712.564178,38.56363636,104606.3386,54,47,47,7,0,17,4,female
77 ms,77,4100 KB,4100,China,Asia,68,407,346.6279634,2477.597376,44.33333333,109840.1504,45,30,30,15,0,19,1,male
46 ms,46,32000 KB,32000,China,Asia,74,473,386.4773318,2937.071442,37.71428571,110769.5515,48,42,42,6,0,16,2,male
171 ms,171,16900 KB,16900,India,Asia,63,368,314.1308434,2199.639012,50.625,111356.725,40,34,31,6,3,11,1,male
46 ms,46,4000 KB,4000,Iran,Asia,90,431,494.7804146,2797.988685,55.64285714,155688.0847,53,43,41,10,2,16,1,male
77 ms,77,32100 KB,32100,China,Asia,58,369,283.5668306,2161.594987,40.32608696,87168.66742,74,68,68,6,0,15,1,male
280 ms,280,8100 KB,8100,South Korea,Asia,71,440,366.4572094,2705.888733,78.06451613,211233.8946,67,41,29,26,12,19,3,male
109 ms,109,16000 KB,16000,China,Asia,71,384,365.7235111,2361.502894,32.10294118,75811.18849,72,62,62,10,0,15,2,male
78 ms,78,4100 KB,4100,China,Asia,81,375,432.9647657,2377.443751,33.63636364,79968.56254,53,32,29,21,3,7,2,female
483 ms,483,16000 KB,16000,Egypt,AsiaAfrica,59,368,291.6599114,2164.812642,55.19047619,119477.0406,68,56,51,12,5,20,3,male
46 ms,46,20700 KB,20700,China,Asia,86,471,466.9609738,3026.770699,42.17391304,127650.7643,55,48,48,7,0,19,2,female
264 ms,264,15900 KB,15900,Mexico,North America,71,399,366.1306865,2453.749101,45.703125,112144.0019,72,55,47,17,8,17,2,male
62 ms,62,65500 KB,65500,South Korea,Asia,46,407,223.4212455,2248.089716,19,42713.70461,64,56,56,8,0,19,1,male
77 ms,77,16100 KB,16100,China,Asia,75,510,392.17102,3176.697532,73.94594595,234903.904,57,48,48,9,0,16,1,female
62 ms,62,15800 KB,15800,South Africa,Africa,64,323,320.7232379,1938,37.92857143,73505.57143,48,35,29,13,6,10,2,male
62 ms,62,47200 KB,47200,Unknown,Unknown,85,381,460.8279746,2441.977947,31.98958333,78117.85702,46,29,29,17,0,8,1,male
468 ms,468,17000 KB,17000,Russia,AsiaEurope,62,366,309.4603455,2179.23585,42.75,93162.33257,59,46,40,13,6,14,1,male
124 ms,124,17900 KB,17900,Unknown,Unknown,90,472,496.3295586,3064.154661,49.21698113,150808.4422,45,35,35,10,0,17,2,male
62 ms,62,16000 KB,16000,Bangladesh,Asia,36,262,174.9737366,1354.52035,17,23026.84596,57,40,31,17,9,15,2,male
124 ms,124,39000 KB,39000,Poland,Europe,72,397,372.3949821,2449.460226,37.13157895,90952.32574,60,42,36,18,6,9,3,male
390 ms,390,15800 KB,15800,Romania,Europe,82,426,439.6362367,2708.317154,51.81818182,140340.0707,62,55,55,7,0,18,3,male
46 ms,46,15900 KB,15900,Romania,Europe,64,335,321.1317371,2010,35.62962963,71615.55556,55,46,41,9,5,14,2,male
296 ms,296,44200 KB,44200,Italy,Europe,73,468,378.8670746,2896.837894,61.66666667,178638.3368,66,46,37,20,9,21,3,male
46 ms,46,15900 KB,15900,China,Asia,94,473,525.8801978,3100.320527,45.31034483,140476.5921,33,24,24,9,0,19,1,male
592 ms,592,31900 KB,31900,India,Asia,64,316,322.2270913,1896,46.02,87253.92,50,41,40,9,1,14,3,male
77 ms,77,47400 KB,47400,Iran,Asia,72,368,372.2346001,2270.532401,42,95362.36082,57,40,34,17,6,14,3,male
343 ms,343,4000 KB,4000,Canada,North America,67,355,342.5737365,2153.461663,55.44,119387.9146,49,46,45,3,1,15,1,male
46 ms,46,16000 KB,16000,Aruba,South Africa,85,484,460.2145365,3102.145213,43.66304348,135449.1013,61,51,51,10,0,20,4,female
62 ms,62,4000 KB,4000,Bangladesh,Asia,70,409,359.2147805,2506.876754,59.42424242,148969.252,54,46,45,8,1,15,2,male
156 ms,156,16000 KB,16000,Bangladesh,Asia,59,313,290.159225,1841.267274,39.13043478,72049.589,58,46,41,12,5,16,2,male
46 ms,46,15900 KB,15900,Norway,Europe,68,392,347.0121354,2386.285434,72.62068966,173293.6939,52,46,44,6,2,22,1,male
46 ms,46,4000 KB,4000,Romania,Europe,87,421,474.5420279,2712.479212,44.20408163,119902.6525,55,43,39,12,4,17,2,male
78 ms,78,15700 KB,15700,United States,North America,82,398,439.3544556,2530.305698,50.95238095,128925.0998,55,43,37,12,6,13,1,male
78 ms,78,15800 KB,15800,India,Asia,63,432,314.4992626,2582.184927,44,113616.1368,63,61,61,2,0,25,1,male
124 ms,124,63600 KB,63600,Bangladesh,Asia,56,361,275.6175548,2096.455127,24.08823529,50499.90438,70,45,33,25,12,16,2,male
46 ms,46,4200 KB,4200,China,Asia,89,457,487.5430078,2959.410178,41.10638298,121650.6482,66,57,57,9,0,20,2,male
62 ms,62,4000 KB,4000,Bangladesh,Asia,70,416,359.2147805,2549.781735,59.42424242,151518.848,55,47,46,8,1,15,2,male
31 ms,31,500 KB,500,Japan,Asia,67,356,341.2590864,2159.527752,60,129571.6651,51,38,35,13,3,11,1,male
46 ms,46,4000 KB,4000,Moldova,Asia,72,386,372.5956925,2381.591051,62.63636364,149174.2031,57,46,46,11,0,18,2,male
46 ms,46,4000 KB,4000,China,Asia,54,365,263.4212455,2100.533938,33.25,69842.75345,71,62,61,9,1,17,2,male
78 ms,78,4000 KB,4000,Finland,Europe,73,404,378.9461511,2500.689122,64.6,161544.5173,59,42,35,17,7,16,1,female
46 ms,46,15800 KB,15800,Poland,Europe,67,423,340.3026944,2565.955728,26.20689655,67245.73631,46,31,28,15,3,23,1,male
280 ms,280,31500 KB,31500,Georgia,AsiaEurope,63,352,314.1308434,2104.002533,42.5,89420.10766,64,48,38,16,10,20,2,male
217 ms,217,47600 KB,47600,South Korea,Asia,78,382,412.2983693,2401.023648,31.57894737,75821.7994,66,43,31,23,12,18,2,male
77 ms,77,51100 KB,51100,United States,North America,62,407,307.9068682,2423.357898,54.44444444,131938.3745,49,35,30,14,5,15,1,male
77 ms,77,15900 KB,15900,India,Asia,66,382,333.6312234,2308.958554,45.93103448,106052.8549,71,51,44,20,7,15,3,male
61 ms,61,15700 KB,15700,India,Asia,55,410,270.1306865,2370.357483,41.4375,98221.68818,56,52,50,4,2,20,2,male
343 ms,343,43500 KB,43500,China,Asia,87,499,474.942584,3215.028804,32.19,103491.7772,44,34,34,10,0,19,1,male
997 ms,997,15900 KB,15900,India,Asia,42,292,210.885574,1574.556687,26,40938.47387,44,34,32,10,2,19,2,male
46 ms,46,15600 KB,15600,China,Asia,64,330,320.1804545,1980,24.93333333,49368,54,43,41,11,2,19,4,female
545 ms,545,31700 KB,31700,India,Asia,64,325,322.2270913,1950,46.02,89739,51,41,40,10,1,14,3,male
327 ms,327,15900 KB,15900,Lebanon,Asia,66,385,333.6312234,2327.091736,54.22413793,126184.5433,48,33,27,15,6,16,3,male
124 ms,124,4200 KB,4200,India,Asia,65,322,327.8032081,1939.202436,45.74074074,88700.55586,50,36,29,14,7,15,2,male
46 ms,46,19400 KB,19400,China,Asia,69,482,353.0013311,2944.308788,36.77419355,108274.5812,59,54,54,5,0,16,1,male
62 ms,62,16300 KB,16300,Indonesia,Asia,66,419,334.0271833,2532.601136,69.89285714,177010.7294,64,44,29,20,15,16,2,male
46 ms,46,4800 KB,4800,Italy,Europe,70,357,359.7107722,2188.154037,63.53225806,139018.367,78,45,34,33,11,14,2,male
140 ms,140,4100 KB,4100,Syria,Asia,64,305,322.9162238,1830,41.66666667,76250,65,47,39,18,8,15,2,male
46 ms,46,4100 KB,4100,China,Asia,69,422,359.1731716,2577.797321,36.31818182,93620.91179,50,38,34,12,4,22,3,male
171 ms,171,31900 KB,31900,India,Asia,73,355,379.3421297,2197.387718,46.66666667,102544.7602,64,50,46,14,4,15,2,male
156 ms,156,16200 KB,16200,Brazil,South America,72,361,372.2746801,2227.342926,43.34285714,96539.40623,53,36,27,17,9,16,3,male
31 ms,31,600 KB,600,China,Asia,90,444,494.5555318,2882.382775,51.1875,147541.9683,52,40,40,12,0,13,1,male
30 ms,30,600 KB,600,China,Asia,90,444,494.5555318,2882.382775,51.1875,147541.9683,52,40,40,12,0,13,1,male
46 ms,46,15900 KB,15900,South Korea,Asia,66,375,333.3240179,2266.647795,47.4,107439.1055,56,41,37,15,4,15,2,male
46 ms,46,3900 KB,3900,Jordan,Asia,85,513,460.4869215,3288.01755,51.74468085,170137.4188,56,34,31,22,3,12,2,male
61 ms,61,4000 KB,4000,Kazakhstan,AsiaEurope,82,414,439.3192644,2632.02653,52,136865.3796,56,47,43,9,4,14,2,male
296 ms,296,15800 KB,15800,Iran,Asia,86,427,466.9609738,2744.01505,56.08695652,153903.4528,63,47,36,16,11,17,1,male
46 ms,46,35400 KB,35400,China,Asia,83,477,446.5546348,3040.893809,43.06666667,130961.16,44,35,35,9,0,25,4,male
61 ms,61,4000 KB,4000,Bangladesh,Asia,82,414,439.3192644,2632.02653,52,136865.3796,56,47,43,9,4,14,2,male
31 ms,31,35400 KB,35400,China,Asia,83,477,446.5546348,3040.893809,43.06666667,130961.16,44,35,35,9,0,25,4,male
514 ms,514,31800 KB,31800,India,Asia,70,397,359.4212455,2433.325358,41.5625,101135.0852,72,57,51,15,6,19,3,male
389 ms,389,16000 KB,16000,India,Asia,64,369,322.2270913,2214,59.28,131245.92,72,56,47,16,9,18,3,male
46 ms,46,17200 KB,17200,India,Asia,63,405,314.4992626,2420.798369,44,106515.1282,58,53,52,5,1,15,1,male
62 ms,62,4100 KB,4100,China,Asia,82,562,439.6362367,3572.944227,44.47727273,158914.8148,58,49,49,9,0,25,1,female
46 ms,46,15800 KB,15800,India,Asia,57,444,277.0156616,2589.803166,53.2173913,137822.5685,71,67,66,4,1,25,1,male
78 ms,78,32200 KB,32200,Tajikistan,Asia,75,385,393.3293845,2398.095196,56.4375,135342.4976,63,50,46,13,4,18,1,male
498 ms,498,97600 KB,97600,Egypt,AsiaAfrica,60,345,294.8469685,2037.877255,40.33333333,82194.38264,58,38,36,20,2,15,3,male
78 ms,78,15800 KB,15800,Colombia,South America,74,387,386.1246381,2403.058452,44.10606061,105989.4417,68,47,35,21,12,15,4,male
46 ms,46,19500 KB,19500,United States,North America,62,404,308.8461793,2405.495309,65.12,156645.8545,65,59,57,6,2,21,1,male
795 ms,795,15900 KB,15900,Australia,Australia,77,369,406.0022373,2312.444234,57.6,133196.7879,49,37,32,12,5,14,2,male
31 ms,31,500 KB,500,Ukraine,Europe,90,371,494.3950605,2408.477499,57.63829787,138820.5435,56,41,35,15,6,16,3,male
171 ms,171,34800 KB,34800,India,Asia,66,362,334.5126491,2188.070671,50.55555556,110619.1284,66,48,41,18,7,16,2,male
62 ms,62,31600 KB,31600,Brazil,South America,67,470,339.9564924,2851.06192,76.46666667,218011.2014,70,49,35,21,14,17,2,male
483 ms,483,16100 KB,16100,Bangladesh,Asia,74,427,386.1246381,2651.436587,60.87878788,161416.2456,73,58,52,15,6,19,3,male
62 ms,62,62800 KB,62800,Russia,AsiaEurope,68,422,346.3298602,2568.909319,61.46774194,157905.0551,53,47,47,6,0,20,1,male
78 ms,78,21800 KB,21800,Bosnia and Herzegovina,Europe,61,345,301.3556992,2046.104381,44.7037037,91468.44402,58,40,31,18,9,17,3,male
156 ms,156,31600 KB,31600,Thailand,Asia,92,472,510.1851706,3079.121243,43.62962963,134340.9194,54,37,31,17,6,18,4,male
78 ms,78,19600 KB,19600,United States,North America,76,460,398.9944238,2874.046656,55.35,159078.4824,62,50,44,12,6,18,3,male
202 ms,202,6800 KB,6800,India,Asia,83,411,446.3456778,2620.141206,51.85227273,135860.2764,66,32,16,34,16,16,3,male
62 ms,62,16000 KB,16000,Peru,South America,73,366,378.8670746,2265.475789,44.75675676,101395.3488,62,47,41,15,6,18,3,male
61 ms,61,19900 KB,19900,Thailand,Asia,74,396,385.5385456,2458.943533,46.89473684,115311.5099,60,44,39,16,5,21,3,male
124 ms,124,18300 KB,18300,Italy,Europe,66,438,333.6312234,2647.444624,65.70689655,173955.3701,79,50,26,29,24,20,3,male
498 ms,498,96900 KB,96900,India,Asia,58,333,283.0128366,1950.707671,29.75,58033.55322,54,37,36,17,1,13,2,male
452 ms,452,15900 KB,15900,India,Asia,65,355,328.9735285,2137.940574,33.6,71834.80327,56,34,23,22,11,19,3,male
140 ms,140,32400 KB,32400,India,Asia,83,469,446.5546348,2989.893493,52.77777778,157799.9344,63,46,37,17,9,17,3,male
93 ms,93,4900 KB,4900,United Kingdom,Europe,69,370,355.5408171,2260.154049,38.86538462,87841.7564,79,66,66,13,0,16,2,male
78 ms,78,15900 KB,15900,Georgia,AsiaEurope,59,390,288.3819626,2294.230789,62.22222222,142752.138,53,43,38,10,5,18,2,female
264 ms,264,15900 KB,15900,Syria,Asia,75,362,392.6333688,2254.832366,42.80882353,96526.72084,72,45,32,27,13,18,2,male
62 ms,62,16800 KB,16800,Russia,AsiaEurope,67,453,340.3026944,2747.938403,68.79310345,189039.2108,72,66,62,6,4,19,3,male
124 ms,124,15900 KB,15900,Unknown,Unknown,87,369,473.7434822,2377.44615,34.76086957,82642.09552,49,30,28,19,2,10,2,male
156 ms,156,4100 KB,4100,Ukraine,Europe,83,368,446.1369639,2346.014511,36.60714286,85880.88834,66,44,37,22,7,7,1,male
93 ms,93,15900 KB,15900,Unknown,Unknown,86,368,466.9609738,2364.86543,33.91304348,80199.78414,49,31,30,18,1,10,2,male
218 ms,218,4800 KB,4800,India,Asia,61,368,309.7018595,2182.51134,49.17647059,107328.2047,64,49,47,15,2,18,2,male
140 ms,140,4500 KB,4500,Syria,Asia,97,421,544.452116,2778.563307,43.14545455,119882.3768,78,59,54,19,5,17,4,male
452 ms,452,14100 KB,14100,India,Asia,56,369,271.0812322,2142.913966,37.86363636,81138.51518,54,39,30,15,9,18,1,male
108 ms,108,16000 KB,16000,Bangladesh,Asia,60,340,297.5287411,2008.342803,57.86363636,116210.0176,59,32,19,27,13,10,3,male
296 ms,296,67300 KB,67300,Georgia,AsiaEurope,55,408,265.9634675,2358.794763,42.875,101133.3255,64,41,33,23,8,16,1,male
124 ms,124,15900 KB,15900,Bangladesh,Asia,60,340,297.5287411,2008.342803,57.86363636,116210.0176,59,32,19,27,13,10,3,male
218 ms,218,15900 KB,15900,Turkey,AsiaEurope,65,396,327.8032081,2384.857654,58.40740741,139293.3526,89,55,30,34,25,20,3,male
202 ms,202,31900 KB,31900,Bangladesh,Asia,44,269,220.8771238,1468.587105,20,29371.74211,59,50,50,9,0,16,2,male
171 ms,171,31500 KB,31500,Lebanon,Asia,62,450,307.5796744,2679.38834,58.89285714,157796.8347,86,53,38,33,15,20,4,male
62 ms,62,31600 KB,31600,China,Asia,102,445,581.4346098,2969.229277,37.63934426,111759.843,85,58,52,27,6,14,2,male
46 ms,46,4100 KB,4100,Canada,North America,89,423,487.7378322,2739.235241,43.5625,119327.9352,47,35,35,12,0,15,1,male
46 ms,46,600 KB,600,Iran,Asia,75,389,392.6333688,2423.010471,51.85294118,125640.2194,60,33,24,27,9,15,2,male
78 ms,78,4000 KB,4000,Iran,Asia,81,436,432.9647657,2764.174601,70.16216216,193940.4666,91,53,25,38,28,18,2,male
545 ms,545,96800 KB,96800,India,Asia,62,349,307.9068682,2078.014512,35,72730.50793,61,58,58,3,0,18,3,male
46 ms,46,900 KB,900,India,Asia,58,397,285.8598074,2325.618455,51.3,119304.2267,59,47,46,12,1,20,1,male
93 ms,93,19500 KB,19500,Indonesia,Asia,86,401,466.692323,2576.932167,48.20454545,124219.8438,67,46,39,21,7,15,3,male
62 ms,62,8100 KB,8100,Austria,Europe,92,405,508.2931913,2642.042592,44,116249.8741,73,59,54,14,5,20,2,male
156 ms,156,15900 KB,15900,Egypt,AsiaAfrica,69,353,354.8592943,2156.309133,56,120753.3115,85,48,25,37,23,17,3,male
436 ms,436,99300 KB,99300,India,Asia,57,444,277.6324012,2589.803166,42.95454545,111243.8178,73,55,53,18,2,18,2,male
124 ms,124,16900 KB,16900,Sweden,Europe,63,358,314.9612072,2139.866213,39.13461538,83742.84121,59,36,31,23,5,7,1,male
93 ms,93,15800 KB,15800,Jordan,Asia,81,474,432.536756,3005.088901,61.46341463,184703.0252,61,53,53,8,0,15,2,male
655 ms,655,96900 KB,96900,Cuba,North America,72,378,372.3949821,2332.231651,46.94117647,109477.6975,71,39,20,32,19,14,3,female
421 ms,421,99300 KB,99300,India,Asia,57,444,277.6324012,2589.803166,42.95454545,111243.8178,73,55,53,18,2,18,2,male
93 ms,93,4400 KB,4400,Vietnam,Asia,66,412,332.9300119,2490.290377,35,87160.1632,78,38,31,40,7,18,3,male
155 ms,155,58200 KB,58200,South Korea,Asia,87,551,473.5443757,3550.061866,71.34090909,253264.6409,60,52,51,8,1,19,2,female
31 ms,31,3900 KB,3900,China,Asia,77,436,405.7769322,2732.318932,20.63414634,56379.06869,76,32,-6,44,38,20,1,male
31 ms,31,4000 KB,4000,Indonesia,Asia,68,405,348.6887644,2465.422451,55.73076923,137399.8897,45,31,31,14,0,18,1,male
78 ms,78,15900 KB,15900,South Korea,Asia,82,407,439.3544556,2587.523666,47.61904762,123215.4127,77,50,34,27,16,19,4,male
46 ms,46,4300 KB,4300,Kazakhstan,AsiaEurope,66,435,333.1049912,2629.311442,58.70967742,154366.0266,69,54,44,15,10,22,2,male
46 ms,46,15800 KB,15800,China,Asia,76,479,398.8804611,2992.757279,50.59459459,151417.3412,66,35,24,31,11,6,1,male
139 ms,139,31500 KB,31500,South Korea,Asia,82,407,439.3544556,2587.523666,47.61904762,123215.4127,77,50,34,27,16,19,4,male
62 ms,62,16100 KB,16100,India,Asia,63,472,313.8551855,2821.276124,62.72413793,176962.1127,82,71,64,11,7,25,3,male
77 ms,77,35600 KB,35600,India,Asia,62,416,308.3287327,2476.945665,41.53846154,102888.5122,77,70,67,7,3,21,1,male
920 ms,920,31500 KB,31500,Unknown,Unknown,72,385,372.8771238,2375.421126,44.375,105409.3124,73,53,45,20,8,17,2,male
779 ms,779,16000 KB,16000,Indonesia,Asia,62,389,307.9068682,2316.182365,56.38888889,130606.95,71,42,32,29,10,17,4,male
46 ms,46,4200 KB,4200,China,Asia,77,427,405.7769322,2675.917853,38.19512195,102207.0087,79,49,42,30,7,17,1,male
46 ms,46,15800 KB,15800,China,Asia,77,430,406.6799972,2694.718212,36.66666667,98806.33446,72,60,60,12,0,21,3,male
31 ms,31,900 KB,900,Sweden,Europe,54,419,264.7340455,2411.297863,42.9,103444.6783,67,41,29,26,12,7,1,male
46 ms,46,4300 KB,4300,Kazakhstan,AsiaEurope,66,435,333.1049912,2629.311442,58.70967742,154366.0266,69,54,45,15,9,22,2,male
46 ms,46,15900 KB,15900,South Korea,Asia,68,370,346.1173001,2252.361251,36,81085.00505,55,36,33,19,3,21,2,male
78 ms,78,31500 KB,31500,India,Asia,91,454,504.7367812,2954.538767,38.125,112641.7905,65,55,52,10,3,14,1,male
46 ms,46,800 KB,800,India,Asia,66,448,334.0271833,2707.888565,52.92857143,143324.6734,80,76,75,4,1,23,2,male
139 ms,139,15900 KB,15900,Syria,Asia,65,375,326.9987489,2258.38793,52.13793103,117747.6741,60,51,49,9,2,20,4,male
139 ms,139,31600 KB,31600,Canada,North America,88,377,480.9553238,2435.20572,43.75,106540.2503,62,54,50,8,4,15,3,male
46 ms,46,4100 KB,4100,Azerbaijan,AsiaEurope,71,454,365.7235111,2791.985192,65.83823529,183819.378,69,48,39,21,9,20,1,male
217 ms,217,31700 KB,31700,India,Asia,69,358,353.3374044,2186.851756,58.5,127930.8277,56,40,33,16,7,17,3,male
46 ms,46,700 KB,700,Finland,Europe,78,367,412.2983693,2306.742614,46.31578947,106838.6053,42,37,37,5,0,13,1,male
171 ms,171,4000 KB,4000,South Korea,Asia,65,422,326.5538222,2541.439217,47.86764706,121652.7155,83,57,51,26,6,19,4,female
139 ms,139,31600 KB,31600,India,Asia,70,399,361.711347,2445.583924,54.14814815,132423.8406,71,52,52,19,0,17,3,male
15 ms,15,600 KB,600,China,Asia,71,471,366.1306865,2896.530893,36.5625,105904.4108,51,19,19,32,0,10,1,female
265 ms,265,31700 KB,31700,Ukraine,Europe,75,340,392.4020294,2117.798355,35.42857143,75030.57028,59,36,28,23,8,15,1,male
61 ms,61,16000 KB,16000,China,Asia,83,470,446.2065082,2996.268533,33.95348837,101733.7688,52,31,31,21,0,12,1,female
77 ms,77,63100 KB,63100,Estonia,Europe,66,411,334.5126491,2484.245983,44.77777778,111239.0146,42,33,32,9,1,17,1,male
93 ms,93,16000 KB,16000,Chile,South America,63,336,316.1697866,2008.366054,41.4375,83221.66837,66,46,36,20,10,10,2,male
62 ms,62,16000 KB,16000,China,Asia,83,470,446.2065082,2996.268533,33.95348837,101733.7688,52,31,31,21,0,12,1,male
62 ms,62,15900 KB,15900,Croatia,Europe,79,490,419.4466845,3088.852567,53.58139535,165505.0305,73,51,42,22,9,21,5,male
46 ms,46,16200 KB,16200,South Korea,Asia,82,470,439.3544556,2988.049442,50,149402.4721,63,44,38,19,6,20,1,female
717 ms,717,16000 KB,16000,Bangladesh,Asia,67,354,341.8710649,2147.395573,47.30769231,101588.3291,54,41,37,13,4,18,3,male
171 ms,171,16200 KB,16200,Bangladesh,Asia,70,359,359.0910367,2200.412603,43.94117647,96688.7185,60,44,40,16,4,17,3,male
78 ms,78,4500 KB,4500,Kazakhstan,AsiaEurope,73,457,379.1044231,2828.749823,71.11764706,201174.0316,77,40,28,37,12,17,1,male
249 ms,249,4500 KB,4500,Russia,AsiaEurope,77,464,406.3031211,2907.788955,72.08823529,209617.3744,80,53,37,27,16,18,2,male
623 ms,623,155300 KB,155300,India,Asia,58,436,284.2247957,2554.079714,73.63636364,188073.1426,62,56,53,6,3,14,2,male
218 ms,218,31700 KB,31700,Bangladesh,Asia,43,261,211.030886,1416.255101,22.8,32290.6163,61,54,54,7,0,17,2,male
46 ms,46,16200 KB,16200,China,Asia,79,532,419.0078103,3353.611358,78.4875,263216.5715,56,48,48,8,0,23,1,male
46 ms,46,4400 KB,4400,Russia,AsiaEurope,90,447,494.2667787,2901.858334,64,185718.9334,69,56,52,13,4,16,2,male
46 ms,46,4000 KB,4000,China,Asia,70,445,359.4212455,2727.530943,57,155469.2637,74,46,40,28,6,17,1,female
327 ms,327,15900 KB,15900,India,Asia,62,444,310.1726115,2643.663162,53.41304348,141206.0954,92,84,84,8,0,27,3,male
888 ms,888,15800 KB,15800,India,Asia,72,350,372.8771238,2159.473751,44.375,95826.64768,50,39,38,11,1,14,2,male
546 ms,546,16100 KB,16100,India,Asia,0,0,0,0,0,0,50,42,42,8,0,16,2,male
46 ms,46,17100 KB,17100,China,Asia,63,440,314.4992626,2630.003166,65.33333333,171826.8735,61,55,52,6,3,20,1,male
31 ms,31,6600 KB,6600,Russia,AsiaEurope,64,374,322.9162238,2244,32.5,72930,72,53,50,19,3,11,2,male
62 ms,62,15900 KB,15900,Vietnam,Asia,91,458,501.8524417,2980.569945,52.07,155198.277,56,41,37,15,4,13,2,male
374 ms,374,47200 KB,47200,China,Asia,89,522,490.9485208,3380.332851,33.38181818,112841.6566,70,63,63,7,0,20,3,female
61 ms,61,15900 KB,15900,China,Asia,83,456,446.1369639,2907.017981,47.12195122,136984.3595,65,55,55,10,0,22,2,male
576 ms,576,157600 KB,157600,China,Asia,58,442,284.9884404,2589.2276,55.5,143702.1318,48,36,36,12,0,17,2,male
46 ms,46,34900 KB,34900,India,Asia,64,456,320.4063545,2736,68.79310345,188217.931,61,52,48,9,4,20,1,male
77 ms,77,7700 KB,7700,India,Asia,62,423,310.1726115,2518.625039,33.91304348,85414.24046,88,68,53,20,15,23,2,male
826 ms,826,129400 KB,129400,Iran,Asia,65,337,327.3557123,2029.537953,46.25,93866.13033,62,44,34,18,10,15,3,male
124 ms,124,4000 KB,4000,Iran,Asia,76,480,399.4510684,2999.005206,91.41176471,274144.3583,59,49,46,10,3,21,2,male
140 ms,140,34600 KB,34600,Kazakhstan,AsiaEurope,42,393,214.8771238,2119.180747,20,42383.61494,81,56,55,25,1,15,2,male
46 ms,46,4300 KB,4300,Kazakhstan,AsiaEurope,67,443,339.6973857,2687.277511,60.38709677,162276.8871,71,56,46,15,10,22,2,male
140 ms,140,15900 KB,15900,Bangladesh,Asia,69,403,354.8592943,2461.735356,76.22222222,187638.9394,62,54,52,8,2,16,3,female
62 ms,62,4000 KB,4000,China,Asia,80,460,426.079159,2908.086924,47.64864865,138566.4121,69,51,48,18,3,20,2,male
61 ms,61,19900 KB,19900,Bangladesh,Asia,74,367,385.5385456,2278.869385,43.80555556,99827.13946,61,46,40,15,6,16,2,male
546 ms,546,47400 KB,47400,India,Asia,75,446,392.17102,2778.053136,33.59210526,93320.65337,82,70,70,12,0,20,3,male
93 ms,93,7900 KB,7900,Georgia,AsiaEurope,68,384,347.4830616,2337.585731,23.57142857,55100.23509,56,51,51,5,0,14,2,male
670 ms,670,157400 KB,157400,Hong Kong,Asia,74,442,385.4995491,2744.578388,69,189375.9087,49,38,35,11,3,19,3,male
764 ms,764,66300 KB,66300,Russia,AsiaEurope,34,294,162,1495.714075,16,23931.42521,58,38,35,20,3,15,2,female
31 ms,31,20800 KB,20800,China,Asia,73,478,380.0574174,2958.736139,43.35483871,128275.5281,63,36,35,27,1,21,1,female
46 ms,46,900 KB,900,Kazakhstan,AsiaEurope,73,392,380.0574174,2426.411227,49.4516129,119989.9487,85,51,44,34,7,19,3,male
78 ms,78,16100 KB,16100,Egypt,AsiaAfrica,67,399,341.2590864,2420.369587,69.62962963,168529.4379,48,39,39,9,0,20,3,male
124 ms,124,16200 KB,16200,Egypt,AsiaAfrica,66,417,333.6312234,2520.512348,59.32758621,149535.9136,52,40,38,12,2,19,3,male
108 ms,108,36700 KB,36700,Iran,Asia,67,437,340.3026944,2650.880976,43.89655172,116364.5339,65,48,48,17,0,19,3,male
78 ms,78,15900 KB,15900,China,Asia,63,340,314.1308434,2032.275174,31.25,63508.59919,60,38,33,22,5,10,2,male
109 ms,109,20500 KB,20500,United States,North America,83,400,446.2065082,2550.015773,51.1627907,130465.9232,54,36,29,18,7,14,4,male
966 ms,966,158400 KB,158400,Vietnam,Asia,73,480,380.0574174,2971.115788,60.96774194,181142.2206,64,44,40,20,4,12,3,male
62 ms,62,31600 KB,31600,India,Asia,71,476,365.7235111,2927.279629,44.07352941,129015.5448,76,56,49,20,7,21,3,male
467 ms,467,236200 KB,236200,China,Asia,82,530,439.6362367,3369.502562,54.42105263,183371.8763,62,52,52,10,0,20,3,female
171 ms,171,4000 KB,4000,Brazil,South America,60,457,296.1564001,2699.449002,46.5,125524.3786,56,47,43,9,4,23,1,male
561 ms,561,31700 KB,31700,India,Asia,41,278,208.1306865,1489.399457,19.5,29043.28942,61,45,42,16,3,15,3,male
451 ms,451,236200 KB,236200,China,Asia,82,530,439.6362367,3369.502562,54.42105263,183371.8763,62,52,52,10,0,20,3,female
811 ms,811,16100 KB,16100,Canada,North America,65,353,327.8032081,2125.895838,57.7037037,122672.0635,64,47,38,17,9,15,3,male
327 ms,327,20700 KB,20700,Bangladesh,Asia,69,408,353.3374044,2492.277978,70.2,174957.9141,72,58,52,14,6,17,3,male
46 ms,46,15900 KB,15900,Romania,Europe,56,333,270.5069309,1933.849189,19.36956522,37457.81799,50,44,44,6,0,19,1,female
155 ms,155,4100 KB,4100,China,Asia,84,499,453.2640759,3189.766394,64.03846154,204267.7325,72,50,45,22,5,27,4,female
155 ms,155,62600 KB,62600,India,Asia,37,339,181.5249056,1766.004691,17.5,30905.08209,71,54,44,17,10,7,2,female
155 ms,155,4200 KB,4200,China,Asia,84,500,453.2640759,3196.158711,64.03846154,204677.0867,72,50,45,22,5,27,4,female
139 ms,139,17100 KB,17100,Croatia,Europe,63,490,314.9612072,2928.867163,53.36538462,156300.1226,66,51,50,15,1,20,3,female
62 ms,62,31500 KB,31500,China,Asia,71,450,365.8862514,2767.386204,58.72727273,162521.0443,45,40,40,5,0,18,2,female
124 ms,124,31500 KB,31500,India,Asia,42,442,210.885574,2383.404301,19.5,46476.38387,47,28,24,19,4,10,1,female
61 ms,61,4000 KB,4000,China,Asia,81,371,432.6080183,2352.084351,49,115252.1332,69,54,52,15,2,18,2,female
46 ms,46,4200 KB,4200,South Korea,Asia,56,435,276.8771238,2526.199391,28.75,72628.23249,77,64,64,13,0,19,1,female
77 ms,77,19700 KB,19700,Bangladesh,Asia,66,377,333.3240179,2278.736583,29.4,66994.85554,67,58,56,9,2,19,2,female
62 ms,62,47400 KB,47400,China,Asia,88,414,482.043467,2674.20469,39.53921569,105735.956,63,50,45,13,5,17,3,female
61 ms,61,32000 KB,32000,China,Asia,96,562,536.6378566,3700.748925,44.42307692,164398.6542,55,45,45,10,0,29,4,female
155 ms,155,19400 KB,19400,Russia,AsiaEurope,75,449,392.9423377,2796.739592,78.27272727,218908.4353,63,53,48,10,5,19,1,female
186 ms,186,31600 KB,31600,India,Asia,68,386,347.4830616,2349.760657,62.14285714,146020.8408,61,45,45,16,0,17,3,female
187 ms,187,15800 KB,15800,Croatia,Europe,83,455,446.2065082,2900.642941,90.8375,263487.1532,72,35,22,37,13,14,3,female
935 ms,935,20300 KB,20300,Peru,South America,71,490,365.6422056,3013.376089,61.25,184569.2854,71,64,64,7,0,19,5,female
468 ms,468,15900 KB,15900,China,Asia,69,360,352.7497745,2199.068804,42.78125,94078.91229,75,50,40,25,10,17,2,female
46 ms,46,16000 KB,16000,China,Asia,72,489,372.5956925,3017.093326,68.54545455,206808.0334,72,48,44,24,4,19,1,female
873 ms,873,16800 KB,16800,Russia,AsiaEurope,66,371,333.6312234,2242.470218,52.94827586,118734.9317,64,39,28,25,11,11,1,female
46 ms,46,16100 KB,16100,China,Asia,71,537,370.1802547,3302.414203,83.72,276478.1171,62,48,48,14,0,13,2,female
826 ms,826,15800 KB,15800,Japan,Asia,77,437,405.7769322,2738.585718,49.54166667,135674.1008,56,42,41,14,1,15,2,female
93 ms,93,126000 KB,126000,Iran,Asia,0,0,0,0,0,0,76,55,46,21,9,16,3,female
202 ms,202,15900 KB,15900,India,Asia,60,440,296.7916995,2599.031862,35.39130435,91983.12764,86,60,56,26,4,19,2,female
46 ms,46,17500 KB,17500,China,Asia,81,543,433.2506894,3442.538552,46.875,161368.9946,84,69,67,15,2,15,5,female
702 ms,702,15700 KB,15700,Kazakhstan,AsiaEurope,74,489,385.5385456,3036.422696,65.44444444,198716.9964,72,52,52,20,0,24,2,female
342 ms,342,39500 KB,39500,China,Asia,79,541,419.0808777,3410.345385,60.96052632,207896.4496,59,49,49,10,0,30,4,female
327 ms,327,39700 KB,39700,China,Asia,79,541,419.0808777,3410.345385,60.96052632,207896.4496,59,49,49,10,0,30,4,female
155 ms,155,16000 KB,16000,China,Asia,76,440,398.8804611,2749.088106,66.93243243,184003.1539,81,51,32,30,19,18,5,female
31 ms,31,8000 KB,8000,India,Asia,78,482,412.5946318,3029.563869,33.42857143,101273.9922,89,60,50,29,10,15,1,female
46 ms,46,8000 KB,8000,India,Asia,79,496,419.4466845,3126.675251,35.1627907,109942.6274,79,60,60,19,0,16,1,female
140 ms,140,19600 KB,19600,Bangladesh,Asia,73,535,378.8670746,3311.556139,62.69444444,207616.1724,76,61,51,15,10,23,2,female
732 ms,732,97100 KB,97100,Unknown,Unknown,74,575,385.6555921,3570.435685,51.15384615,182641.5177,91,64,59,27,5,24,4,female
46 ms,46,15800 KB,15800,South Korea,Asia,70,452,359.2147805,2770.435924,71.75757576,198799.7657,74,55,42,19,13,16,2,female
46 ms,46,17200 KB,17200,Serbia,Europe,61,433,302.7888745,2568.009267,70.14583333,180135.1501,55,49,46,6,3,20,1,female
31 ms,31,600 KB,600,China,Asia,91,531,501.5981141,3455.638954,70,241894.7268,62,45,40,17,5,22,4,female
405 ms,405,40600 KB,40600,South Korea,Asia,100,579,567.2905595,3846.792734,44.66666667,171823.4088,97,60,48,37,12,27,6,female
109 ms,109,31400 KB,31400,India,Asia,70,514,360.541081,3150.451471,78.46551724,247201.8042,97,73,63,24,10,23,3,female
46 ms,46,4000 KB,4000,China,Asia,91,571,501.8524417,3715.95074,46.74,173683.5376,69,46,43,23,3,26,1,female
296 ms,296,4000 KB,4000,Taiwan,Asia,96,567,537.6344164,3733.673738,48.08181818,179521.8218,85,73,68,12,5,20,4,female
46 ms,46,4000 KB,4000,China,Asia,92,579,508.6701412,3777.142373,47.88,180849.5768,69,46,43,23,3,26,1,female
61 ms,61,16800 KB,16800,Germany,Europe,59,400,290.8572701,2353.05722,46.25,108828.8964,63,54,50,9,4,17,1,female
62 ms,62,4200 KB,4200,China,Asia,85,567,460.0105131,3634.124661,46.125,167624,58,48,46,10,2,32,5,female
77 ms,77,31400 KB,31400,India,Asia,69,441,352.7497745,2693.859285,45.09375,121476.2172,62,50,49,12,1,19,2,female
62 ms,62,15800 KB,15800,Poland,Europe,62,440,307.3464548,2619.846377,43.24137931,113285.7709,74,63,59,11,4,22,1,female
46 ms,46,15800 KB,15800,China,Asia,74,584,385.5385456,3626.320766,46.42105263,168337.6271,99,67,61,32,6,18,3,female
795 ms,795,16000 KB,16000,Syria,Asia,61,408,303.4631705,2419.740834,54.52173913,131928.4785,96,70,52,26,18,21,4,female
140 ms,140,27600 KB,27600,China,Asia,99,684,561.9099458,4534.479928,64.4516129,292254.545,85,70,63,15,7,27,1,female
358 ms,358,800 KB,800,Belarus,Europe,74,553,385.6555921,3433.827711,80.22857143,275491.0918,75,62,52,13,10,30,2,female
93 ms,93,35600 KB,35600,Bangladesh,Asia,67,409,339.9564924,2481.030479,33.91666667,84148.28374,86,74,67,12,7,23,3,female
514 ms,514,16100 KB,16100,Bangladesh,Asia,81,463,432.9647657,2935.350551,62.43243243,183261.075,84,59,46,25,13,21,9,female
30 ms,30,200 KB,200,China,Asia,71,560,366.1306865,3443.858387,76.78125,264423.7518,83,75,74,8,1,25,3,female
61 ms,61,4000 KB,4000,India,Asia,66,529,333.3240179,3197.484489,67.2,214870.9577,73,68,68,5,0,24,2,female
31 ms,31,19700 KB,19700,China,Asia,92,519,508.4501668,3385.728655,50.89795918,172326.6789,88,63,51,25,12,13,3,female
62 ms,62,17200 KB,17200,India,Asia,57,395,277.6324012,2303.991556,51.70454545,119126.8361,74,63,55,11,8,20,1,female
62 ms,62,17000 KB,17000,Unknown,Unknown,58,457,289.1465005,2677.097315,33.76470588,90391.40345,87,60,51,27,9,19,2,female
62 ms,62,15800 KB,15800,India,Asia,50,450,242.4407955,2539.735285,28.5,72382.45563,77,53,49,24,4,12,1,female
62 ms,62,17200 KB,17200,Russia,AsiaEurope,61,415,301.7363383,2461.255995,59.90384615,147438.7005,73,54,41,19,13,20,1,female
109 ms,109,31700 KB,31700,Indonesia,Asia,98,657,552.6400215,4345.864368,70.34482759,305709.0797,113,77,54,36,23,21,2,female
919 ms,919,4000 KB,4000,China,Asia,75,457,393.7950768,2846.570142,41.87096774,119188.6466,82,48,48,34,0,12,2,female
140 ms,140,4000 KB,4000,Iran,Asia,74,473,386.1246381,2937.071442,65.84848485,193401.7043,97,50,36,47,14,15,2,female
296 ms,296,19000 KB,19000,Russia,AsiaEurope,67,404,341.8710649,2450.700033,37.05769231,90817.28776,69,54,46,15,8,18,2,female
62 ms,62,900 KB,900,Belarus,Europe,72,600,372.3949821,3701.955001,90.52941176,335135.8086,82,68,57,14,11,32,2,female
78 ms,78,15900 KB,15900,India,Asia,87,459,473.5443757,2957.311065,37.13636364,109823.7791,75,56,52,19,4,20,2,female
46 ms,46,9500 KB,9500,France,Europe,73,491,380.0574174,3039.203858,81.29032258,247057.862,81,63,51,18,12,20,1,female
108 ms,108,27300 KB,27300,China,Asia,100,724,567.9056641,4810.151881,54.02459016,259866.484,82,75,75,7,0,37,4,female
62 ms,62,11900 KB,11900,China,Asia,82,433,439.3544556,2752.820018,38.0952381,104869.334,84,53,46,31,7,16,2,female
46 ms,46,1100 KB,1100,Russia,AsiaEurope,65,465,328.3421192,2800.401033,68.25,191127.3705,67,51,45,16,6,21,2,female
187 ms,187,31600 KB,31600,India,Asia,73,485,378.9461511,3002.064911,68.4,205341.2399,75,60,60,15,0,22,4,female
46 ms,46,11800 KB,11800,China,Asia,108,566,625.4073436,3823.266326,41.68181818,159360.6919,69,46,45,23,1,22,4,female
139 ms,139,32100 KB,32100,India,Asia,59,463,290.159225,2723.663732,57.91304348,157735.6561,98,78,69,20,9,17,3,female
140 ms,140,3900 KB,3900,China,Asia,68,484,346.3298602,2946.332015,74,218028.5691,59,52,52,7,0,18,1,female
171 ms,171,4000 KB,4000,China,Asia,68,484,346.3298602,2946.332015,74,218028.5691,59,52,52,7,0,18,1,female
234 ms,234,15800 KB,15800,Unknown,Unknown,66,486,336.5164318,2937.575542,36.75,107955.9012,71,46,41,25,5,10,1,female
124 ms,124,63100 KB,63100,India,Asia,46,501,242.2149912,2767.30454,22,60880.69988,88,57,46,31,11,21,4,female
46 ms,46,9100 KB,9100,Russia,AsiaEurope,66,580,333.3240179,3505.748589,81,283965.6357,102,91,89,11,2,26,1,female
810 ms,810,13300 KB,13300,South Korea,Asia,99,634,557.6636341,4203.012097,42.09433962,176923.0187,83,55,50,28,5,24,5,female
62 ms,62,16100 KB,16100,China,Asia,65,507,327.3557123,3053.340481,56.82142857,173495.1681,107,56,56,51,0,13,3,female
62 ms,62,4200 KB,4200,Iran,Asia,66,406,333.3240179,2454.024012,54,132517.2967,84,51,41,33,10,17,3,female
62 ms,62,32300 KB,32300,China,Asia,76,621,398.842491,3879.962986,76,294877.1869,89,67,60,22,7,24,3,female
31 ms,31,300 KB,300,China,Asia,99,587,561.1962231,3891.432336,39.55737705,153934.8562,98,62,52,36,10,14,3,female
93 ms,93,16900 KB,16900,Japan,Asia,80,472,425.7903187,2983.950061,51.51282051,153711.6839,85,50,44,35,6,14,1,female
46 ms,46,15900 KB,15900,Serbia,Europe,52,486,247.1756287,2770.413703,23.44736842,64958.91077,100,69,50,31,19,27,2,female
62 ms,62,16800 KB,16800,India,Asia,0,0,0,0,0,0,80,50,44,30,6,12,1,female
31 ms,31,700 KB,700,Russia,AsiaEurope,73,471,380.0574174,2915.407367,75.19354839,219219.8249,78,55,51,23,4,17,1,female
46 ms,46,19500 KB,19500,China,Asia,75,479,392.2479866,2983.604153,48.75,145450.7024,67,57,57,10,0,11,2,female
62 ms,62,8600 KB,8600,Kazakhstan,AsiaEurope,85,563,460.2145365,3608.487097,58.5,211096.4952,102,44,32,58,12,20,3,female
61 ms,61,15800 KB,15800,China,Asia,77,637,405.551932,3991.943026,48.23076923,192534.4829,115,67,62,48,5,19,3,female
108 ms,108,19500 KB,19500,India,Asia,67,554,341.2590864,3360.613412,61.48148148,206615.4912,93,57,49,36,8,19,3,female
139 ms,139,75900 KB,75900,Bangladesh,Asia,62,385,309.4603455,2292.365579,29.29166667,67147.20843,109,63,33,46,30,17,2,female
61 ms,61,800 KB,800,Ukraine,Europe,77,419,406.0022373,2625.783561,51,133914.9616,74,62,57,12,5,17,3,female
93 ms,93,16600 KB,16600,Vietnam,Asia,100,640,565.1081736,4252.067961,44.18181818,187864.0936,92,64,64,28,0,31,5,female
31 ms,31,16000 KB,16000,China,Asia,83,583,446.5546348,3716.647988,78.75,292686.0291,85,51,48,34,3,18,3,female
77 ms,77,700 KB,700,Cuba,North America,68,486,347.0121354,2958.506941,66.56896552,196944.7465,83,69,58,14,11,22,1,female
108 ms,108,47400 KB,47400,Bangladesh,Asia,88,580,480.5611817,3746.470339,75.02380952,281074.4771,99,73,59,26,14,25,10,female
93 ms,93,5900 KB,5900,China,Asia,98,602,552.6400215,3982.055326,51.03448276,203222.1339,83,49,46,34,3,19,4,female
296 ms,296,15900 KB,15900,India,Asia,75,534,392.9423377,3326.189181,52.18181818,173566.5991,115,67,40,48,27,26,6,female
171 ms,171,16000 KB,16000,Singapore,Asia,66,553,336.5164318,3342.549948,64.75,216430.1091,97,53,33,44,20,20,7,female
592 ms,592,16000 KB,16000,South Korea,Asia,81,540,432.75063,3423.519002,76.38157895,261493.7869,94,50,42,44,8,19,3,female
78 ms,78,15800 KB,15800,Russia,AsiaEurope,92,567,508.1677,3698.859629,92,340295.0859,85,66,58,19,8,23,4,female
61 ms,61,15700 KB,15700,India,Asia,0,0,0,0,0,0,91,68,61,23,7,27,4,female
62 ms,62,15700 KB,15700,India,Asia,0,0,0,0,0,0,91,68,61,23,7,27,4,female
78 ms,78,31900 KB,31900,Singapore,Asia,80,575,426.3322913,3635.108655,58.90909091,214140.9462,92,68,60,24,8,24,3,female
249 ms,249,63300 KB,63300,Japan,Asia,75,560,394.3401072,3488.138467,54.75,190975.5811,65,57,54,8,3,19,3,female
78 ms,78,900 KB,900,South Korea,Asia,70,639,359.7107722,3916.611848,88.69354839,347378.2024,101,71,62,30,9,28,1,female
46 ms,46,900 KB,900,Germany,Europe,67,511,340.3026944,3099.771576,75.34482759,233551.755,88,65,48,23,17,23,3,female
171 ms,171,31600 KB,31600,Russia,AsiaEurope,74,673,385.8508604,4178.962115,51.76470588,216322.7448,129,60,35,69,25,21,2,female
109 ms,109,16000 KB,16000,Unknown,Unknown,63,396,314.1308434,2367.00285,46.875,110953.2586,118,80,55,38,25,22,2,female
61 ms,61,36100 KB,36100,Russia,AsiaEurope,90,491,494.5555318,3187.49987,46.375,147820.3065,98,54,46,44,8,10,2,female
483 ms,483,15900 KB,15900,Bangladesh,Asia,66,535,333.6312234,3233.750854,52.94827586,171221.5323,96,57,44,39,13,26,3,female
46 ms,46,8200 KB,8200,China,Asia,96,712,536.4270818,4688.493301,83.82352941,393006.0561,100,77,72,23,5,25,2,female
109 ms,109,31600 KB,31600,Bangladesh,Asia,61,340,302.2137048,2016.450695,28.08,56621.93551,89,52,42,37,10,18,2,female
62 ms,62,18100 KB,18100,China,Asia,83,631,448.094519,4022.649881,85.75,344942.2273,119,90,89,29,1,28,6,female
514 ms,514,20000 KB,20000,Bangladesh,Asia,84,582,453.2640759,3720.32874,86.53846154,321951.5256,108,77,63,31,14,28,10,female
529 ms,529,700 KB,700,Philippines,Asia,81,680,432.9647657,4311.098002,93.94594595,405010.1799,103,95,90,8,5,31,4,female
46 ms,46,4000 KB,4000,Bulgaria,Europe,85,517,461.2380824,3313.655114,70.77777778,234533.1453,115,84,65,31,19,21,7,female
62 ms,62,32900 KB,32900,Georgia,AsiaEurope,71,628,365.6422056,3862.041191,62.22857143,240329.3061,85,65,58,20,7,19,1,female
748 ms,748,19800 KB,19800,Jordan,Asia,74,606,385.6555921,3762.92874,57.38571429,215938.3535,83,67,62,16,5,29,4,female
78 ms,78,26700 KB,26700,China,Asia,105,688,600.5529308,4619.400916,45.47368421,210061.1785,107,76,70,31,6,36,5,female
592 ms,592,16000 KB,16000,South Korea,Asia,84,597,453.092115,3816.213501,81.95,312738.6964,101,57,49,44,8,22,3,female
624 ms,624,4400 KB,4400,India,Asia,86,612,466.7930215,3932.87403,58.7195122,230936.4446,97,54,50,43,4,23,3,female
61 ms,61,700 KB,700,Poland,Europe,55,549,282.613175,3173.966483,56.22222222,178447.4489,100,57,47,43,10,11,4,female
685 ms,685,63100 KB,63100,Iran,Asia,45,430,224.4867643,2361.496831,24,56675.92395,107,46,14,61,32,16,2,female
62 ms,62,18100 KB,18100,China,Asia,83,631,448.094519,4022.649881,85.75,344942.2273,125,90,89,35,1,28,6,female
46 ms,46,9100 KB,9100,Belarus,Europe,41,432,200.7497745,2314.462466,18.5,42817.55562,132,61,23,71,38,18,3,female
46 ms,46,19900 KB,19900,China,Asia,100,619,566.2402295,4112.546981,61.55172414,253134.3573,78,53,48,25,5,19,2,female
61 ms,61,15900 KB,15900,China,Asia,107,874,616.2935606,5892.042146,63.87096774,376330.4338,114,70,65,44,5,21,3,female
46 ms,46,4100 KB,4100,China,Asia,85,535,460.0105131,3429.024151,70.3125,241103.2606,99,81,77,18,4,23,3,female
62 ms,62,31500 KB,31500,India,Asia,99,700,557.3135919,4640.549634,53.9,250125.6253,81,56,56,25,0,27,7,female
77 ms,77,4400 KB,4400,Unknown,Unknown,72,453,372.5956925,2794.976026,50.81818182,142035.5998,108,77,63,31,14,20,3,female
109 ms,109,1500 KB,1500,Unknown,Unknown,71,685,369.344822,4212.576777,63.17307692,266121.4368,107,81,77,26,4,25,4,female
62 ms,62,31400 KB,31400,Unknown,Unknown,89,476,487.9979062,3082.449113,57.55102041,177398.0918,102,79,67,23,12,20,1,female
46 ms,46,4100 KB,4100,India,Asia,81,555,433.2506894,3518.616752,73.75,259497.9854,109,80,66,29,14,25,5,female
483 ms,483,31700 KB,31700,Egypt,AsiaAfrica,76,630,401.9471249,3936.194333,55.9137931,220087.5556,106,68,66,38,2,24,3,female
31 ms,31,100 KB,100,Russia,AsiaEurope,75,732,392.6333688,4559.495281,112.75,514083.093,121,111,104,10,7,31,5,female
592 ms,592,1700 KB,1700,Peru,South America,83,601,446.2065082,3831.398698,69.3375,265659.6072,92,71,64,21,7,28,4,female
61 ms,61,47300 KB,47300,China,Asia,109,656,633.6071054,4439.928917,50.34558824,223530.8331,114,38,29,76,9,11,2,female
77 ms,77,31400 KB,31400,India,Asia,38,175,162.6452839,918.3873149,25.3,23235.19907,102,70,67,32,3,15,2,female
46 ms,46,4000 KB,4000,China,Asia,107,619,615.8588276,4172.968065,64.47540984,269053.8262,107,65,47,42,18,28,4,female
140 ms,140,31800 KB,31800,India,Asia,53,485,268.7443162,2778.04142,26.88888889,74698.44708,117,89,85,28,4,25,4,female
639 ms,639,253100 KB,253100,China,Asia,99,737,558.1897755,4885.835829,71.25,348115.8028,92,67,67,25,0,36,11,female
156 ms,156,192800 KB,192800,India,Asia,84,703,452.9546635,4493.799148,64,287603.1455,122,83,78,39,5,23,4,female
62 ms,62,15800 KB,15800,India,Asia,76,603,399.4510684,3767.500291,44.47058824,167542.9541,126,67,48,59,19,18,3,female
31 ms,31,700 KB,700,Ukraine,Europe,70,548,362.4264239,3358.847093,67.69230769,227368.1109,111,66,56,45,10,15,5,female
171 ms,171,31600 KB,31600,China,Asia,99,856,557.6636341,5674.729267,68.56603774,389093.701,80,58,51,22,7,25,4,female
61 ms,61,36200 KB,36200,Kazakhstan,AsiaEurope,72,371,372.8771238,2289.042176,53.125,121605.3656,110,56,50,54,6,14,1,female
405 ms,405,800 KB,800,Taiwan,Asia,84,652,454.1955001,4167.79096,71.33333333,297302.4218,101,46,28,55,18,21,3,female
124 ms,124,27800 KB,27800,China,Asia,101,796,571.5436477,5299.93634,65.79591837,348714.1788,121,88,86,33,2,41,8,female
61 ms,61,2400 KB,2400,China,Asia,106,681,609.3751625,4581.71383,62.4516129,286135.4185,114,70,51,44,19,31,5,female
62 ms,62,5000 KB,5000,China,Asia,100,720,565.1081736,4783.576457,87.13636364,416823.4576,144,95,83,49,12,28,8,female
233 ms,233,31800 KB,31800,Unknown,Unknown,63,623,316.1697866,3723.845392,47.9375,178511.8385,135,77,61,58,16,19,3,female
46 ms,46,4100 KB,4100,China,Asia,113,772,658.4538637,5265.178159,48.53225806,255530.9852,114,87,81,27,6,43,12,female
62 ms,62,15900 KB,15900,India,Asia,84,591,452.9890166,3777.859597,59.59302326,225134.0748,138,68,47,70,21,23,5,female
93 ms,93,16000 KB,16000,India,Asia,82,704,439.460071,4475.716611,65.75581395,294304.3888,125,96,92,29,4,27,2,female
78 ms,78,47000 KB,47000,India,Asia,61,566,301.0709438,3356.797333,53.03571429,178030.1443,118,99,93,19,6,29,2,female
202 ms,202,67300 KB,67300,Iran,Asia,91,737,501.2172393,4796.24465,74.62222222,357906.4341,101,41,41,60,0,18,5,female
62 ms,62,19800 KB,19800,China,Asia,39,209,177.5800856,1104.649064,15.5,17122.06049,110,66,56,44,10,25,6,female
93 ms,93,20800 KB,20800,Spain,Europe,77,746,405.551932,4675.022759,72.1025641,337081.1282,139,105,99,34,6,28,5,female
654 ms,654,98800 KB,98800,Russia,AsiaEurope,76,597,401.2905678,3730.012726,45.23333333,168720.909,144,67,46,77,21,21,6,female
93 ms,93,17500 KB,17500,Japan,Asia,95,633,530.0571158,4158.7186,51.50943396,214213.2411,91,46,41,45,5,16,3,female
77 ms,77,16000 KB,16000,India,Asia,78,574,414.6457617,3607.820874,40.17741935,144952.9322,116,60,38,56,22,18,3,female
46 ms,46,4300 KB,4300,China,Asia,58,524,303.6501074,3069.582041,29.94444444,91916.92891,144,100,93,44,7,30,4,female
124 ms,124,15900 KB,15900,Unknown,Unknown,71,558,369.344822,3431.558893,57.11538462,195994.806,116,75,75,41,0,21,2,female
46 ms,46,19100 KB,19100,China,Asia,99,693,559.9530637,4594.144138,63.72881356,292779.3552,104,80,80,24,0,26,2,female
46 ms,46,15900 KB,15900,China,Asia,121,776,717.5272573,5369.037872,53.77941176,288743.6985,151,86,71,65,15,35,7,female
78 ms,78,35800 KB,35800,Unknown,Unknown,73,520,381.7393272,3218.708771,42.58928571,137082.5075,116,56,39,60,17,20,2,female
46 ms,46,4000 KB,4000,China,Asia,119,771,704.1705935,5315.904496,74.9,398161.2467,109,80,73,29,7,33,4,female
62 ms,62,15800 KB,15800,India,Asia,76,815,398.9944238,5092.060923,56.66666667,288550.119,136,100,99,36,1,28,5,female
46 ms,46,21600 KB,21600,Russia,AsiaEurope,79,622,419.4466845,3920.951625,59.125,231826.2648,123,77,70,46,7,22,1,female
61 ms,61,8500 KB,8500,Bangladesh,Asia,70,568,359.4212455,3481.432754,59.375,206710.0697,131,79,66,52,13,21,5,female
77 ms,77,55000 KB,55000,Indonesia,Asia,123,926,736.6264136,6428.768432,67.20779221,432063.3329,136,56,35,80,21,22,2,female
46 ms,46,16100 KB,16100,China,Asia,90,586,494.2667787,3804.225914,28,106518.3256,101,48,41,53,7,24,1,female
171 ms,171,31700 KB,31700,India,Asia,61,619,308.3880345,3671.126412,29.86111111,109623.9137,206,151,131,55,20,35,12,female
436 ms,436,20100 KB,20100,Serbia,Europe,69,544,353.3374044,3323.037304,39,129598.4549,128,62,47,66,15,19,4,female
62 ms,62,16100 KB,16100,China,Asia,93,618,515.149526,4041.200145,29.11956522,117677.9912,105,50,43,55,7,24,1,female
482 ms,482,141700 KB,141700,Russia,AsiaEurope,109,933,632.9053075,6314.715975,70.52238806,445328.8505,164,121,109,43,12,32,7,female
249 ms,249,6300 KB,6300,China,Asia,141,1102,873.5604711,7867.78559,51.56666667,405715.4769,95,48,45,47,3,35,17,female
62 ms,62,31900 KB,31900,India,Asia,70,512,360.541081,3138.192905,50.18965517,157504.8198,145,93,79,52,14,28,2,female
62 ms,62,32000 KB,32000,India,Asia,78,1014,414.6457617,6373.39785,59.12903226,376852.8471,174,114,102,60,12,26,3,female
62 ms,62,19900 KB,19900,China,Asia,94,870,522.16205,5702.492301,73.79166667,420796.411,178,107,92,71,15,33,6,female
93 ms,93,130500 KB,130500,Iran,Asia,0,0,0,0,0,0,114,68,55,46,13,18,3,female
530 ms,530,173800 KB,173800,India,Asia,75,733,393.7950768,4565.7241,72.38709677,330499.5123,143,121,118,22,3,35,8,female
483 ms,483,173600 KB,173600,India,Asia,75,733,393.7950768,4565.7241,72.38709677,330499.5123,143,121,118,22,3,35,8,female
607 ms,607,129600 KB,129600,India,Asia,61,699,308.3880345,4145.585399,29.86111111,123791.7862,236,163,131,73,32,37,13,female
30 ms,30,600 KB,600,Russia,AsiaEurope,80,526,425.8985773,3325.334178,40.34210526,134150.9814,146,58,46,88,12,20,4,female
62 ms,62,31600 KB,31600,Russia,AsiaEurope,85,547,459.8067162,3505.936842,41.51162791,145537.1457,148,60,47,88,13,21,4,female
514 ms,514,173400 KB,173400,Bangladesh,Asia,126,1079,760.6612396,7528.485037,83.33333333,627373.7531,187,116,79,71,37,39,9,female
31 ms,31,200 KB,200,China,Asia,158,1629,1026.614,11897.85884,47.5210084,565398.2499,146,142,140,4,2,69,2,female
607 ms,607,189200 KB,189200,Bangladesh,Asia,43,229,190.7497228,1242.614629,22.73684211,28253.13261,138,60,46,78,14,24,3,female
109 ms,109,8300 KB,8300,India,Asia,119,1114,705.3002761,7680.826988,133.1666667,1022830.127,148,98,86,50,12,35,10,female
124 ms,124,8300 KB,8300,India,Asia,119,1114,705.3002761,7680.826988,133.1666667,1022830.127,148,98,86,50,12,35,10,female
997 ms,997,31500 KB,31500,India,Asia,130,1263,788.6486326,8869.250548,67.14814815,595553.7498,244,129,85,115,44,24,6,female
156 ms,156,102500 KB,102500,Taiwan,Asia,103,973,586.2775517,6505.965013,49.9375,324891.6278,157,87,79,70,8,28,6,female
62 ms,62,4200 KB,4200,Belarus,Europe,106,873,607.1595682,5873.474557,81.5,478688.1764,217,68,33,149,35,24,10,female
93 ms,93,16200 KB,16200,India,Asia,115,951,674.0507942,6510.061038,58.65151515,381824.9436,169,113,109,56,4,27,11,female
155 ms,155,16100 KB,16100,India,Asia,116,944,680.1484193,6473.934059,68.56349206,443875.5265,167,113,109,54,4,29,10,female
109 ms,109,8900 KB,8900,France,Europe,99,1341,557.3135919,8889.967228,87.24489796,775604.2836,220,86,30,134,56,49,30,female
31 ms,31,15700 KB,15700,China,Asia,153,1408,960.8354139,10218.40208,82.95,847616.4527,244,156,134,88,22,51,26,female
608 ms,608,172800 KB,172800,Bangladesh,Asia,93,743,518.5920309,4858.594997,50.52631579,245486.9051,201,74,56,127,18,27,5,female
888 ms,888,31300 KB,31300,Russia,AsiaEurope,108,672,622.8406536,4539.284401,62.79508197,285044.7361,116,49,44,67,5,26,7,female
124 ms,124,31400 KB,31400,South Korea,Asia,139,1547,850.5795187,11013.00184,104.8732394,1154969.179,226,115,73,111,42,57,35,female
46 ms,46,15900 KB,15900,China,Asia,6,14,15.509775,36.18947501,0,0,152,73,73,79,0,72,38,female
31 ms,31,15900 KB,15900,China,Asia,6,14,15.509775,36.18947501,0,0,152,73,73,79,0,71,38,female
46 ms,46,15900 KB,15900,China,Asia,6,14,15.509775,36.18947501,0,0,152,73,73,79,0,72,38,female
61 ms,61,16000 KB,16000,China,Asia,149,1619,934.9002079,11687.83383,72.18947368,843738.573,334,200,166,134,34,72,40,female
109 ms,109,63500 KB,63500,India,Asia,124,1602,742.2821841,11140.62249,83.3,928013.8534,321,241,221,80,20,55,14,female
93 ms,93,16600 KB,16600,Bangladesh,Asia,47,350,222.5444556,1944.106098,29.16666667,56703.09453,276,66,28,210,38,36,16,female
93 ms,93,16300 KB,16300,India,Asia,107,1507,615.1541399,10159.39075,138.28125,1404853.252,332,175,133,157,42,67,17,female
31 ms,31,900 KB,900,India,Asia,80,1643,437.8703933,10386.92786,50.09090909,520290.6592,504,361,300,143,61,82,25,female
92 ms,92,44300 KB,44300,China,Asia,210,4369,1452.042082,33703.53867,162.4622642,5475553.202,542,264,181,278,83,206,148,female
93 ms,93,47000 KB,47000,India,Asia,62,263,307.3464548,1565.95363,23.32758621,36529.91829,31,24,24,7,0,15,3,male
156 ms,156,5600 KB,5600,Mongolia,Asia,68,258,345.9899115,1570.565413,33.93939394,53304.03826,26,23,23,3,0,16,1,male
77 ms,77,67100 KB,67100,India,Asia,50,313,235.9518742,1766.526987,24.26470588,42864.25778,48,42,39,6,3,18,2,male
202 ms,202,68100 KB,68100,United States,North America,72,418,372.5956925,2579.028651,53.30769231,137482.0658,42,36,35,6,1,26,2,male
202 ms,202,68100 KB,68100,India,Asia,72,418,372.5956925,2579.028651,53.30769231,137482.0658,41,36,36,5,0,26,2,male
248 ms,248,68100 KB,68100,Serbia,Europe,72,418,372.5956925,2579.028651,53.30769231,137482.0658,41,36,36,5,0,26,2,male
77 ms,77,50600 KB,50600,Poland,Europe,67,325,339.6973857,1971.478987,47.61290323,93867.83821,52,43,41,9,2,19,2,male
77 ms,77,72000 KB,72000,India,Asia,50,345,235.9518742,1947.130385,24.26470588,47246.54612,57,51,51,6,0,34,2,male
77 ms,77,72000 KB,72000,India,Asia,50,345,235.9518742,1947.130385,24.26470588,47246.54612,57,51,51,6,0,34,2,male
202 ms,202,35200 KB,35200,India,Asia,65,424,326.4650059,2553.483953,49.5,126397.4557,66,58,58,8,0,25,3,male
62 ms,62,4700 KB,4700,India,Asia,66,420,333.3240179,2538.64553,72,182782.4782,53,50,50,3,0,24,4,male
78 ms,78,67100 KB,67100,Italy,Europe,60,408,295.1851693,2410.011363,56.23076923,135516.7928,65,50,43,15,7,30,2,male
46 ms,46,36800 KB,36800,United States,North America,80,463,428.700868,2927.052708,34.79591837,101849.4871,59,50,48,9,2,26,2,male
61 ms,61,48600 KB,48600,China,Asia,84,448,455.1665461,2863.758205,51,146051.6685,40,30,27,10,3,23,2,male
124 ms,124,4200 KB,4200,India,Asia,61,328,301.3556992,1945.281847,26.44444444,51441.89772,36,27,23,9,4,21,1,male
92 ms,92,68000 KB,68000,Mexico,North America,56,397,270.0391,2305.519904,56,129109.1146,64,55,50,9,5,24,2,male
62 ms,62,75500 KB,75500,China,Asia,55,420,265.2124025,2428.17108,23.47619048,57004.20678,48,42,42,6,0,44,2,male
109 ms,109,115300 KB,115300,South Korea,Asia,33,345,166.4650059,1740.315971,0,0,84,78,78,6,0,28,2,male
62 ms,62,43600 KB,43600,China,Asia,70,448,359.0498112,2745.918792,36.5,100226.0359,77,60,53,17,7,31,2,male
186 ms,186,82000 KB,82000,Unknown,Unknown,41,262,195.0346806,1403.678625,17.5,24564.37594,66,34,17,32,17,14,2,male
202 ms,202,69000 KB,69000,China,Asia,54,399,258.7036718,2296.200113,46.35714286,106445.2767,83,78,78,5,0,34,2,male
62 ms,62,42900 KB,42900,China,Asia,76,515,400.2149912,3217.682669,42.54545455,136897.7718,50,42,40,8,2,33,2,male
139 ms,139,99100 KB,99100,Poland,Europe,75,405,392.6333688,2522.67157,37.31707317,94138.71955,52,39,33,13,6,22,2,male
46 ms,46,5800 KB,5800,China,Asia,85,541,461.2380824,3467.480496,49.2244898,170684.9583,53,39,36,14,3,29,2,male
93 ms,93,36900 KB,36900,Indonesia,Asia,73,424,379.3421297,2624.485613,42.9,112590.4328,59,46,42,13,4,17,2,male
77 ms,77,55400 KB,55400,China,Asia,67,441,339.5249056,2675.145333,40.22857143,107617.2751,72,66,66,6,0,27,2,female
62 ms,62,55700 KB,55700,China,Asia,84,514,455.1665461,3285.651155,41.14,135171.6885,59,54,54,5,0,27,3,male
77 ms,77,55500 KB,55500,China,Asia,82,405,439.8831639,2574.808562,37.41111111,96326.4492,53,41,37,12,4,24,2,male
171 ms,171,52500 KB,52500,South Korea,Asia,93,533,519.2878033,3485.371646,50.68965517,176672.2869,58,50,47,8,3,26,2,male
248 ms,248,121900 KB,121900,Italy,Europe,60,453,294.4615345,2675.82144,49.58064516,132668.9533,63,55,52,8,3,32,2,male
77 ms,77,68000 KB,68000,China,Asia,62,479,307.3464548,2852.060033,51.20689655,146045.1431,65,60,59,5,1,31,3,male
46 ms,46,16600 KB,16600,Belarus,Europe,66,434,332.9300119,2623.267048,19.5,51153.70743,40,34,34,6,0,31,1,male
46 ms,46,7600 KB,7600,India,Asia,53,350,255.6041684,2004.772159,25.41176471,50944.7984,80,74,74,6,0,31,1,female
62 ms,62,37000 KB,37000,China,Asia,85,593,461.7177151,3800.768825,65.45,248760.3196,38,34,34,4,0,36,3,male
61 ms,61,5800 KB,5800,Brazil,South America,67,424,339.6973857,2572.021817,54.58064516,140382.6101,64,45,30,19,15,20,1,male
249 ms,249,73900 KB,73900,India,Asia,59,385,288.6764386,2264.817574,46.32692308,104922.0295,98,91,89,7,2,32,2,male
202 ms,202,41600 KB,41600,South Korea,Asia,82,476,440.5905816,3026.194754,46.54255319,140846.8303,64,58,57,6,1,31,3,female
124 ms,124,115500 KB,115500,United States,North America,70,398,360.0838417,2439.454641,71.33333333,174014.431,75,60,51,15,9,22,3,male
249 ms,249,68100 KB,68100,Iran,Asia,71,457,365.6422056,2810.434434,43.26388889,121590.3231,69,56,52,13,4,32,2,male
62 ms,62,52400 KB,52400,China,Asia,83,530,450.002951,3378.770899,42.625,144020.1096,55,46,46,9,0,34,2,male
92 ms,92,71100 KB,71100,India,Asia,64,398,320.1804545,2388,64.6,154264.8,51,38,31,13,7,26,2,male
46 ms,46,4800 KB,4800,Singapore,Asia,78,547,414.08385,3438.115014,38.60869565,132741.1362,56,53,52,3,1,31,1,male
46 ms,46,4800 KB,4800,China,Asia,59,428,288.6764386,2517.771225,46.96153846,118238.4102,82,64,62,18,2,26,1,male
249 ms,249,40000 KB,40000,Iran,Asia,65,485,326.4650059,2920.848389,67.39393939,196847.4793,51,39,36,12,3,32,2,male
46 ms,46,5600 KB,5600,Iran,Asia,59,426,289.0701413,2506.005939,76.84,192561.4964,68,57,53,11,4,28,1,male
93 ms,93,11700 KB,11700,China,Asia,89,509,489.1726399,3296.148316,28.81730769,94986.12023,49,43,43,6,0,32,2,male
77 ms,77,42800 KB,42800,Poland,Europe,85,484,461.7177151,3102.145213,33.6,104232.0792,59,43,39,16,4,31,2,male
61 ms,61,36900 KB,36900,Romania,Europe,70,432,359.0910367,2647.850263,48.70588235,128965.8834,67,59,58,8,1,25,2,male
139 ms,139,103600 KB,103600,South Korea,Asia,76,613,399.4510684,3829.979566,63.95238095,244936.3122,47,36,31,11,5,40,3,female
264 ms,264,145200 KB,145200,India,Asia,41,367,188.529325,1966.221586,17.77777778,34955.05041,73,54,44,19,10,30,3,female
436 ms,436,82900 KB,82900,Iran,Asia,60,488,294.8469685,2882.562611,70.27777778,202580.0946,68,54,46,14,8,34,4,male
46 ms,46,5500 KB,5500,India,Asia,59,477,288.1860234,2806.020735,54.25,152226.6248,50,42,38,8,4,31,1,male
93 ms,93,68000 KB,68000,Hungary,Europe,68,453,346.1173001,2757.620667,61.875,170627.7788,49,43,42,6,1,35,3,male
93 ms,93,63400 KB,63400,Bangladesh,Asia,59,370,288.6764386,2176.577928,30.46153846,66301.91228,62,54,52,8,2,24,2,female
62 ms,62,38800 KB,38800,Singapore,Asia,64,478,320.0450916,2868,76.64516129,219818.3226,70,56,49,14,7,27,3,male
77 ms,77,68000 KB,68000,Poland,Europe,66,486,334.0271833,2937.575542,73.96428571,217275.6767,93,69,51,24,18,34,3,male
218 ms,218,33200 KB,33200,Bangladesh,Asia,83,521,450.002951,3321.395544,36.36538462,120783.8264,74,56,56,18,0,25,2,female
46 ms,46,5600 KB,5600,Iran,Asia,52,429,249.0117739,2445.488639,71.02941176,173701.6195,70,63,59,7,4,33,1,male
62 ms,62,21400 KB,21400,Mexico,North America,42,393,210.885574,2119.180747,19.5,41324.02457,47,38,38,9,0,23,1,male
46 ms,46,8500 KB,8500,China,Asia,58,564,282.2114327,3303.901281,80.61538462,266345.2725,68,62,61,6,1,34,1,male
61 ms,61,55600 KB,55600,China,Asia,73,459,378.8670746,2841.129473,43.2972973,123013.2274,55,47,47,8,0,29,2,female
93 ms,93,83700 KB,83700,Italy,Europe,53,482,252.2386659,2760.857659,51.04761905,140935.21,86,61,42,25,19,37,2,male
186 ms,186,85400 KB,85400,Canada,North America,74,529,385.4995491,3284.80083,67.5,221724.0561,56,47,47,9,0,33,3,male
92 ms,92,82700 KB,82700,India,Asia,53,450,253.6843594,2577.564205,35.78947368,92249.66627,91,73,65,18,8,37,2,male
77 ms,77,68000 KB,68000,United States,North America,65,558,326.5538222,3360.48124,56.07352941,188434.0436,74,63,59,11,4,29,2,male
109 ms,109,72300 KB,72300,Norway,Europe,58,449,283.5668306,2630.233467,92.06521739,242153.0159,67,60,56,7,4,26,2,male
77 ms,77,70100 KB,70100,China,Asia,84,468,453.092115,2991.604554,51.36363636,153659.6884,51,39,37,12,2,28,3,male
109 ms,109,75500 KB,75500,India,Asia,68,573,346.1173001,3488.116208,88.44444444,308504.5002,53,47,45,6,2,30,2,male
124 ms,124,107100 KB,107100,India,Asia,68,438,346.3298602,2666.308724,56.09677419,149571.3184,88,69,62,19,7,31,4,male
46 ms,46,3900 KB,3900,Iran,Asia,72,378,372.5956925,2332.231651,33.09090909,77175.66553,78,54,46,24,8,15,2,female
61 ms,61,55700 KB,55700,China,Asia,79,545,419.2271063,3435.560508,47.13095238,161921.2387,72,62,61,10,1,36,3,male
77 ms,77,46400 KB,46400,Bangladesh,Asia,78,476,412.85429,2991.851456,53.31395349,159507.4294,72,55,49,17,6,25,3,male
77 ms,77,68800 KB,68800,Georgia,AsiaEurope,62,431,308.8461793,2566.25861,41.44,106345.7568,62,54,52,8,2,34,2,male
108 ms,108,68500 KB,68500,Russia,AsiaEurope,72,556,372.5956925,3430.478301,73.27272727,251360.5009,74,66,66,8,0,35,2,male
62 ms,62,71000 KB,71000,China,Asia,79,478,419.0808777,3013.207198,39.3902439,118690.9664,64,50,50,14,0,21,3,male
77 ms,77,36300 KB,36300,China,Asia,99,535,561.9099458,3546.705792,54.90322581,194725.589,52,37,33,15,4,24,3,male
202 ms,202,37800 KB,37800,Iran,Asia,75,520,392.9423377,3238.985719,64.42857143,208683.2228,80,57,42,23,15,32,3,male
46 ms,46,35900 KB,35900,Russia,AsiaEurope,76,558,398.9944238,3486.343553,73.8,257292.1542,62,51,51,11,0,29,2,male
31 ms,31,13700 KB,13700,China,Asia,77,541,405.551932,3390.331519,47.74358974,161866.5971,56,43,43,13,0,24,1,female
46 ms,46,13700 KB,13700,China,Asia,77,541,405.551932,3390.331519,47.74358974,161866.5971,56,43,43,13,0,24,1,female
46 ms,46,8700 KB,8700,Jordan,Asia,89,592,487.9979062,3833.634191,50.6122449,194028.8325,55,43,38,12,5,28,4,male
46 ms,46,5300 KB,5300,Poland,Europe,63,258,314.4992626,1542.13822,34,52432.69949,65,44,31,21,13,18,1,male
61 ms,61,36900 KB,36900,Romania,Europe,78,469,414.08385,2947.853641,34.43478261,101508.6993,55,43,38,12,5,32,2,male
46 ms,46,3700 KB,3700,Denmark,Europe,65,450,326.4650059,2710.065516,55.75757576,151106.6833,85,66,53,19,13,22,2,male
156 ms,156,7600 KB,7600,Georgia,AsiaEurope,55,402,263.3031226,2324.106605,63.6,147813.1801,60,53,50,7,3,27,1,female
93 ms,93,38800 KB,38800,China,Asia,86,544,467.1963626,3495.888027,60.15957447,210311.1361,67,44,41,23,3,29,5,male
61 ms,61,35900 KB,35900,South Korea,Asia,75,541,392.4020294,3369.790912,33.6875,113519.8313,70,46,33,24,13,30,2,male
109 ms,109,83600 KB,83600,Vietnam,Asia,59,427,288.6764386,2511.888582,74.88461538,188101.8104,61,51,47,10,4,27,2,male
124 ms,124,99900 KB,99900,United States,North America,65,454,327.3557123,2734.154987,86.55357143,236650.879,67,58,54,9,4,28,2,male
46 ms,46,4600 KB,4600,Hungary,Europe,75,558,392.4020294,3475.680829,83.125,288915.9689,48,38,36,10,2,29,1,male
46 ms,46,4700 KB,4700,Kazakhstan,AsiaEurope,72,504,372.2346001,3109.642201,91.5,284532.2614,74,54,40,20,14,25,5,male
124 ms,124,100000 KB,100000,Brazil,South America,81,485,433.6087556,3074.827251,42.98913043,132184.1498,64,47,37,17,10,25,2,male
108 ms,108,103700 KB,103700,Finland,Europe,63,489,314.4992626,2922.889883,87.33333333,255265.7164,68,59,59,9,0,28,3,female
77 ms,77,37800 KB,37800,Iran,Asia,80,446,425.7542476,2819.57993,56.5,159306.2661,53,39,37,14,2,19,3,male
140 ms,140,4800 KB,4800,Croatia,Europe,61,495,301.3556992,2935.714982,54.77777778,160811.9429,72,65,64,7,1,26,1,male
77 ms,77,42900 KB,42900,Iran,Asia,83,526,446.8336245,3353.270741,67.56521739,226564.4666,61,57,57,4,0,35,4,male
187 ms,187,149600 KB,149600,China,Asia,75,555,392.17102,3456.994373,35.53947368,122859.7606,58,37,37,21,0,24,2,female
170 ms,170,149600 KB,149600,China,Asia,75,555,392.17102,3456.994373,35.53947368,122859.7606,58,37,37,21,0,24,2,male
46 ms,46,5800 KB,5800,South Korea,Asia,84,554,454.1955001,3541.343852,56.625,200528.5956,80,54,37,26,17,26,1,male
46 ms,46,5800 KB,5800,India,Asia,84,554,454.1955001,3541.343852,56.625,200528.5956,80,54,37,26,17,26,1,female
46 ms,46,2300 KB,2300,India,Asia,84,554,454.1955001,3541.343852,56.625,200528.5956,80,54,37,26,17,26,1,male
124 ms,124,90500 KB,90500,China,Asia,48,394,227.6306219,2200.475225,24.23076923,53319.20738,93,76,76,17,0,28,2,male
77 ms,77,73900 KB,73900,China,Asia,65,622,326.7316235,3745.91278,77,288435.284,69,64,64,5,0,44,3,male
93 ms,93,83800 KB,83800,Egypt,AsiaAfrica,59,384,289.5640056,2258.934931,64.89583333,146595.4648,72,58,50,14,8,26,2,female
62 ms,62,12000 KB,12000,Iran,Asia,66,462,333.3240179,2792.510083,72,201060.726,59,42,35,17,7,23,1,male
46 ms,46,5600 KB,5600,India,Asia,52,321,249.0117739,1829.84115,23.67647059,43324.18016,63,43,40,20,3,18,1,male
187 ms,187,101000 KB,101000,Taiwan,Asia,76,579,399.1845378,3617.55003,81.09756098,293374.4842,69,62,61,7,1,32,2,male
140 ms,140,55900 KB,55900,Turkmenistan,Asia,78,590,414.08385,3708.387309,50.7826087,188321.5816,60,43,40,17,3,22,3,male
108 ms,108,83700 KB,83700,India,Asia,42,389,194.994331,2097.611477,45.83333333,96140.52605,84,72,72,12,0,21,2,male
92 ms,92,71100 KB,71100,China,Asia,69,441,352.582306,2693.859285,53.45454545,143999.0236,57,51,51,6,0,32,2,male
124 ms,124,52600 KB,52600,Iran,Asia,73,501,378.8670746,3101.102104,70.05405405,217244.7744,77,62,57,15,5,27,2,male
248 ms,248,69100 KB,69100,India,Asia,58,434,281.9620482,2542.363752,45.35185185,115300.9042,88,75,70,13,5,24,2,male
77 ms,77,55400 KB,55400,China,Asia,89,558,488.714938,3613.459254,67.80392157,245006.7079,56,44,41,12,3,29,2,male
77 ms,77,53700 KB,53700,China,Asia,83,578,446.8336245,3684.772791,63.14130435,232661.3603,73,65,65,8,0,31,3,male
61 ms,61,62500 KB,62500,China,Asia,68,396,345.9474732,2410.635285,26.5,63881.83506,68,56,55,12,1,24,2,female
77 ms,77,36900 KB,36900,India,Asia,81,485,433.6087556,3074.827251,42.98913043,132184.1498,64,47,37,17,10,25,2,female
62 ms,62,36400 KB,36400,Czechia,Europe,70,479,359.4212455,2935.926565,61.05263158,179246.0429,92,75,68,17,7,27,2,male
93 ms,93,67100 KB,67100,Bangladesh,Asia,62,486,307.1601712,2893.739407,59.5,172177.4947,65,56,52,9,4,33,2,male
92 ms,92,52400 KB,52400,India,Asia,44,397,212.401259,2167.394353,26.42857143,57281.13646,94,81,81,13,0,30,3,male
62 ms,62,17100 KB,17100,China,Asia,82,516,439.8831639,3280.496834,35.35555556,115983.7881,66,42,42,24,0,19,2,female
61 ms,61,23700 KB,23700,Russia,AsiaEurope,61,385,302.2137048,2283.333875,61.92,141384.0335,102,85,79,17,6,25,2,male
77 ms,77,68000 KB,68000,India,Asia,62,458,308.3287327,2727.02191,31.84615385,86845.15929,86,72,61,14,11,28,3,male
249 ms,249,116000 KB,116000,India,Asia,42,440,207.4212455,2372.619666,19,45079.77365,97,82,79,15,3,39,2,male
109 ms,109,53400 KB,53400,Bangladesh,Asia,78,471,413.1887278,2960.424445,52.15909091,154413.0478,69,45,29,24,16,29,4,male
186 ms,186,84700 KB,84700,South Korea,Asia,58,523,281.8126557,3063.72406,69.64285714,213366.4971,43,32,31,11,1,21,2,male
77 ms,77,67100 KB,67100,China,Asia,92,503,508.6701412,3281.351664,65.94,216372.3287,67,55,54,12,1,23,1,male
92 ms,92,67100 KB,67100,China,Asia,92,503,508.6701412,3281.351664,65.94,216372.3287,67,55,54,12,1,23,1,male
171 ms,171,8800 KB,8800,China,Asia,68,467,345.9899115,2842.845147,39.24242424,111560.1353,64,56,55,8,1,32,2,male
62 ms,62,36800 KB,36800,Finland,Europe,52,483,245.8187515,2753.312384,92.26190476,254025.8449,91,70,64,21,6,28,2,male
77 ms,77,75100 KB,75100,South Korea,Asia,51,428,239.4453837,2427.798046,26.42857143,64163.23408,72,66,66,6,0,29,2,male
46 ms,46,9200 KB,9200,China,Asia,81,574,432.75063,3639.073902,48.1627907,175267.9547,85,77,77,8,0,29,3,female
93 ms,93,65000 KB,65000,South Korea,Asia,71,523,365.6422056,3216.317744,67.56944444,217324.8031,74,58,56,16,2,25,2,male
77 ms,77,51500 KB,51500,Croatia,Europe,80,483,425.7903187,3053.49127,69.91463415,213483.725,90,66,53,24,13,26,9,male
77 ms,77,52900 KB,52900,Germany,Europe,78,544,412.2613731,3419.258807,81,276959.9634,63,50,44,13,6,24,3,male
46 ms,46,8800 KB,8800,China,Asia,92,625,509.2999891,4077.226223,48.46153846,197588.6554,69,55,55,14,0,34,3,male
77 ms,77,65200 KB,65200,Bangladesh,Asia,70,536,359.2147805,3285.295697,95.3030303,313098.6354,80,71,68,9,3,32,3,female
202 ms,202,68100 KB,68100,India,Asia,56,490,273.4603973,2845.603912,44.78947368,127453.1015,94,85,81,9,4,46,2,male
233 ms,233,50700 KB,50700,Vietnam,Asia,81,509,433.2506894,3226.983651,53.6,172966.3237,57,47,43,10,4,26,3,male
92 ms,92,68000 KB,68000,India,Asia,62,447,310.1726115,2661.525751,76.30434783,203085.9866,89,60,37,29,23,34,3,male
93 ms,93,53500 KB,53500,Russia,AsiaEurope,94,487,522.9001971,3192.084771,56.94230769,181764.6732,81,45,23,36,22,27,4,male
218 ms,218,11700 KB,11700,Georgia,AsiaEurope,60,483,295.1851693,2853.028158,56.23076923,160427.9679,88,83,83,5,0,33,4,male
62 ms,62,52700 KB,52700,China,Asia,73,623,379.3421297,3856.2607,55.275,213154.8102,77,65,63,12,2,40,3,male
93 ms,93,67100 KB,67100,India,Asia,66,494,333.3240179,2985.930695,75.6,225736.3605,88,62,54,26,8,27,2,male
61 ms,61,36900 KB,36900,Unknown,Unknown,73,623,379.3421297,3856.2607,55.275,213154.8102,77,65,63,12,2,40,3,male
46 ms,46,54800 KB,54800,India,Asia,81,586,432.6080183,3715.152102,59.42857143,220786.182,97,85,85,12,0,34,3,female
77 ms,77,81800 KB,81800,India,Asia,56,420,271.7635715,2439.089067,106.6666667,260169.5005,66,55,51,11,4,26,2,male
108 ms,108,85000 KB,85000,Russia,AsiaEurope,67,503,339.6973857,3051.242863,54,164767.1146,79,65,60,14,5,33,2,male
156 ms,156,104000 KB,104000,Finland,Europe,64,554,320.7232379,3324,86.78571429,288475.7143,67,63,61,4,2,28,1,male
62 ms,62,44800 KB,44800,Syria,Asia,54,395,257.6220106,2273.180563,47.17391304,107234.8222,78,67,67,11,0,28,3,male
62 ms,62,32200 KB,32200,China,Asia,87,462,474.942584,2976.639895,39.22,116743.8167,81,56,49,25,7,23,3,female
61 ms,61,36900 KB,36900,Russia,AsiaEurope,68,390,345.9474732,2374.110508,32,75971.53626,74,67,67,7,0,20,2,male
46 ms,46,8200 KB,8200,Mexico,North America,76,489,398.9944238,3055.236554,39.15,119612.5111,93,54,35,39,19,16,4,male
77 ms,77,69100 KB,69100,Australia,Australia,64,455,320.7232379,2730,71.35714286,194805,66,53,48,13,5,33,2,male
93 ms,93,9200 KB,9200,Brazil,South America,91,583,502.1708162,3794.044275,65.88235294,249960.564,79,61,51,18,10,28,4,male
109 ms,109,81900 KB,81900,India,Asia,83,568,446.8336245,3621.022397,56.30434783,203879.3045,105,80,65,25,15,27,3,male
93 ms,93,67700 KB,67700,India,Asia,66,489,333.3240179,2955.708724,83.4,246506.1076,61,51,45,10,6,35,4,male
77 ms,77,52500 KB,52500,Bangladesh,Asia,73,534,378.8670746,3305.366314,41.625,137585.8728,101,77,65,24,12,35,3,male
46 ms,46,5500 KB,5500,Egypt,AsiaAfrica,58,414,284.2247957,2425.204132,72.81818182,176598.9554,57,49,47,8,2,22,1,male
686 ms,686,102100 KB,102100,Finland,Europe,62,590,307.9068682,3512.975823,70,245908.3076,90,62,48,28,14,40,2,male
77 ms,77,69100 KB,69100,India,Asia,71,504,365.7235111,3099.472548,73.45588235,227674.4909,78,54,45,24,9,31,3,male
124 ms,124,87900 KB,87900,Sweden,Europe,82,534,439.460071,3394.93277,47.1627907,160114.5037,72,54,45,18,9,23,2,male
202 ms,202,7800 KB,7800,Jordan,Asia,58,552,283.0128366,3233.605509,80.04166667,258823.1743,76,61,51,15,10,34,2,male
265 ms,265,71300 KB,71300,China,Asia,69,576,353.3374044,3518.510087,37.7,132647.8303,83,69,69,14,0,28,4,female
62 ms,62,68300 KB,68300,China,Asia,76,513,399.1845378,3205.186814,38.41463415,123126.0788,57,51,51,6,0,40,3,male
155 ms,155,146100 KB,146100,India,Asia,0,0,0,0,0,0,63,52,47,11,5,36,3,female
62 ms,62,39900 KB,39900,South Korea,Asia,83,556,447.1829761,3544.521924,54.76595745,194119.1368,84,64,57,20,7,32,3,female
61 ms,61,36900 KB,36900,Croatia,Europe,89,571,489.1726399,3697.643789,64.39423077,238106.9275,78,49,34,29,15,26,2,male
109 ms,109,100600 KB,100600,Reunion,Africa,72,501,372.3949821,3091.132426,68.17647059,210742.4989,101,75,60,26,15,30,4,male
61 ms,61,39800 KB,39800,South Korea,Asia,75,464,392.9423377,2890.171872,43.60714286,126032.1377,67,57,55,10,2,28,3,male
436 ms,436,68500 KB,68500,India,Asia,71,395,365.6422056,2429.150112,42.68571429,103690.0076,51,46,44,5,2,25,3,male
155 ms,155,7900 KB,7900,Ukraine,Europe,73,603,378.8670746,3732.464209,91.45945946,341369.159,68,51,48,17,3,30,1,male
249 ms,249,68100 KB,68100,India,Asia,62,529,307.2067179,3149.769848,58.66666667,184786.4978,89,81,81,8,0,36,2,male
78 ms,78,39800 KB,39800,Bangladesh,Asia,85,583,464.3440107,3736.674916,68.31481481,255270.2549,81,57,41,24,16,29,4,male
124 ms,124,99200 KB,99200,India,Asia,44,487,214.9310205,2658.743198,19,50516.12077,86,80,80,6,0,41,3,male
234 ms,234,12800 KB,12800,China,Asia,81,549,432.75063,3480.577652,45.06976744,156868.8253,89,73,72,16,1,34,3,male
156 ms,156,5600 KB,5600,India,Asia,80,497,426.079159,3141.998263,60.43243243,189878.5977,72,65,65,7,0,33,3,male
265 ms,265,15500 KB,15500,China,Asia,69,614,352.4986422,3750.634016,70,262544.3812,87,81,81,6,0,40,3,female
77 ms,77,71300 KB,71300,Finland,Europe,56,588,271.0812322,3414.724694,131.3636364,448570.653,92,76,67,16,9,37,2,male
249 ms,249,84600 KB,84600,China,Asia,64,567,320.7232379,3402,75.85714286,258066,70,63,62,7,1,42,2,male
592 ms,592,83900 KB,83900,China,Asia,78,643,413.5983953,4041.513627,49.86666667,201536.8129,94,85,84,9,1,33,2,male
109 ms,109,98900 KB,98900,China,Asia,85,632,460.8279746,4050.735072,59.35416667,240428.0046,83,63,59,20,4,36,2,female
452 ms,452,83900 KB,83900,China,Asia,78,643,413.5983953,4041.513627,49.86666667,201536.8129,94,85,84,9,1,33,2,male
93 ms,93,68000 KB,68000,Austria,Europe,70,562,359.4212455,3444.657056,70.0625,241341.285,101,85,76,16,9,39,5,male
233 ms,233,68000 KB,68000,Armenia,Europe,55,454,263.6191856,2624.73731,62,162733.7132,109,74,64,35,10,25,2,male
109 ms,109,68100 KB,68100,Ukraine,Europe,63,475,314.9612072,2839.207964,67.59615385,191919.5383,79,58,49,21,9,29,3,male
265 ms,265,107400 KB,107400,Ukraine,Europe,59,496,290.159225,2917.790952,86.08695652,251183.7429,87,66,56,21,10,27,2,male
77 ms,77,68100 KB,68100,India,Asia,46,423,217.5786534,2336.466707,27.04545455,63190.80413,100,81,72,19,9,22,2,male
187 ms,187,106700 KB,106700,India,Asia,67,462,339.5249056,2802.533206,52.5,147132.9933,66,54,49,12,5,36,2,male
61 ms,61,47300 KB,47300,Aruba,South Africa,68,593,346.1173001,3609.865465,43.3125,156352.2979,84,73,73,11,0,32,4,female
46 ms,46,5500 KB,5500,Japan,Asia,73,469,378.8670746,2903.027718,51.56756757,149702.078,77,63,60,14,3,19,4,male
233 ms,233,61200 KB,61200,India,Asia,71,484,365.6422056,2976.477606,59.14285714,176037.3898,65,47,36,18,11,32,2,male
46 ms,46,9700 KB,9700,China,Asia,78,597,412.5946318,3752.385125,39,146343.0199,91,80,80,11,0,34,2,female
77 ms,77,48800 KB,48800,Philippines,Asia,75,642,392.2479866,3998.901599,76.375,305416.1096,84,78,78,6,0,39,2,male
93 ms,93,60700 KB,60700,United States,North America,77,540,406.0022373,3384.064732,67.5,228424.3694,76,53,49,23,4,29,2,male
217 ms,217,33200 KB,33200,Romania,Europe,72,517,372.5956925,3189.851226,71.07692308,226724.8102,84,69,62,15,7,33,3,male
77 ms,77,64600 KB,64600,India,Asia,68,530,346.6279634,3226.355306,49.4,159381.9521,108,80,68,28,12,39,4,male
77 ms,77,55500 KB,55500,Russia,AsiaEurope,80,425,425.8985773,2686.81944,52.47619048,140994.0487,79,57,45,22,12,24,2,male
93 ms,93,52500 KB,52500,Iran,Asia,68,633,346.1173001,3853.363979,82.22222222,316832.1493,91,80,78,11,2,36,2,male
77 ms,77,74900 KB,74900,China,Asia,81,631,433.2506894,4000.445352,56.8,227225.296,86,73,73,13,0,41,4,male
62 ms,62,5800 KB,5800,Switzerland,Europe,84,604,453.8154506,3860.959723,83.05319149,320665.0272,71,59,55,12,4,31,3,male
264 ms,264,67100 KB,67100,Latvia,Europe,52,397,244.6450378,2263.074568,35.58333333,80527.73671,78,74,73,4,1,31,2,male
187 ms,187,36900 KB,36900,Taiwan,Asia,88,538,480.9553238,3475.174211,50,173758.7105,75,64,63,11,1,37,2,male
78 ms,78,37800 KB,37800,South Korea,Asia,77,556,405.551932,3484.333317,79.41025641,276691.8021,95,68,51,27,17,33,3,male
77 ms,77,83800 KB,83800,China,Asia,65,601,326.4650059,3619.443056,58.78125,212755.3871,102,95,94,7,1,35,2,male
77 ms,77,50900 KB,50900,Mexico,North America,79,491,419.0078103,3095.156347,51.79487179,160313.2262,83,60,57,23,3,24,2,male
61 ms,61,4600 KB,4600,Russia,AsiaEurope,66,502,334.5126491,3034.285848,101.1111111,306800.0135,94,62,52,32,10,23,5,male
46 ms,46,1900 KB,1900,India,Asia,50,453,236.9737366,2556.666854,57.375,146688.7607,119,110,106,9,4,36,1,male
109 ms,109,83700 KB,83700,Iran,Asia,86,697,469.3966019,4479.106534,84.67307692,379259.7321,79,45,22,34,23,37,3,male
62 ms,62,29000 KB,29000,China,Asia,79,615,419.2271063,3876.82516,50.6547619,196379.6554,93,88,88,5,0,42,5,female
46 ms,46,29000 KB,29000,China,Asia,79,615,419.2271063,3876.82516,50.6547619,196379.6554,93,88,88,5,0,42,5,female
93 ms,93,99000 KB,99000,China,Asia,89,653,487.7378322,4228.65393,65.77083333,278122.0929,85,64,60,21,4,40,2,female
92 ms,92,40800 KB,40800,Romania,Europe,75,533,392.2479866,3319.960362,57.69230769,191536.1747,95,78,72,17,6,35,3,female
61 ms,61,52800 KB,52800,China,Asia,87,721,473.9427998,4645.362261,71.91489362,334070.7328,77,63,61,14,2,32,2,female
1699 ms,1699,4700 KB,4700,China,Asia,48,492,222.2653679,2747.80155,44.16666667,121361.2351,123,115,113,8,2,37,1,female
92 ms,92,58500 KB,58500,Vietnam,Asia,70,487,359.0498112,2984.960829,70,208947.258,71,49,36,22,13,29,2,female
92 ms,92,74000 KB,74000,Serbia,Europe,68,499,346.1173001,3037.643958,70.875,215293.0155,76,63,58,13,5,25,2,female
62 ms,62,55500 KB,55500,China,Asia,71,605,365.7235111,3720.597007,82.16176471,305690.8159,84,68,68,16,0,32,2,female
46 ms,46,40000 KB,40000,China,Asia,80,626,425.7542476,3957.526987,71,280984.4161,97,90,90,7,0,40,3,female
61 ms,61,36900 KB,36900,China,Asia,68,559,347.0121354,3402.891728,32.27586207,109831.2641,107,92,90,15,2,39,3,female
93 ms,93,75000 KB,75000,India,Asia,60,533,295.6213103,3148.372687,32.9,103581.4614,89,56,46,33,10,26,2,female
61 ms,61,56700 KB,56700,China,Asia,74,586,385.5385456,3638.739672,61.22222222,222771.7288,93,80,79,13,1,34,2,female
46 ms,46,37300 KB,37300,Russia,AsiaEurope,67,416,339.4387425,2523.493103,27.81818182,70198.98996,87,67,60,20,7,27,2,female
46 ms,46,4600 KB,4600,Lithuania,Europe,59,424,288.6764386,2494.240653,86.94230769,216855.0383,79,63,51,16,12,36,1,female
93 ms,93,71100 KB,71100,India,Asia,0,0,0,0,0,0,91,54,45,37,9,15,2,female
93 ms,93,80400 KB,80400,India,Asia,85,574,460.2145365,3678.990397,66.97826087,246412.3786,101,85,83,16,2,31,4,female
92 ms,92,36800 KB,36800,Finland,Europe,84,525,454.1955001,3355.966647,64.875,217718.3362,75,52,42,23,10,26,2,female
108 ms,108,82300 KB,82300,Germany,Europe,64,483,320.7232379,2898,55.92857143,162081,79,68,62,11,6,36,2,female
77 ms,77,59400 KB,59400,China,Asia,76,680,399.1845378,4248.590709,83.23170732,353617.4584,89,79,79,10,0,40,2,female
62 ms,62,18000 KB,18000,China,Asia,91,610,501.2172393,3969.754731,76.79347826,304851.2736,84,65,58,19,7,33,6,female
171 ms,171,5600 KB,5600,India,Asia,62,393,307.3464548,2339.99915,25.03448276,58580.66838,108,67,43,41,24,20,1,female
109 ms,109,102200 KB,102200,India,Asia,55,597,265.9634675,3451.471749,54.25,187242.3424,100,75,69,25,6,43,2,female
46 ms,46,6600 KB,6600,Croatia,Europe,73,533,379.1044231,3299.17649,69.97058824,230845.3197,85,56,40,29,16,30,2,female
155 ms,155,98300 KB,98300,India,Asia,73,732,378.8670746,4530.951577,104.8333333,474994.757,81,70,65,11,5,39,3,female
77 ms,77,68200 KB,68200,China,Asia,69,696,352.7497745,4251.533022,111,471920.1654,125,98,91,27,7,38,2,female
46 ms,46,37000 KB,37000,China,Asia,80,582,427.0575866,3679.362151,55.43478261,203964.641,87,72,66,15,6,32,3,female
77 ms,77,68100 KB,68100,Vietnam,Asia,80,644,425.7542476,4071.321693,58,236136.6582,70,48,47,22,1,38,2,female
92 ms,92,68100 KB,68100,Vietnam,Asia,80,644,425.7542476,4071.321693,58,236136.6582,70,48,47,22,1,38,2,female
187 ms,187,38000 KB,38000,Romania,Europe,72,492,372.5956925,3035.603101,26.65384615,80910.49803,90,84,84,6,0,30,2,female
77 ms,77,68300 KB,68300,China,Asia,67,597,340.7366244,3621.455247,45.96428571,166457.6037,74,59,53,15,6,44,3,female
249 ms,249,67700 KB,67700,Philippines,Asia,76,688,398.8804611,4298.574129,92.02564103,395579.0397,113,95,88,18,7,37,5,female
92 ms,92,69100 KB,69100,China,Asia,68,676,346.3298602,4115.124881,122.3387097,503439.0681,113,96,91,17,5,45,3,female
187 ms,187,40800 KB,40800,Bangladesh,Asia,72,437,372.2346001,2696.257226,45,121331.5752,100,80,71,20,9,30,2,female
46 ms,46,5800 KB,5800,China,Asia,80,526,426.3322913,3325.334178,42.95454545,142838.2181,95,70,70,25,0,28,2,female
249 ms,249,69100 KB,69100,China,Asia,90,664,494.5555318,4310.590456,61.25,264023.6654,93,66,66,27,0,38,4,female
46 ms,46,18000 KB,18000,Ukraine,Europe,67,569,339.4387425,3451.604749,41.25,142378.6959,85,70,66,15,4,34,1,female
77 ms,77,21600 KB,21600,Cuba,North America,70,698,359.4212455,4278.239546,97.375,416593.5758,132,82,44,50,38,34,5,female
77 ms,77,67700 KB,67700,Singapore,Asia,58,610,290.4773318,3573.368407,56.4375,201671.9795,103,52,26,51,26,28,7,female
280 ms,280,84600 KB,84600,India,Asia,82,779,439.6362367,4952.533012,88.09090909,436273.1353,124,97,75,27,22,50,2,female
46 ms,46,11700 KB,11700,China,Asia,89,637,488.323496,4125.042196,68.25,281534.1298,96,82,75,14,7,30,5,female
62 ms,62,38800 KB,38800,China,Asia,83,584,446.5546348,3723.023028,79.37777778,295525.2946,88,77,76,11,1,32,3,female
171 ms,171,4600 KB,4600,China,Asia,71,557,365.7235111,3425.409146,66.92647059,229250.5444,112,84,76,28,8,26,2,female
62 ms,62,4600 KB,4600,Ukraine,Europe,66,699,334.0271833,4225.031489,105.1785714,444382.7763,98,79,76,19,3,50,1,female
202 ms,202,107200 KB,107200,China,Asia,97,714,543.5562547,4712.337769,65.76923077,309926.8302,107,65,52,42,13,45,6,female
264 ms,264,72000 KB,72000,Egypt,AsiaAfrica,76,676,398.8804611,4223.598999,74.94871795,316553.3301,71,53,50,18,3,33,2,female
46 ms,46,5600 KB,5600,Bangladesh,Asia,75,537,392.17102,3344.875637,33.10526316,110732.9882,105,71,59,34,12,29,2,female
218 ms,218,8800 KB,8800,India,Asia,56,651,269.6764904,3780.588054,75.64,285963.6804,87,68,52,19,16,34,1,female
264 ms,264,130600 KB,130600,India,Asia,45,625,209.4845559,3432.408185,111.375,382284.4616,162,126,105,36,21,44,2,female
156 ms,156,5800 KB,5800,China,Asia,82,688,440.5905816,4373.995779,70,306179.7045,85,76,76,9,0,31,2,female
124 ms,124,102900 KB,102900,Russia,AsiaEurope,73,498,378.8670746,3082.53263,51.08108108,157459.0992,106,58,50,48,8,19,3,female
108 ms,108,72000 KB,72000,Unknown,Unknown,62,667,307.5796744,3971.448939,51,202543.8959,105,77,67,28,10,35,2,female
93 ms,93,72000 KB,72000,Russia,AsiaEurope,59,603,289.0701413,3547.233759,110.16,390763.2709,113,79,57,34,22,39,4,female
62 ms,62,10300 KB,10300,Japan,Asia,86,641,466.9609738,4119.235708,63.91304348,263272.8909,110,75,68,35,7,29,1,female
62 ms,62,42100 KB,42100,Vietnam,Asia,81,700,432.536756,4437.895002,49.26829268,218647.5099,82,59,54,23,5,30,2,female
124 ms,124,115000 KB,115000,Poland,Europe,71,533,365.6422056,3277.815215,52.97142857,173630.5545,112,84,77,28,7,37,2,female
61 ms,61,40400 KB,40400,China,Asia,79,627,419.4466845,3952.470529,67.81395349,268032.6526,96,86,83,10,3,36,2,female
77 ms,77,68200 KB,68200,Ukraine,Europe,83,533,446.2065082,3397.896017,52.1375,177157.8036,87,75,69,12,6,32,4,female
249 ms,249,82000 KB,82000,India,Asia,62,692,309.4603455,4120.303847,50.66666667,208762.0616,131,105,96,26,9,45,4,female
62 ms,62,37900 KB,37900,Russia,AsiaEurope,95,746,530.851908,4901.112284,84.36363636,413475.6545,105,83,76,22,7,36,4,female
140 ms,140,102900 KB,102900,China,Asia,93,784,516.0824975,5126.700508,66.23076923,339545.3183,108,76,76,32,0,33,4,female
46 ms,46,5800 KB,5800,Bangladesh,Asia,74,531,385.6555921,3297.219737,30.08571429,99199.21095,137,105,85,32,20,36,2,female
140 ms,140,53600 KB,53600,Bangladesh,Asia,74,654,385.6555921,4060.982501,43.97435897,178579.1023,121,82,72,39,10,29,3,female
46 ms,46,8100 KB,8100,Russia,AsiaEurope,85,632,460.8279746,4050.735072,46.63541667,188907.7179,126,110,104,16,6,32,2,female
171 ms,171,7800 KB,7800,Russia,AsiaEurope,62,719,308.3287327,4281.067147,114.2307692,489029.5933,151,142,140,9,2,44,1,female
46 ms,46,5800 KB,5800,China,Asia,78,808,412.5946318,5078.604993,83.57142857,424426.2744,133,100,91,33,9,43,3,female
108 ms,108,68100 KB,68100,Vietnam,Asia,93,815,515.5221939,5329.414431,65.36,348330.5272,122,89,89,33,0,43,6,female
61 ms,61,68600 KB,68600,China,Asia,107,837,614.8836801,5642.607868,71.81034483,405197.6167,126,93,85,33,8,47,5,female
93 ms,93,8700 KB,8700,China,Asia,120,981,711.7528278,6775.659674,109.0422535,738833.2,104,80,72,24,8,49,5,female
139 ms,139,119700 KB,119700,South Korea,Asia,71,588,370.1802547,3616.051306,55.2,199606.0321,100,75,69,25,6,32,3,female
342 ms,342,180400 KB,180400,Russia,AsiaEurope,44,615,210.1173001,3357.550445,72,241743.6321,93,78,73,15,5,57,3,female
93 ms,93,55500 KB,55500,Russia,AsiaEurope,86,639,467.8705569,4106.383178,51.34693878,210850.2056,118,74,64,44,10,25,2,female
77 ms,77,61000 KB,61000,Mexico,North America,103,867,587.2909311,5797.195957,54.44067797,315603.2782,137,91,75,46,16,40,11,female
436 ms,436,132600 KB,132600,Russia,AsiaEurope,60,830,297.5287411,4902.719194,123.5,605485.8205,120,106,106,14,0,51,2,female
61 ms,61,6200 KB,6200,China,Asia,74,582,385.4995491,3613.901859,71,256587.032,83,76,76,7,0,33,1,female
78 ms,78,5800 KB,5800,China,Asia,74,582,385.4995491,3613.901859,71,256587.032,83,76,76,7,0,33,1,female
233 ms,233,68100 KB,68100,India,Asia,65,612,327.3557123,3685.689102,59.46428571,219166.8698,138,130,128,8,2,44,2,female
202 ms,202,52800 KB,52800,Unknown,Unknown,78,592,412.4094067,3720.958114,59.56097561,221623.8954,118,100,88,18,12,41,3,female
109 ms,109,48700 KB,48700,Japan,Asia,33,90,140.0964047,453.9954707,15.625,7093.67923,103,76,68,27,8,25,4,female
93 ms,93,69100 KB,69100,Russia,AsiaEurope,68,597,345.9899115,3634.215316,71.06060606,258249.5429,118,77,77,41,0,31,2,female
46 ms,46,37800 KB,37800,Bangladesh,Asia,79,551,419.2271063,3473.383192,40.52380952,140754.7189,125,88,79,37,9,21,2,female
62 ms,62,18400 KB,18400,China,Asia,99,828,560.5441223,5489.107281,75.075,412094.7292,82,71,71,11,0,26,3,female
62 ms,62,18400 KB,18400,China,Asia,99,828,560.5441223,5489.107281,75.075,412094.7292,82,71,71,11,0,26,3,female
46 ms,46,5500 KB,5500,United States,North America,83,518,446.1369639,3302.270425,43.02439024,142078.1715,95,58,47,37,11,20,1,female
233 ms,233,4800 KB,4800,Unknown,Unknown,53,520,253.6843594,2978.518636,54.57894737,162564.4119,113,102,95,11,7,30,1,female
62 ms,62,13800 KB,13800,Poland,Europe,63,669,323.5707183,3998.800269,52.76470588,210995.5201,126,82,72,44,10,17,5,female
139 ms,139,114900 KB,114900,India,Asia,53,660,256.7497745,3780.4275,33.53125,126762.4596,119,74,63,45,11,40,2,female
139 ms,139,114900 KB,114900,India,Asia,53,660,256.7497745,3780.4275,33.53125,126762.4596,119,74,63,45,11,40,2,female
46 ms,46,5600 KB,5600,Iran,Asia,69,571,352.582306,3487.967465,68.72727273,239718.4912,118,81,67,37,14,26,2,female
62 ms,62,31300 KB,31300,Belarus,Europe,42,520,201.6270751,2804.00506,18,50472.09108,158,76,28,82,48,30,3,female
62 ms,62,21100 KB,21100,China,Asia,99,1007,557.6636341,6675.762116,60.75471698,405584.038,96,77,75,19,2,62,9,female
249 ms,249,67400 KB,67400,Ukraine,Europe,84,629,453.092115,4020.767659,48.63636364,195555.518,137,86,74,51,12,25,3,female
140 ms,140,121800 KB,121800,India,Asia,105,890,601.1597899,5975.678511,77.96610169,465900.3585,112,83,83,29,0,37,10,female
265 ms,265,83900 KB,83900,India,Asia,65,617,327.8032081,3715.800941,71.77777778,266711.9342,158,149,146,9,3,37,2,female
46 ms,46,4100 KB,4100,Germany,Europe,71,636,365.7235111,3911.239168,85.97058824,336251.532,117,99,90,18,9,39,3,female
61 ms,61,5900 KB,5900,India,Asia,33,147,134.0135917,741.5259355,21.03571429,15598.52772,86,66,64,20,2,40,1,female
77 ms,77,15400 KB,15400,India,Asia,0,0,0,0,0,0,187,154,145,33,9,50,4,female
46 ms,46,13500 KB,13500,China,Asia,92,691,508.9533246,4507.781312,42.20588235,190254.8877,158,119,109,39,10,30,3,female
77 ms,77,59400 KB,59400,India,Asia,92,680,508.2931913,4436.02213,50.41666667,223649.4491,141,72,41,69,31,30,5,female
109 ms,109,71100 KB,71100,Serbia,Europe,56,700,273.4603973,4065.148445,49.65789474,201866.7136,126,89,76,37,13,31,4,female
77 ms,77,36900 KB,36900,South Korea,Asia,90,756,496.8812252,4907.840941,78.33333333,384447.5404,115,44,37,71,7,21,4,female
108 ms,108,36100 KB,36100,India,Asia,100,881,565.8041153,5853.237303,77.3245614,452599.0073,133,112,107,21,5,52,8,female
108 ms,108,98900 KB,98900,Russia,AsiaEurope,72,721,372.3949821,4448.515926,79.91176471,355488.758,134,81,73,53,8,42,2,female
311 ms,311,101900 KB,101900,Russia,AsiaEurope,74,815,385.5385456,5060.704493,111.3611111,563565.6753,116,100,93,16,7,48,3,female
77 ms,77,88000 KB,88000,India,Asia,63,683,314.9612072,4082.482188,78.26923077,319532.7405,130,104,93,26,11,46,2,female
93 ms,93,53800 KB,53800,Ukraine,Europe,58,678,290.4773318,3971.711115,42,166811.8668,139,81,63,58,18,41,6,female
109 ms,109,83900 KB,83900,Russia,AsiaEurope,98,931,550.9789163,6158.294865,131.1851852,807877.0523,139,117,108,22,9,46,7,female
62 ms,62,8800 KB,8800,India,Asia,77,671,405.6268983,4205.013769,45.40540541,190930.3549,161,98,90,63,8,29,3,female
93 ms,93,70000 KB,70000,Bulgaria,Europe,80,970,426.3322913,6132.270252,157.0555556,963107.1113,195,151,120,44,31,52,6,female
171 ms,171,177100 KB,177100,India,Asia,53,661,260.9828401,3786.15542,36.92307692,139796.5078,145,119,110,26,9,31,3,female
62 ms,62,8800 KB,8800,China,Asia,122,1090,724.7113983,7554.503698,73.45588235,554922.7349,149,124,118,25,6,56,12,female
93 ms,93,9800 KB,9800,Russia,AsiaEurope,83,1016,446.1369639,6477.040062,94.20238095,610152.5954,186,145,133,41,12,53,2,female
62 ms,62,33200 KB,33200,India,Asia,104,820,594.628427,5494.360569,56.1,308233.6279,149,96,84,53,12,33,3,female
155 ms,155,58700 KB,58700,Singapore,Asia,112,1175,658.9207946,7998.642033,77.54054054,620219.0269,150,108,96,42,12,54,5,female
187 ms,187,15400 KB,15400,India,Asia,58,532,283.0128366,3116.445889,35.41666667,110374.1252,130,108,105,22,3,30,1,female
61 ms,61,6500 KB,6500,Taiwan,Asia,89,884,487.7378322,5724.548353,102.4390244,586417.1484,142,83,63,59,20,33,2,female
62 ms,62,22600 KB,22600,Unknown,Unknown,92,953,508.2931913,6216.954544,61.875,384674.0624,159,106,83,53,23,51,7,female
61 ms,61,12200 KB,12200,Japan,Asia,92,809,508.1677,5277.561622,68.5,361512.9711,163,113,90,50,23,43,10,female
108 ms,108,69200 KB,69200,United Kingdom,Europe,81,830,432.9647657,5262.075502,76.10810811,400486.6112,181,122,91,59,31,43,5,female
78 ms,78,59400 KB,59400,India,Asia,93,861,515.2115894,5630.215736,52.5,295586.3262,190,109,64,81,45,32,5,female
93 ms,93,69000 KB,69000,Bulgaria,Europe,83,1154,446.3456778,7356.795504,166.974359,1228396.213,224,177,143,47,34,68,6,female
124 ms,124,9100 KB,9100,Russia,AsiaEurope,105,857,603.0459669,5754.108409,75.33333333,433476.1668,145,89,83,56,6,42,9,female
234 ms,234,131700 KB,131700,Russia,AsiaEurope,93,1191,515.5221939,7788.138144,124.27,967831.9272,182,139,125,43,14,43,8,female
577 ms,577,99900 KB,99900,Unknown,Unknown,88,807,480.4299824,5212.761316,48,250212.5432,181,105,71,76,34,37,3,female
545 ms,545,99900 KB,99900,Unknown,Unknown,88,807,480.4299824,5212.761316,48,250212.5432,184,105,69,79,36,37,3,female
77 ms,77,59500 KB,59500,South Korea,Asia,121,1100,719.3553825,7610.749561,82.34722222,626724.0854,159,88,62,71,26,32,12,female
62 ms,62,8700 KB,8700,China,Asia,105,864,600.8285737,5801.108127,90.75862069,526500.5721,149,116,107,33,9,46,3,female
234 ms,234,12700 KB,12700,Bangladesh,Asia,62,800,308.3287327,4763.357048,42.23076923,201160.2323,190,130,111,60,19,42,2,female
46 ms,46,5700 KB,5700,South Korea,Asia,88,1077,480.5611817,6956.807853,94.73809524,659074.725,194,127,91,67,36,44,2,female
264 ms,264,119500 KB,119500,India,Asia,82,935,439.460071,5944.311124,44.89534884,266871.9215,172,133,130,39,3,42,3,female
77 ms,77,13800 KB,13800,Russia,AsiaEurope,82,985,439.3544556,6262.188725,83.475,522736.2038,194,149,144,45,5,56,4,female
109 ms,109,115000 KB,115000,India,Asia,74,731,388.0148382,4539.11041,60.51724138,274694.4403,218,154,140,64,14,40,6,female
311 ms,311,241100 KB,241100,India,Asia,0,0,0,0,0,0,186,128,113,58,15,30,5,female
124 ms,124,108500 KB,108500,India,Asia,105,1012,603.0459669,6794.816464,125.6666667,853881.9356,140,98,96,42,2,46,9,female
264 ms,264,66300 KB,66300,India,Asia,88,846,481.614055,5464.679149,51.97368421,284019.5084,184,127,117,57,10,38,5,female
405 ms,405,178400 KB,178400,Russia,AsiaEurope,95,1083,530.851908,7115.153624,98.90909091,703753.3766,170,99,74,71,25,61,3,female
421 ms,421,120200 KB,120200,India,Asia,139,1341,857.7236749,9546.499979,70.99431818,677747.257,281,170,122,111,48,39,8,female
78 ms,78,14700 KB,14700,India,Asia,98,1782,550.7131734,11787.41294,156.2264151,1841505.267,259,191,171,68,20,98,2,female
77 ms,77,42800 KB,42800,China,Asia,132,937,805.0328635,6600.59729,51.14285714,337573.4043,172,75,69,97,6,59,4,female
545 ms,545,142700 KB,142700,Russia,AsiaEurope,145,2131,902.2415629,15300.38627,163.7777778,2505863.263,263,193,183,70,10,92,22,female
62 ms,62,4800 KB,4800,South Korea,Asia,143,1642,881.7152809,11756.50873,98.33333333,1156056.692,233,130,88,103,42,61,35,female
77 ms,77,33000 KB,33000,India,Asia,113,1214,658.4538637,8279.69726,81.43548387,674261.1527,256,136,127,120,9,56,11,female
62 ms,62,12600 KB,12600,China,Asia,122,1298,728.2270778,8996.097064,205.5466667,1849117.765,255,200,196,55,4,68,16,female
62 ms,62,55800 KB,55800,China,Asia,6,14,15.509775,36.18947501,0,0,167,87,87,80,0,89,39,female
124 ms,124,17400 KB,17400,France,Europe,113,1962,658.1978429,13381.19112,97.18032787,1300388.541,278,144,82,134,62,101,35,female
62 ms,62,28300 KB,28300,India,Asia,131,1711,795.7206597,12034.18676,84.25925926,1013991.662,401,326,301,75,25,81,14,female
108 ms,108,68100 KB,68100,India,Asia,88,1527,483.7376617,9863.552082,55.58823529,548297.454,453,335,290,118,45,80,22,female
77 ms,77,55500 KB,55500,China,Asia,210,4356,1452.042082,33603.25347,161.9811321,5443093.039,523,265,197,258,68,221,148,female