time,memory,country,continent,program_vocabulary,program_length,calculated_estimated_program_length,volume,difficulty,effort,loc,slocP,lsloc,comments,blankLine,cyclomatic_complexity,numberOfFunction,gender
1029 ms,13200 KB,China,Asia,47,251,217.5800856,1394.201802,53.28125,74284.81475,36,32,32,4,0,12,3,male
811 ms,13400 KB,Iran,Asia,51,223,240.7106228,1264.950851,39.57894737,50065.42317,39,34,34,5,0,11,3,male
311 ms,14200 KB,Finland,Europe,52,249,244.9233738,1419.40949,30.89130435,43847.41054,32,26,26,6,0,10,3,male
810 ms,15300 KB,Poland,Europe,50,223,235.05865,1258.57993,41.77777778,52580.67264,39,34,34,5,0,11,3,male
764 ms,15300 KB,Latvia,Europe,51,225,240.7106228,1276.295702,41.26315789,52663.99107,38,33,33,5,0,11,3,male
779 ms,13400 KB,Egypt,AsiaAfrica,51,223,240.7106228,1264.950851,39.57894737,50065.42317,39,34,34,5,0,11,3,male
748 ms,19700 KB,France,Europe,53,233,252.9035678,1334.605466,39.6,52850.37645,41,36,36,5,0,11,3,male
748 ms,15500 KB,India,Asia,63,279,313.5800856,1667.661099,43.59375,72699.60102,40,28,24,12,4,11,3,male
779 ms,15300 KB,Iran,Asia,58,272,283.0128366,1593.370831,38.95833333,62075.07195,44,35,34,9,1,12,3,female
342 ms,19800 KB,Russia,AsiaEurope,59,280,288.6764386,1647.140054,41.25,67944.52722,39,32,32,7,0,13,3,male
265 ms,19700 KB,India,Asia,57,248,276.0964047,1446.556724,38.4,55547.77818,43,31,24,12,7,11,3,male
733 ms,15300 KB,India,Asia,58,283,281.9620482,1657.808622,37.88888889,62812.52666,32,28,28,4,0,11,3,male
264 ms,14900 KB,China,Asia,73,324,379.3421297,2005.503157,37.5375,75281.57476,31,25,22,6,3,14,3,male
280 ms,16100 KB,China,Asia,54,241,258.1074956,1386.927888,39.27272727,54468.44069,38,32,32,6,0,11,3,female
264 ms,14200 KB,India,Asia,53,276,252.2386659,1580.906045,53.33333333,84314.98909,44,36,33,8,3,11,3,male
295 ms,15500 KB,Bangladesh,Asia,58,313,281.8126557,1833.548051,43.92857143,80545.14655,49,36,29,13,7,12,3,male
311 ms,14100 KB,China,Asia,60,314,294.6059378,1854.763647,46.85714286,86908.92517,43,37,36,6,1,12,3,female
483 ms,14000 KB,Iran,Asia,58,288,282.5614107,1687.098527,50.82,85738.34712,51,41,37,10,4,11,3,male
296 ms,15300 KB,Iran,Asia,60,263,294.8469685,1553.512227,47.05555556,73101.38089,38,30,27,8,3,11,3,male
264 ms,14200 KB,Finland,Europe,60,294,296.1564001,1736.625835,43.5,75543.22383,50,38,35,12,3,11,3,male
249 ms,16900 KB,Taiwan,Asia,61,314,300.7868035,1862.251524,51.66666667,96216.32874,42,31,24,11,7,13,3,male
1014 ms,14000 KB,China,Asia,54,243,258.1074956,1398.437663,37.09090909,51869.32423,45,39,38,6,1,11,3,female
280 ms,16100 KB,Bangladesh,Asia,50,251,235.05865,1416.607904,27.55555556,39035.41779,37,33,33,4,0,11,3,male
717 ms,16100 KB,India,Asia,47,269,215.9400989,1494.184401,40.27777778,60182.42727,50,42,42,8,0,11,3,male
780 ms,14200 KB,India,Asia,55,260,263.6191856,1503.153526,38.75,58247.19911,53,41,36,12,5,12,3,male
1029 ms,15200 KB,United States,North America,46,277,209.0925853,1530.026662,44.76315789,68488.82505,38,29,24,9,5,10,3,male
810 ms,15300 KB,India,Asia,52,241,248.0323866,1373.805972,44.38888889,60981.72065,44,34,34,10,0,11,3,male
748 ms,16100 KB,Bangladesh,Asia,57,348,275.7915183,2029.845725,50.07692308,101648.4282,47,36,32,11,4,14,3,male
779 ms,16100 KB,India,Asia,64,295,320.1804545,1770,44.76666667,79237,50,42,40,8,2,14,3,male
763 ms,15500 KB,Indonesia,Asia,65,285,326.5538222,1716.374827,36.47058824,62597.19956,42,33,29,9,4,11,3,male
748 ms,15200 KB,India,Asia,51,292,238.9889445,1656.3482,37.56818182,62225.99033,55,47,47,8,0,11,3,male
779 ms,14200 KB,China,Asia,49,297,227.3200108,1667.568824,46.4,77375.19342,60,56,56,4,0,11,3,male
748 ms,14200 KB,India,Asia,57,295,276.504106,1720.702554,52.9375,91089.69146,51,41,36,10,5,12,3,male
218 ms,14100 KB,China,Asia,64,304,320.0450916,1824,37.79032258,68929.54839,48,35,34,13,1,12,3,male
748 ms,14200 KB,India,Asia,49,315,229.4868683,1768.633601,47.05882353,83229.81651,65,59,59,6,0,15,3,male
311 ms,15900 KB,China,Asia,54,307,257.6220106,1766.750463,41.7826087,73819.44327,45,38,38,7,0,11,3,male
264 ms,13400 KB,Vietnam,Asia,60,306,295.1851693,1807.508522,56.88461538,102819.4271,51,38,30,13,8,12,3,male
264 ms,14200 KB,Taiwan,Asia,57,287,277.0156616,1674.039434,53.2173913,89088.01162,49,41,40,8,1,13,3,male
358 ms,24600 KB,India,Asia,59,289,288.6764386,1700.083841,53.30769231,90627.54631,55,36,29,19,7,10,3,male
248 ms,14000 KB,China,Asia,65,324,326.4650059,1951.247171,45.890625,89543.95223,50,41,37,9,4,12,3,male
296 ms,11500 KB,Russia,AsiaEurope,79,374,422.3275002,2357.614,41.63265306,98153.72571,40,29,25,11,4,11,3,male
296 ms,14200 KB,China,Asia,56,265,271.0812322,1538.949054,51,78486.40177,41,33,33,8,0,11,3,male
311 ms,22700 KB,Mexico,North America,35,223,164.7548875,1143.830113,16,18301.2818,38,31,31,7,0,8,3,male
763 ms,16900 KB,Russia,AsiaEurope,63,305,313.6717238,1823.070377,46.75,85228.54011,57,37,24,20,13,11,3,male
1045 ms,30000 KB,Bangladesh,Asia,38,251,184.2797931,1317.229806,17.5,23051.5216,45,27,23,18,4,11,3,male
156 ms,12100 KB,China,Asia,66,388,333.1049912,2345.224918,38.08571429,89319.56617,43,39,39,4,0,11,4,male
311 ms,16100 KB,India,Asia,51,249,242.4606049,1412.43391,37,52260.05468,59,39,28,20,11,11,3,male
280 ms,16900 KB,Hong Kong,Asia,58,346,281.8126557,2026.861424,46.2,93640.9978,40,35,35,5,0,13,3,male
264 ms,16100 KB,China,Asia,53,258,252.2386659,1477.803477,36.57142857,54045.38431,44,38,38,6,0,11,3,female
296 ms,14200 KB,Syria,Asia,58,310,281.9620482,1815.974108,63.14814815,114675.402,46,31,22,15,9,11,3,male
249 ms,14100 KB,China,Asia,57,308,276.0964047,1796.530124,48,86233.44597,41,34,33,7,1,13,3,male
296 ms,22700 KB,India,Asia,36,218,171.2198934,1127.04365,16.5,18596.22023,41,30,27,11,3,11,3,male
296 ms,21100 KB,India,Asia,35,235,164.7548875,1205.381509,16,19286.10414,53,41,35,12,6,15,3,male
264 ms,12600 KB,India,Asia,54,258,257.6220106,1484.760976,51.2173913,76045.58388,41,36,36,5,0,11,3,male
763 ms,24700 KB,India,Asia,48,289,223.0669539,1614.054163,46.5,75053.51857,63,47,39,16,8,11,3,male
1029 ms,14000 KB,Iran,Asia,0,0,0,0,0,0,46,35,32,11,3,11,3,male
764 ms,28300 KB,India,Asia,51,268,242.4606049,1520.209992,35,53207.34971,60,45,39,15,6,11,3,male
264 ms,17800 KB,Egypt,AsiaAfrica,53,256,252.9035678,1466.347636,41.25,60486.84,46,41,41,5,0,11,3,male
764 ms,16100 KB,India,Asia,50,249,235.05865,1405.320191,31.11111111,43721.07262,59,48,45,11,3,9,3,male
249 ms,13400 KB,Argentina,South America,53,246,251.2486429,1409.068432,30,42272.05295,53,37,26,16,11,11,3,male
732 ms,19700 KB,India,Asia,52,290,245.8187515,1653.127518,45.02380952,74430.0985,51,41,37,10,4,11,3,male
280 ms,13400 KB,Indonesia,Asia,54,309,258.1074956,1778.260238,55.27272727,98289.29316,50,39,35,11,4,14,3,male
1060 ms,21200 KB,India,Asia,34,209,158.3349731,1063.279734,15.5,16480.83587,76,47,25,29,22,12,3,male
748 ms,17800 KB,Bangladesh,Asia,50,237,233.6452798,1337.593917,34.5,46146.99014,54,42,38,12,4,12,3,male
794 ms,23000 KB,India,Asia,38,268,180.9737366,1406.444574,17,23909.55775,64,57,57,7,0,12,3,male
249 ms,12600 KB,India,Asia,52,244,247.1756287,1390.907291,49.5,68849.91092,59,47,41,12,6,10,3,male
264 ms,15300 KB,Unknown,Unknown,54,305,258.7036718,1755.240688,51.85714286,91021.76711,58,46,40,12,6,11,3,male
312 ms,22300 KB,India,Asia,61,285,301.7363383,1690.260141,45.09615385,76224.23137,58,42,36,16,6,12,3,male
295 ms,13600 KB,South Korea,Asia,58,263,282.5614107,1540.649002,34.98,53891.90208,45,29,24,16,5,12,3,male
483 ms,15900 KB,Taiwan,Asia,49,273,231.5770955,1532.815787,36.26666667,55590.11922,68,49,36,19,13,11,3,male
311 ms,16100 KB,China,Asia,54,295,256.9778536,1697.691813,40.6,68926.28761,41,31,26,10,5,15,3,male
312 ms,16300 KB,Unknown,Unknown,64,312,320.7232379,1872,45,84240,51,40,36,11,4,12,4,male
280 ms,16300 KB,Unknown,Unknown,64,312,320.7232379,1872,45,84240,51,40,36,11,4,12,4,male
280 ms,21100 KB,India,Asia,44,249,212.401259,1359.398473,52.85714286,71853.91929,58,36,28,22,8,8,3,male
779 ms,14200 KB,Russia,AsiaEurope,58,296,281.9620482,1733.962375,48.7962963,84610.9418,57,43,35,14,8,11,3,male
779 ms,14200 KB,India,Asia,51,295,239.4453837,1673.365476,43.57142857,72910.92431,74,49,34,25,15,8,3,male
265 ms,12800 KB,India,Asia,53,252,252.2386659,1443.435955,44.95238095,64885.88291,60,47,41,13,6,10,3,male
327 ms,22300 KB,India,Asia,59,321,290.159225,1888.328419,41.47826087,78324.57876,50,42,42,8,0,15,3,male
1029 ms,13200 KB,India,Asia,55,296,264.041925,1711.282475,57.04347826,97617.50467,53,37,32,16,5,11,3,male
249 ms,19000 KB,India,Asia,59,301,289.5640056,1770.675558,47.39583333,83922.64363,52,49,49,3,0,12,2,male
795 ms,24400 KB,Germany,Europe,60,318,294.4134357,1878.391209,50.5,94858.75607,48,33,26,15,7,13,3,male
265 ms,15500 KB,Peru,South America,61,301,301.3556992,1785.151939,49.74074074,88794.77976,55,40,31,15,9,11,3,male
795 ms,15300 KB,Russia,AsiaEurope,53,308,250.9205489,1764.1995,62.22916667,109784.6647,51,40,35,11,5,10,3,male
171 ms,12000 KB,China,Asia,75,430,392.9423377,2678.392037,39.67857143,106274.7698,38,0,0,38,0,0,3,female
249 ms,15900 KB,China,Asia,54,327,256.9778536,1881.848213,40.02,75311.56549,45,37,37,8,0,13,3,male
826 ms,11600 KB,India,Asia,51,327,239.4453837,1854.883087,36.42857143,67570.74102,62,54,53,8,1,13,3,male
264 ms,10000 KB,Turkmenistan,Asia,56,316,269.6764904,1835.124155,45.26,83057.71927,57,34,24,23,10,14,3,male
249 ms,12800 KB,India,Asia,55,258,264.041925,1491.590806,43.82608696,65370.58837,61,48,42,13,6,10,3,male
280 ms,15500 KB,Indonesia,Asia,58,299,283.5668306,1751.536318,51.73913043,90622.96599,55,40,32,15,8,12,3,male
280 ms,13600 KB,Vietnam,Asia,55,278,264.5725015,1607.218,36.75,59065.26151,46,39,39,7,0,14,3,male
264 ms,16200 KB,Bangladesh,Asia,65,355,326.4650059,2137.940574,56.24242424,120242.9607,51,34,25,17,9,11,3,male
841 ms,27100 KB,India,Asia,34,238,158.3349731,1210.816156,20.66666667,25023.5339,73,44,20,29,24,10,3,male
280 ms,14700 KB,Iran,Asia,0,0,0,0,0,0,50,38,38,12,0,14,3,female
452 ms,15900 KB,Poland,Europe,60,344,294.6059378,2031.970365,54.28571429,110306.9627,69,45,26,24,19,11,3,male
748 ms,31900 KB,India,Asia,58,291,281.9620482,1704.67247,43.05555556,73395.62022,53,29,15,24,14,12,3,male
311 ms,19200 KB,Syria,Asia,38,214,188.1173001,1123.056488,18,20215.01678,45,39,39,6,0,13,3,male
748 ms,13400 KB,Argentina,South America,48,228,223.0669539,1273.37145,35.55882353,45279.59068,57,41,30,16,11,11,3,male
265 ms,14900 KB,Bangladesh,Asia,68,325,345.9899115,1978.425423,50.90909091,100719.8397,53,41,35,12,6,11,3,male
561 ms,26100 KB,India,Asia,40,244,191.1345461,1298.550455,24.5,31814.48615,61,47,47,14,0,11,3,male
1091 ms,30000 KB,Taiwan,Asia,41,265,197.7269405,1419.751281,18,25555.52306,48,27,23,21,4,11,3,male
295 ms,16100 KB,China,Asia,77,361,405.7769322,2262.309941,42.14634146,95348.08728,42,32,28,10,4,15,3,female
748 ms,14200 KB,India,Asia,56,343,269.4181505,1991.922738,52.5,104575.9438,89,60,38,29,22,13,3,male
234 ms,14000 KB,Bangladesh,Asia,65,299,326.4650059,1800.687976,38.78787879,69844.86695,45,34,30,11,4,12,3,male
795 ms,16100 KB,India,Asia,60,272,294.4615345,1606.674242,39.01724138,62687.99672,50,39,35,11,4,12,3,male
280 ms,12800 KB,India,Asia,55,263,264.041925,1520.497605,43.82608696,66637.46024,62,49,43,13,6,11,3,male
810 ms,16100 KB,India,Asia,52,290,245.3142135,1653.127518,36.81818182,60865.14954,57,41,32,16,9,11,3,male
249 ms,15900 KB,China,Asia,66,378,332.9300119,2284.780977,60.5,138229.2491,42,36,36,6,0,14,4,male
389 ms,20800 KB,India,Asia,39,237,190.8721876,1252.640326,24,30063.36782,57,48,48,9,0,12,3,male
280 ms,10900 KB,Italy,Europe,63,321,313.8551855,1918.706855,42.79310345,82107.42095,50,39,34,11,5,13,4,male
795 ms,16100 KB,India,Asia,49,300,228.6387356,1684.412953,48.22222222,81226.13574,59,42,34,17,8,12,3,male
186 ms,35200 KB,China,Asia,71,389,365.7235111,2392.251629,47.88235294,114546.6368,44,0,0,44,0,0,3,female
826 ms,13400 KB,Indonesia,Asia,59,239,288.3819626,1405.951689,24.88888889,34992.57537,47,38,38,9,0,12,3,male
748 ms,14200 KB,Unknown,Unknown,72,362,372.3949821,2233.512851,42.05263158,93925.09303,46,38,37,8,1,19,4,male
748 ms,17800 KB,India,Asia,52,250,245.3142135,1425.10993,32.72727273,46639.96133,60,45,37,15,8,12,3,male
296 ms,26800 KB,Brazil,South America,25,48,91.82263988,222.9050971,11.25,2507.682342,49,35,30,14,5,8,3,male
919 ms,15500 KB,Syria,Asia,57,277,275.7915183,1615.710534,42.92307692,69351.26753,64,40,24,24,16,11,3,female
280 ms,16100 KB,Unknown,Unknown,51,304,241.523656,1724.417304,42.16666667,72712.92965,58,39,33,19,6,11,3,female
295 ms,14500 KB,China,Asia,46,279,209.6645878,1541.073786,53.66666667,82704.29317,47,41,41,6,0,11,3,female
264 ms,29000 KB,China,Asia,63,283,313.6717238,1691.570218,40.7,68846.90789,51,39,34,12,5,11,3,female
280 ms,14200 KB,Taiwan,Asia,58,309,284.2247957,1810.116127,57.27272727,103670.2873,61,41,28,20,13,14,3,female
1013 ms,34700 KB,China,Asia,81,393,434.543206,2491.561051,48.125,119906.3756,43,29,29,14,0,12,3,female
280 ms,14900 KB,South Georgia and the South Sandwich Islands,Antarctic,64,360,320.4063545,2160,58.53448276,126434.4828,59,48,47,11,1,12,3,female
171 ms,12000 KB,China,Asia,67,438,339.4387425,2656.947065,54.60606061,145085.4125,58,51,51,7,0,15,4,female
265 ms,14800 KB,China,Asia,67,358,339.4387425,2171.65993,32.96969697,71598.96982,53,29,29,24,0,8,3,female
311 ms,58300 KB,China,Asia,60,339,294.4615345,2002.435912,39.55172414,79199.79279,56,45,43,11,2,12,3,female
311 ms,26600 KB,Ukraine,Europe,57,344,276.0964047,2006.514165,60.8,121996.0612,53,33,29,20,4,11,3,female
1029 ms,16000 KB,Unknown,Unknown,58,378,281.7628977,2214.316816,49,108501.524,54,44,40,10,4,11,3,female
795 ms,18900 KB,Bangladesh,Asia,51,268,241.523656,1520.209992,24.75,37625.19729,54,44,39,10,5,13,2,female
795 ms,20800 KB,India,Asia,36,306,174.9737366,1581.99705,17,26893.94986,82,68,66,14,2,11,4,female
280 ms,16100 KB,Mexico,North America,52,337,247.1756287,1921.048185,36.47368421,70067.70485,59,38,35,21,3,9,3,female
108 ms,12800 KB,Japan,Asia,65,408,328.3421192,2457.126068,35.25,86613.69389,72,62,62,10,0,18,6,female
810 ms,22400 KB,Russia,AsiaEurope,48,276,223.0669539,1541.44965,51.05882353,78704.60567,62,47,41,15,6,11,3,female
483 ms,16000 KB,Egypt,AsiaAfrica,56,331,270.0391,1922.234479,46.66666667,89704.2757,52,40,34,12,6,10,3,female
1107 ms,16000 KB,Romania,Europe,49,342,227.3200108,1920.230767,46.4,89098.70757,54,40,34,14,6,11,3,female
780 ms,14200 KB,Bangladesh,Asia,65,357,328.3421192,2149.985309,60.75,130611.6075,69,46,33,23,13,16,8,female
795 ms,14200 KB,Bangladesh,Asia,66,359,335.0885565,2169.937489,62.30769231,135203.7974,69,46,33,23,13,16,8,female
795 ms,16100 KB,Lebanon,Asia,55,312,263.0928815,1803.784231,45.17307692,81482.4838,53,36,26,17,10,11,3,female
265 ms,24000 KB,Taiwan,Asia,66,356,333.1049912,2151.804306,40.08064516,86245.70487,55,30,26,25,4,12,3,female
187 ms,13800 KB,China,Asia,71,475,365.8862514,2921.129882,64.69736842,188989.4162,58,0,0,58,0,0,3,female
249 ms,17000 KB,Colombia,South America,65,328,327.3557123,1975.336643,43.60714286,86138.78717,66,39,26,27,13,13,5,female
218 ms,15100 KB,China,Asia,71,463,365.7235111,2847.332916,33.73529412,96055.61338,76,64,64,12,0,16,4,female
296 ms,28600 KB,Japan,Asia,39,265,175.7360429,1400.631588,15,21009.47382,66,43,34,23,9,5,2,female
327 ms,22300 KB,Russia,AsiaEurope,55,299,265.9634675,1728.626554,30.625,52939.18823,65,50,44,15,6,14,4,female
295 ms,13400 KB,China,Asia,83,444,447.6031056,2830.517508,47.31428571,133923.9141,48,34,34,14,0,21,8,female
234 ms,10600 KB,China,Asia,68,468,346.6279634,2848.93261,57.63333333,164193.4827,65,40,37,25,3,14,3,female
858 ms,13200 KB,Poland,Europe,50,298,233.1201147,1681.869145,32.45238095,54580.65819,60,45,39,15,6,13,3,female
265 ms,13400 KB,China,Asia,83,450,447.6031056,2868.767744,47.31428571,135733.6967,50,36,36,14,0,22,8,female
717 ms,11200 KB,China,Asia,65,439,326.5538222,2643.81947,61.41935484,162381.6862,57,20,15,37,5,5,1,female
249 ms,14200 KB,Unknown,Unknown,61,396,305.1157897,2348.571986,46.66666667,109600.026,58,33,27,25,6,8,3,female
873 ms,15900 KB,China,Asia,73,475,378.8670746,2940.166665,63.20833333,185843.0346,68,58,58,10,0,18,7,female
295 ms,24000 KB,India,Asia,37,251,177.7286241,1307.572795,17,22228.73751,52,33,32,19,1,12,4,female
795 ms,16100 KB,China,Asia,68,380,345.9474732,2313.23588,41.5,95999.28901,64,40,39,24,1,8,3,female
764 ms,16300 KB,Egypt,AsiaAfrica,62,382,307.9068682,2274.502991,49.25925926,112040.3325,64,40,38,24,2,11,3,female
296 ms,20800 KB,India,Asia,38,365,188.1173001,1915.493542,18,34478.88376,86,64,57,22,7,16,6,female
764 ms,16100 KB,Romania,Europe,55,300,265.9634675,1734.407914,45.5,78915.56009,66,44,30,22,14,16,3,female
327 ms,28600 KB,China,Asia,72,505,372.3949821,3115.812126,44.14705882,137553.9412,72,53,51,19,2,19,3,female
296 ms,21100 KB,India,Asia,76,348,399.7943904,2174.278775,39.52325581,85934.57622,54,41,41,13,0,13,3,female
405 ms,15900 KB,China,Asia,93,490,515.2115894,3204.187817,58.59375,187745.3799,60,40,37,20,3,17,4,female
280 ms,14200 KB,India,Asia,70,428,359.4212455,2623.333131,57.59375,151087.5925,64,38,32,26,6,9,3,female
748 ms,14200 KB,Taiwan,Asia,60,295,295.1851693,1742.532726,51,88869.16901,69,42,38,27,4,12,3,female
779 ms,13900 KB,Ukraine,Europe,83,495,446.1369639,3155.644519,73.21428571,231038.2594,78,40,22,38,18,17,6,female
108 ms,12000 KB,China,Asia,106,574,608.4972857,3861.826341,78.2,301994.8199,60,9,-1,51,10,9,2,female
109 ms,12000 KB,China,Asia,106,574,608.4972857,3861.826341,78.2,301994.8199,60,9,-1,51,10,9,2,female
264 ms,15700 KB,India,Asia,60,361,295.1851693,2132.387505,30.07692308,64135.65496,76,59,54,17,5,14,3,female
280 ms,31000 KB,China,Asia,59,402,292.5692484,2364.822506,52.65,124507.9049,93,40,26,53,14,12,3,female
748 ms,19000 KB,Unknown,Unknown,53,323,254.5835556,1850.118307,48.61111111,89936.30658,73,58,51,15,7,13,3,female
841 ms,14000 KB,China,Asia,69,408,352.582306,2492.277978,46.75,116513.9955,87,37,24,50,13,8,3,female
312 ms,24600 KB,India,Asia,57,373,278.3559659,2175.667975,52.28571429,113756.3541,76,44,34,32,10,12,3,female
218 ms,17300 KB,China,Asia,68,492,346.1173001,2995.031718,48.88888889,146423.7729,91,70,70,21,0,18,4,female
779 ms,16100 KB,Germany,Europe,51,334,240.7106228,1894.590064,48.84210526,92535.76735,82,59,51,23,8,13,4,female
826 ms,115500 KB,Unknown,Unknown,55,443,265.9634675,2561.142353,49.875,127736.9749,98,45,28,53,17,12,3,female
763 ms,16100 KB,China,Asia,64,442,322.2270913,2652,49.92,132387.84,76,39,39,37,0,8,3,female
265 ms,10300 KB,Belarus,Europe,62,335,307.9068682,1994.655764,52.5,104719.4276,83,46,33,37,13,11,3,female
280 ms,26300 KB,Belarus,Europe,37,284,181.5249056,1479.484756,17.5,25890.98323,97,41,16,56,25,11,3,female
249 ms,14200 KB,Japan,Asia,81,482,432.75063,3055.807701,74.11842105,226491.6419,95,55,39,40,16,16,7,female
280 ms,13400 KB,China,Asia,90,510,494.5555318,3310.845079,63.42857143,210002.1736,81,54,45,27,9,26,5,female
561 ms,15900 KB,China,Asia,71,496,365.7235111,3050.274571,71.27941176,217421.7772,91,43,35,48,8,13,4,female
311 ms,17100 KB,China,Asia,73,452,378.8670746,2797.800701,58.86486486,164692.1602,97,54,28,43,26,17,4,female
904 ms,14200 KB,China,Asia,106,680,607.4046851,4574.985909,83.03571429,379887.2228,71,46,43,25,3,24,7,female
1013 ms,64400 KB,China,Asia,81,465,433.2506894,2948.030251,47.6,140326.24,75,51,51,24,0,19,6,female
529 ms,24500 KB,Russia,AsiaEurope,69,462,352.4986422,2822.138299,56.61764706,159782.8302,92,51,40,41,11,12,3,female
327 ms,28300 KB,India,Asia,41,320,204.176133,1714.416641,19,32573.91619,95,53,40,42,13,13,4,female
280 ms,16900 KB,China,Asia,76,383,399.1845378,2392.956238,31.58536585,75582.39824,83,41,31,42,10,10,3,female
280 ms,17300 KB,South Korea,Asia,53,385,255.6041684,2205.249375,58.23529412,128423.346,67,45,39,22,6,13,3,female
296 ms,16900 KB,Iran,Asia,59,438,288.6764386,2576.597656,68.53846154,176596.0393,76,54,48,22,6,13,3,female
343 ms,26300 KB,India,Asia,38,175,162.6452839,918.3873149,25.3,23235.19907,91,58,55,33,3,10,4,female
296 ms,9500 KB,China,Asia,74,537,386.1246381,3334.476457,69.57575758,231998.7256,91,50,40,41,10,18,4,female
467 ms,14800 KB,China,Asia,90,538,494.3950605,3492.616966,71.04651163,248138.2519,87,45,34,42,11,17,7,female
265 ms,22000 KB,India,Asia,80,492,426.079159,3110.388623,45.90540541,142783.6507,101,47,27,54,20,12,5,female
233 ms,9800 KB,China,Asia,86,486,466.692323,3123.164671,58.70454545,183343.9624,100,52,47,48,5,17,4,female
295 ms,14900 KB,China,Asia,78,474,413.5983953,2979.280652,49.77272727,148286.9233,108,80,80,28,0,24,9,female
358 ms,25500 KB,Russia,AsiaEurope,71,479,366.1306865,2945.72887,50.578125,148989.443,124,74,61,50,13,18,4,female
265 ms,22400 KB,Japan,Asia,84,613,453.8154506,3918.49058,52.35106383,205137.1505,92,39,30,53,9,16,5,female
296 ms,16900 KB,India,Asia,91,687,501.5981141,4470.854918,58.33333333,260799.8702,104,65,53,39,12,18,7,female
295 ms,24600 KB,Bangladesh,Asia,89,639,487.5430078,4137.993662,84.44680851,349440.3584,111,56,31,55,25,25,9,female
358 ms,36400 KB,India,Asia,80,520,425.8985773,3287.402609,57.47368421,188939.1394,123,83,68,40,15,22,5,female
1419 ms,11000 KB,Japan,Asia,84,544,453.2640759,3477.420678,61.73076923,214663.8534,105,66,54,39,12,21,8,female
249 ms,19500 KB,India,Asia,65,445,326.9987489,2679.953677,34.75862069,93151.49332,166,91,66,75,25,17,6,female
592 ms,17900 KB,India,Asia,75,681,392.4020294,4241.825528,63.42857143,269052.9335,119,81,80,38,1,17,7,female
295 ms,26600 KB,Belarus,Europe,77,559,405.6268983,3503.133676,55.5,194423.919,127,65,58,62,7,18,3,female
295 ms,20800 KB,India,Asia,91,797,503.0010296,5186.712328,134.0754717,695410.902,88,54,54,34,0,22,9,female
280 ms,23000 KB,India,Asia,89,733,487.3483806,4746.712605,73.63636364,349530.6555,168,118,118,50,0,32,9,female
280 ms,47800 KB,Russia,AsiaEurope,77,631,405.551932,3954.342307,52.34210526,206978.6013,143,54,42,89,12,17,5,female
343 ms,18400 KB,China,Asia,107,1022,615.8588276,6889.77926,175.704918,1210568.1,115,66,64,49,2,38,11,female
311 ms,24600 KB,India,Asia,50,624,255.7247662,3521.766262,29.33333333,103305.1437,208,139,114,69,25,34,12,female
265 ms,29900 KB,Bangladesh,Asia,68,725,346.6279634,4413.41056,61.43333333,271130.5221,184,53,2,131,51,10,5,female
234 ms,15600 KB,Bangladesh,Asia,84,636,455.7586984,4065.513881,44.64705882,181513.2374,160,38,19,122,19,10,3,female
764 ms,15300 KB,China,Asia,116,1334,683.1336612,9148.546648,86.74285714,793571.0749,200,143,126,57,17,36,12,female
311 ms,39400 KB,Bangladesh,Asia,8,69,24,207,0,0,226,47,-12,179,59,12,3,female
249 ms,10100 KB,China,Asia,11,26,38.05374781,89.94522208,0,0,151,73,73,78,0,68,38,female
311 ms,24600 KB,India,Asia,79,1357,428.0138843,8554.230475,45.83333333,392068.8968,396,271,222,125,49,67,23,female
280 ms,16100 KB,Bangladesh,Asia,49,373,235.7693245,2094.286772,30.83333333,64573.84213,263,51,11,212,40,24,16,female
