time,memory,country,continent,program_vocabulary,program_length,calculated_estimated_program_length,volume,difficulty,effort,loc,slocP,lsloc,comments,blankLine,cyclomatic_complexity,numberOfFunction,gender
530 ms,19500 KB,India,Asia,55,224,263.6191856,1295.024576,26.47916667,34291.17158,35,28,25,7,3,10,2,male
389 ms,21100 KB,India,Asia,47,213,218.6033589,1183.127425,25.6,30288.06209,50,41,36,9,5,8,2,male
108 ms,20900 KB,India,Asia,46,242,217.5786534,1336.701993,35,46784.56977,45,36,29,9,7,10,2,male
108 ms,21800 KB,India,Asia,46,214,215.9932866,1182.042259,31.16666667,36840.31706,43,33,28,10,5,11,3,male
108 ms,18200 KB,United States,North America,48,225,225.0683649,1256.616563,41.8,52526.57232,41,35,32,6,3,10,2,male
373 ms,21100 KB,India,Asia,48,221,225.0683649,1234.276713,25.3,31227.20083,54,40,30,14,10,10,2,male
561 ms,15700 KB,Bangladesh,Asia,51,211,240.7106228,1196.881747,23.57894737,28221.21172,35,33,33,2,0,10,2,male
592 ms,18600 KB,India,Asia,41,241,188.529325,1291.170033,26.66666667,34431.20088,58,56,56,2,0,10,2,male
124 ms,27000 KB,Unknown,Unknown,51,248,241.523656,1406.761485,27.5,38685.94083,52,43,40,9,3,9,2,male
499 ms,20600 KB,India,Asia,41,239,192.6252211,1280.454929,31.57142857,40425.79133,56,51,50,5,1,11,2,male
530 ms,26400 KB,India,Asia,41,235,190.4650059,1259.024721,26.8125,33757.60033,55,51,51,4,0,12,2,male
108 ms,11300 KB,China,Asia,77,403,405.7769322,2525.514976,41.70731707,105332.4539,35,30,30,5,0,20,2,male
108 ms,18200 KB,India,Asia,40,250,201.4212455,1330.482024,19,25279.15845,59,49,46,10,3,11,2,male
436 ms,16700 KB,Jordan,Asia,52,258,248.0323866,1470.713447,28.33333333,41670.21434,46,30,22,16,8,10,2,male
545 ms,23500 KB,Bangladesh,Asia,47,246,221.0794529,1366.428858,27.46153846,37524.23863,60,46,38,14,8,9,2,male
343 ms,16700 KB,China,Asia,56,315,271.0812322,1829.3168,27.81818182,50888.26736,38,35,35,3,0,15,5,male
343 ms,16700 KB,China,Asia,56,315,271.0812322,1829.3168,27.81818182,50888.26736,38,35,35,3,0,15,5,male
529 ms,18600 KB,India,Asia,41,225,192.6252211,1205.449201,38.85714286,46840.31181,52,40,40,12,0,10,2,male
561 ms,25500 KB,India,Asia,49,252,231.5770955,1414.906881,23.8,33674.78376,59,53,52,6,1,10,3,male
546 ms,18600 KB,India,Asia,43,238,203.5249056,1291.451012,26.25,33900.58906,68,58,50,10,8,12,2,male
530 ms,16500 KB,China,Asia,53,315,254.5835556,1804.294943,36.94444444,66658.67429,59,55,55,4,0,16,3,male
608 ms,24400 KB,India,Asia,66,304,333.1049912,1837.495812,41.77419355,76759.90571,56,53,53,3,0,14,3,male
592 ms,32300 KB,India,Asia,49,240,232.8278745,1347.530363,32.5,43794.73678,42,33,27,9,6,9,2,male
545 ms,18600 KB,India,Asia,58,295,284.2247957,1728.104394,36.81818182,63625.66176,59,54,53,5,1,13,3,male
77 ms,17600 KB,China,Asia,68,378,347.4830616,2301.060954,22.14285714,50952.06398,43,35,35,8,0,19,1,male
93 ms,14700 KB,Vietnam,Asia,67,323,340.7366244,1959.346809,40.39285714,79143.61573,53,42,35,11,7,18,1,male
109 ms,10800 KB,South Korea,Asia,79,406,419.2271063,2559.334984,45.80952381,117241.9169,39,33,31,6,2,21,1,male
62 ms,17600 KB,China,Asia,68,391,347.4830616,2380.197971,22.14285714,52704.38364,43,35,35,8,0,19,1,male
561 ms,24500 KB,China,Asia,70,407,359.0910367,2494.618188,54.52941176,136030.0624,48,44,44,4,0,14,2,male
420 ms,25000 KB,India,Asia,38,250,188.1173001,1311.981878,18,23615.67381,67,56,50,11,6,12,2,male
374 ms,15300 KB,Bangladesh,Asia,57,244,277.6324012,1423.225163,26.25,37359.66054,44,39,37,5,2,10,2,male
577 ms,17600 KB,India,Asia,50,286,235.9518742,1614.14287,33.97058824,54833.3828,98,80,72,18,8,12,2,male
93 ms,15300 KB,Iran,Asia,64,252,321.1317371,1512,33.57407407,50764,40,31,30,9,1,10,2,male
108 ms,15700 KB,Brazil,South America,63,302,314.1308434,1805.138537,29.375,53025.94452,68,40,20,28,20,11,2,male
93 ms,11800 KB,China,Asia,68,475,345.9899115,2891.54485,71.59090909,207008.3245,50,45,45,5,0,18,2,male
561 ms,25400 KB,Azerbaijan,AsiaEurope,58,361,282.2114327,2114.731139,43.07692308,91096.11061,40,36,36,4,0,19,2,male
560 ms,19600 KB,India,Asia,46,255,213.3029689,1408.508299,29.71428571,41852.81802,88,65,46,23,19,10,2,male
78 ms,19700 KB,India,Asia,46,250,217.5786534,1380.890489,23.86363636,32953.06849,43,39,38,4,1,13,2,male
109 ms,16600 KB,China,Asia,73,432,380.0574174,2674.004209,32.8452381,87828.30493,44,36,35,8,1,18,1,male
93 ms,10800 KB,China,Asia,70,475,359.0498112,2911.409433,48.5,141203.3575,30,23,21,7,2,15,1,male
93 ms,16500 KB,China,Asia,73,432,380.0574174,2674.004209,32.8452381,87828.30493,45,36,34,9,2,18,1,female
124 ms,15300 KB,Romania,Europe,61,263,302.7888745,1559.78392,35.45833333,55307.33816,35,30,27,5,3,10,2,male
78 ms,11300 KB,China,Asia,67,371,339.5249056,2250.51909,37.734375,84921.93127,61,48,44,13,4,18,2,male
109 ms,17200 KB,India,Asia,47,244,222.5444556,1355.31968,35,47436.18879,47,41,37,6,4,11,3,male
92 ms,19700 KB,India,Asia,51,271,243.5249056,1537.227268,25.15625,38670.87345,48,41,38,7,3,14,3,male
405 ms,9800 KB,Jordan,Asia,54,299,259.4122985,1720.711363,37.4,64354.60498,53,35,26,18,9,13,2,male
124 ms,16700 KB,Austria,Europe,71,330,365.8862514,2029.416549,38.57575758,78286.28083,62,52,47,10,5,15,2,male
560 ms,18600 KB,Ukraine,Europe,60,288,295.6213103,1701.184492,32.2,54778.14063,62,45,35,17,10,12,2,male
296 ms,22600 KB,India,Asia,48,290,226.2767055,1619.639125,26.71428571,43267.50234,65,53,46,12,7,14,3,male
109 ms,16900 KB,India,Asia,87,455,474.942584,2931.539291,48.84,143176.379,53,50,50,3,0,20,6,male
124 ms,18200 KB,India,Asia,48,265,226.2767055,1480.015063,30.35714286,44929.02869,57,50,50,7,0,13,2,male
389 ms,18200 KB,India,Asia,53,289,255.6041684,1655.369011,31.76470588,52582.30977,67,63,63,4,0,13,2,male
389 ms,18200 KB,Kazakhstan,AsiaEurope,62,269,307.9068682,1601.678807,33.05555556,52944.3828,43,27,22,16,5,10,2,male
468 ms,18500 KB,India,Asia,56,257,271.7635715,1492.490215,27.5,41043.48091,51,48,48,3,0,13,2,male
577 ms,17600 KB,India,Asia,56,257,271.7635715,1492.490215,27.5,41043.48091,51,48,48,3,0,13,2,male
483 ms,10800 KB,Unknown,Unknown,58,370,283.5668306,2167.452968,36.52173913,79159.15188,66,61,61,5,0,22,2,male
202 ms,26500 KB,Iran,Asia,66,308,332.9737366,1861.673389,37.1875,69230.97914,47,33,28,14,5,15,2,male
124 ms,22100 KB,India,Asia,60,303,300.3702549,1789.78785,30.21052632,54070.43296,53,44,40,9,4,10,2,male
499 ms,19600 KB,Hong Kong,Asia,54,250,258.1074956,1438.721876,25.45454545,36622.01138,42,37,36,5,1,11,2,male
109 ms,19600 KB,Indonesia,Asia,61,301,302.7888745,1785.151939,39.3125,70178.78559,49,42,39,7,3,11,2,male
124 ms,17200 KB,Vietnam,Asia,52,268,250.1173001,1527.717844,40.5,61872.5727,47,38,33,9,5,12,3,male
124 ms,18200 KB,India,Asia,58,270,283.5668306,1581.654869,36.52173913,57764.78651,54,41,35,13,6,11,2,male
77 ms,21500 KB,China,Asia,71,495,365.6422056,3044.124824,42.77777778,130220.8953,38,34,34,4,0,26,2,male
561 ms,18600 KB,India,Asia,64,337,320.4063545,2022,53.10344828,107375.1724,59,55,53,4,2,15,2,male
93 ms,11800 KB,China,Asia,88,469,480.7253082,3029.473429,36.63829787,110994.7499,43,32,32,11,0,13,2,female
124 ms,20800 KB,Unknown,Unknown,59,310,293.5877466,1823.619345,30.52631579,55668.38001,68,47,38,21,9,12,3,male
592 ms,25500 KB,Kazakhstan,AsiaEurope,56,307,272.5558619,1782.857961,41.4,73810.31959,51,46,46,5,0,10,2,female
77 ms,12700 KB,India,Asia,66,336,334.0271833,2030.916424,37.32142857,75796.70226,57,50,49,7,1,16,1,male
78 ms,6000 KB,South Korea,Asia,42,315,193.2192809,1698.579988,16,27177.27981,84,79,79,5,0,20,1,male
124 ms,19100 KB,Serbia,Europe,51,296,241.523656,1679.037901,33.91666667,56947.36882,74,55,38,19,17,12,3,male
78 ms,50900 KB,China,Asia,74,436,386.1246381,2707.321667,49.07575758,132863.8618,45,0,0,45,0,0,3,male
78 ms,50900 KB,China,Asia,74,436,386.1246381,2707.321667,49.07575758,132863.8618,45,0,0,45,0,0,3,male
109 ms,21800 KB,Bangladesh,Asia,56,271,273.4603973,1573.793184,27.26315789,42906.57207,62,43,32,19,11,13,2,male
373 ms,19200 KB,Bangladesh,Asia,52,255,248.0323866,1453.612128,29.27777778,42558.53286,49,41,37,8,4,11,2,male
546 ms,24500 KB,China,Asia,65,406,326.9987489,2445.081332,48.4137931,118375.6617,45,35,35,10,0,18,3,male
576 ms,17600 KB,India,Asia,67,295,339.6973857,1789.496311,34.25806452,61304.68008,44,39,38,5,1,12,3,male
405 ms,25500 KB,China,Asia,62,400,309.4603455,2381.678524,62.54166667,148954.1444,67,61,61,6,0,17,2,female
78 ms,20600 KB,China,Asia,80,405,425.7903187,2560.380878,42.57692308,109013.1397,53,38,35,15,3,18,2,female
545 ms,16700 KB,Unknown,Unknown,57,247,277.6324012,1440.723833,29.43181818,42403.12192,47,42,42,5,0,11,2,male
545 ms,15600 KB,China,Asia,54,342,260.2355283,1968.171526,41.44736842,81575.53034,86,72,69,14,3,20,2,male
124 ms,19200 KB,India,Asia,45,254,214.6466251,1394.930686,20,27898.61373,54,40,35,14,5,10,2,male
124 ms,20800 KB,Vietnam,Asia,53,284,256.7497745,1626.729409,45.09375,73355.32929,50,38,32,12,6,12,3,male
405 ms,15300 KB,India,Asia,52,278,257.71338,1584.722242,31.68181818,50206.88193,53,37,31,16,6,11,2,male
546 ms,18600 KB,China,Asia,55,250,265.2124025,1445.339928,28.33333333,40951.29797,48,38,34,10,4,13,2,female
421 ms,25600 KB,India,Asia,68,356,345.9899115,2167.136771,34.46969697,74700.5478,51,45,45,6,0,13,2,male
124 ms,6400 KB,India,Asia,65,340,328.3421192,2047.605056,40.5,82928.00479,65,48,42,17,6,11,2,male
577 ms,15700 KB,India,Asia,57,279,280.1318683,1627.376314,30,48821.28942,58,43,40,15,3,10,2,male
109 ms,23100 KB,India,Asia,63,322,317.7671278,1924.684135,45.65909091,87879.32791,50,42,39,8,3,12,2,male
592 ms,25500 KB,Unknown,Unknown,40,279,197.504662,1484.817938,18.5,27469.13186,68,52,44,16,8,12,3,male
93 ms,15400 KB,Iran,Asia,54,332,258.7036718,1910.622651,33.78571429,64551.75098,38,27,22,11,5,18,3,male
77 ms,22100 KB,Mexico,North America,45,310,214.6466251,1702.47446,38,64694.02947,47,38,37,9,1,17,3,male
327 ms,19700 KB,Unknown,Unknown,58,295,284.2247957,1728.104394,31.90909091,55142.24019,63,50,50,13,0,13,2,male
124 ms,18200 KB,India,Asia,57,309,279.1883364,1802.363014,37,66687.43153,63,57,57,6,0,14,3,male
280 ms,17700 KB,Unknown,Unknown,58,295,284.2247957,1728.104394,31.90909091,55142.24019,63,50,50,13,0,13,2,male
77 ms,20600 KB,China,Asia,79,404,419.0808777,2546.727422,44.23684211,112659.1789,56,42,39,14,3,18,2,female
108 ms,18200 KB,India,Asia,55,263,266.8279228,1520.497605,30.31578947,46095.08528,71,47,36,24,11,13,2,male
577 ms,16700 KB,India,Asia,52,254,249.0117739,1447.911688,26.76470588,38752.93048,57,50,49,7,1,11,3,male
124 ms,18100 KB,India,Asia,56,290,273.4603973,1684.132927,30.18421053,50834.22283,66,60,60,6,0,15,2,male
530 ms,31000 KB,India,Asia,32,241,149.2067179,1205,15,18075,74,67,66,7,1,11,2,male
358 ms,15800 KB,Unknown,Unknown,59,299,290.159225,1758.910272,30.52173913,53685.00047,63,50,50,13,0,13,2,male
577 ms,16600 KB,India,Asia,72,344,373.2397178,2122.4542,42.32258065,89827.73907,57,51,49,6,2,16,2,male
124 ms,17700 KB,India,Asia,53,252,256.7497745,1443.435955,27.75,40055.34774,58,54,54,4,0,13,2,male
389 ms,15300 KB,Ukraine,Europe,56,291,273.4603973,1689.940282,44.78947368,75691.5358,57,43,38,14,5,14,2,male
467 ms,22700 KB,Taiwan,Asia,58,369,284.9884404,2161.594987,38.76190476,83787.53903,52,49,48,3,1,16,1,female
576 ms,17600 KB,China,Asia,70,407,359.2147805,2494.618188,49.33333333,123067.8306,76,51,35,25,16,18,2,male
186 ms,16700 KB,Unknown,Unknown,62,315,310.9846194,1875.571838,36.36363636,68202.61228,45,33,26,12,7,10,3,male
358 ms,15800 KB,Unknown,Unknown,60,305,296.7916995,1801.601632,31.36956522,56515.45988,63,50,50,13,0,13,2,male
576 ms,18600 KB,India,Asia,53,277,254.5835556,1586.633966,28.19444444,44734.26321,59,54,53,5,1,14,3,male
561 ms,19600 KB,Bangladesh,Asia,46,257,215.9932866,1419.555423,32.58333333,46253.84752,51,42,38,9,4,13,2,male
124 ms,26700 KB,Unknown,Unknown,53,311,255.6041684,1781.383261,30.70588235,54698.94485,66,48,45,18,3,12,3,female
560 ms,15700 KB,India,Asia,57,266,277.6324012,1551.548744,34.20454545,53070.01953,47,42,42,5,0,10,2,male
109 ms,21800 KB,India,Asia,53,289,254.5835556,1655.369011,28.19444444,46672.20963,62,52,46,10,6,14,3,male
405 ms,30900 KB,India,Asia,39,275,194.7497745,1453.48561,18.5,26889.48379,78,64,61,14,3,12,3,male
296 ms,10800 KB,China,Asia,75,435,392.4020294,2709.53613,46.28571429,125412.8152,51,40,36,11,4,24,2,male
93 ms,10800 KB,South Korea,Asia,70,423,359.4212455,2592.686716,42.52631579,110257.414,62,56,56,6,0,21,4,male
139 ms,17600 KB,Peru,South America,67,338,340.3026944,2050.338146,47.82758621,98062.72445,76,57,41,19,16,15,3,male
342 ms,10800 KB,China,Asia,75,435,392.4020294,2709.53613,46.28571429,125412.8152,51,40,36,11,4,24,2,male
342 ms,10800 KB,China,Asia,75,435,392.4020294,2709.53613,46.28571429,125412.8152,52,40,35,12,5,24,2,male
124 ms,18600 KB,Kenya,Africa,62,334,310.1726115,1988.701568,54.26086957,107908.6764,68,60,59,8,1,14,2,male
124 ms,15300 KB,India,Asia,61,319,306.0981941,1891.905211,46.125,87264.12784,63,57,54,6,3,13,2,male
561 ms,17600 KB,India,Asia,51,257,241.523656,1457.813313,24.75,36080.87949,58,54,52,4,2,14,3,male
108 ms,11700 KB,China,Asia,63,443,314.4992626,2647.935006,42,111213.2703,67,61,61,6,0,25,2,female
483 ms,16600 KB,India,Asia,63,312,314.9612072,1864.911336,38.42307692,71655.63172,62,51,51,11,0,13,2,male
124 ms,17200 KB,India,Asia,47,269,227.9505705,1494.184401,21.11111111,31543.89291,57,45,41,12,4,11,2,male
327 ms,23500 KB,China,Asia,49,322,229.4868683,1807.93657,27.29411765,49346.03343,76,61,61,15,0,14,3,female
561 ms,19600 KB,India,Asia,53,282,253.6843594,1615.273568,30.42105263,49138.32223,57,52,52,5,0,12,2,male
514 ms,31200 KB,Ukraine,Europe,38,278,188.1173001,1458.923849,18,26260.62928,59,46,41,13,5,16,2,male
139 ms,14600 KB,China,Asia,65,444,326.7316235,2673.931309,30.91666667,82669.04297,48,44,44,4,0,30,5,male
530 ms,18600 KB,India,Asia,46,334,215.9932866,1844.869693,19.83333333,36589.91558,91,85,85,6,0,14,1,male
109 ms,19200 KB,India,Asia,56,325,272.5558619,1887.39035,27.9,52658.19076,71,44,35,27,9,13,2,male
93 ms,19200 KB,India,Asia,53,293,254.5835556,1678.280693,30.13888889,50581.51534,54,42,39,12,3,13,2,male
561 ms,17600 KB,India,Asia,47,241,222.5444556,1338.655913,24.79166667,33187.51118,59,46,38,13,8,12,2,male
93 ms,31700 KB,India,Asia,60,308,295.6213103,1819.322303,41.3,75138.01113,79,66,64,13,2,10,2,male
93 ms,19300 KB,Vietnam,Asia,64,348,322.2270913,2088,39,81432,53,33,24,20,9,18,3,male
389 ms,18200 KB,China,Asia,57,312,278.3559659,1819.861684,42.85714286,77994.07219,72,53,43,19,10,14,3,female
561 ms,17600 KB,India,Asia,61,303,301.7363383,1797.013413,35.67307692,64104.99772,79,75,73,4,2,12,3,male
93 ms,19200 KB,India,Asia,0,0,0,0,0,0,56,45,43,11,2,13,2,male
343 ms,41000 KB,Bangladesh,Asia,41,278,208.1306865,1489.399457,19.5,29043.28942,49,43,43,6,0,14,2,male
576 ms,15700 KB,China,Asia,47,266,221.0794529,1477.520635,32.69230769,48303.55921,57,54,53,3,1,13,2,male
498 ms,19300 KB,Vietnam,Asia,66,353,335.7560369,2133.671124,41,87480.51609,53,32,23,21,9,18,3,male
576 ms,18600 KB,India,Asia,72,298,372.2346001,1838.63765,28.5,52401.17304,50,47,46,3,1,13,2,male
171 ms,17700 KB,United States,North America,54,292,260.2355283,1680.427151,27.63157895,46432.85548,64,54,48,10,6,14,3,male
93 ms,12000 KB,China,Asia,66,431,333.6312234,2605.133865,35.72413793,93066.16154,66,61,61,5,0,21,1,male
124 ms,23100 KB,Indonesia,Asia,45,316,214.6466251,1735.425578,28,48591.9162,52,41,37,11,4,10,2,male
109 ms,32800 KB,India,Asia,38,266,188.1173001,1395.948719,18,25127.07693,67,64,64,3,0,9,2,male
124 ms,18200 KB,India,Asia,57,312,279.1883364,1819.861684,45.325,82485.23085,66,57,56,9,1,12,4,male
124 ms,21800 KB,India,Asia,57,301,279.1883364,1755.699894,45.325,79577.09771,66,56,55,10,1,12,4,male
561 ms,90000 KB,India,Asia,0,0,0,0,0,0,80,61,50,19,11,11,3,male
108 ms,19200 KB,India,Asia,44,264,204.5187537,1441.289947,25.5,36752.89366,67,56,49,11,7,14,3,male
93 ms,18700 KB,Unknown,Unknown,62,333,310.1726115,1982.747371,44.93478261,89094.3221,70,47,42,23,5,13,2,male
561 ms,31000 KB,India,Asia,32,241,149.2067179,1205,15,18075,74,67,66,7,1,11,2,female
529 ms,16500 KB,China,Asia,73,398,379.6596322,2463.550174,67.265625,165712.2422,46,40,39,6,1,19,2,male
93 ms,21500 KB,China,Asia,62,381,311.8982981,2268.548794,29.28571429,66436.07183,45,38,38,7,0,14,3,male
405 ms,19600 KB,Ukraine,Europe,45,289,206.8830545,1587.145545,29.89285714,47444.31504,58,36,31,22,5,13,2,male
389 ms,18200 KB,India,Asia,59,322,290.159225,1894.211062,32.08695652,60779.46799,68,58,54,10,4,13,3,male
124 ms,23100 KB,India,Asia,61,306,308.3880345,1814.805625,40.61111111,73701.27289,71,47,37,24,10,11,3,male
93 ms,18200 KB,India,Asia,53,289,254.5835556,1655.369011,28.19444444,46672.20963,57,52,51,5,1,14,3,male
545 ms,18600 KB,Bangladesh,Asia,55,281,267.8084246,1624.56208,34.94444444,56769.41933,52,43,39,9,4,11,2,male
390 ms,18200 KB,India,Asia,53,287,254.5835556,1643.91317,28.19444444,46349.21856,58,52,50,6,2,14,3,male
187 ms,9400 KB,Iran,Asia,71,385,365.8862514,2367.652641,66.21212121,156767.3037,58,46,43,12,3,13,1,male
389 ms,17200 KB,India,Asia,58,328,285.8598074,1921.417766,35.15,67537.83449,86,63,49,23,14,12,3,male
140 ms,16200 KB,Egypt,AsiaAfrica,73,346,378.8670746,2141.679297,33.40277778,71538.03764,53,41,39,12,2,13,2,male
124 ms,6400 KB,Sweden,Europe,38,240,184.2797931,1259.502603,17.5,22041.29556,69,49,38,20,11,8,2,male
186 ms,15700 KB,China,Asia,83,553,446.8336245,3525.396806,47.05434783,165885.2475,55,13,10,42,3,9,2,male
404 ms,27000 KB,India,Asia,65,340,327.8032081,2047.605056,40.11111111,82131.71393,60,55,52,5,3,12,3,male
187 ms,15700 KB,China,Asia,83,553,446.8336245,3525.396806,47.05434783,165885.2475,55,13,10,42,3,9,2,male
93 ms,18200 KB,India,Asia,53,289,254.5835556,1655.369011,28.19444444,46672.20963,62,52,46,10,6,14,3,male
156 ms,17700 KB,India,Asia,53,289,254.5835556,1655.369011,28.19444444,46672.20963,62,52,46,10,6,14,3,male
108 ms,21800 KB,India,Asia,53,289,254.5835556,1655.369011,28.19444444,46672.20963,62,52,46,10,6,14,3,male
108 ms,18200 KB,India,Asia,53,289,254.5835556,1655.369011,28.19444444,46672.20963,62,52,46,10,6,14,3,male
607 ms,19300 KB,Iran,Asia,78,516,412.5946318,3243.267545,84,272434.4738,47,35,32,12,3,18,3,male
156 ms,17700 KB,India,Asia,53,289,254.5835556,1655.369011,28.19444444,46672.20963,62,52,46,10,6,14,3,male
576 ms,29400 KB,India,Asia,51,334,243.5249056,1894.590064,38.28125,72527.2759,85,80,77,5,3,15,2,male
108 ms,18200 KB,Vietnam,Asia,53,289,254.5835556,1655.369011,28.19444444,46672.20963,62,52,46,10,6,14,3,male
93 ms,18200 KB,India,Asia,53,289,254.5835556,1655.369011,28.19444444,46672.20963,62,52,46,10,6,14,3,male
140 ms,17700 KB,India,Asia,53,289,254.5835556,1655.369011,28.19444444,46672.20963,62,52,46,10,6,14,3,male
108 ms,18200 KB,Unknown,Unknown,53,289,254.5835556,1655.369011,28.19444444,46672.20963,62,52,46,10,6,14,3,male
108 ms,18200 KB,India,Asia,53,289,254.5835556,1655.369011,28.19444444,46672.20963,62,52,46,10,6,14,3,male
93 ms,18200 KB,India,Asia,53,289,254.5835556,1655.369011,28.19444444,46672.20963,62,52,46,10,6,14,3,male
108 ms,18200 KB,India,Asia,53,289,254.5835556,1655.369011,28.19444444,46672.20963,62,52,46,10,6,14,3,male
108 ms,18200 KB,India,Asia,53,289,254.5835556,1655.369011,28.19444444,46672.20963,62,52,46,10,6,14,3,male
93 ms,18200 KB,India,Asia,53,289,254.5835556,1655.369011,28.19444444,46672.20963,62,52,46,10,6,14,3,male
93 ms,18200 KB,India,Asia,53,289,254.5835556,1655.369011,28.19444444,46672.20963,62,52,46,10,6,14,3,male
108 ms,18200 KB,India,Asia,53,289,254.5835556,1655.369011,28.19444444,46672.20963,62,52,46,10,6,14,3,male
109 ms,18200 KB,Romania,Europe,53,289,254.5835556,1655.369011,28.19444444,46672.20963,62,52,46,10,6,14,3,male
109 ms,18200 KB,Ukraine,Europe,53,289,254.5835556,1655.369011,28.19444444,46672.20963,62,52,46,10,6,14,3,male
109 ms,18200 KB,Singapore,Asia,53,289,254.5835556,1655.369011,28.19444444,46672.20963,62,52,46,10,6,14,3,male
108 ms,21800 KB,India,Asia,53,289,254.5835556,1655.369011,28.19444444,46672.20963,62,52,46,10,6,14,3,male
108 ms,21800 KB,India,Asia,53,289,254.5835556,1655.369011,28.19444444,46672.20963,62,52,46,10,6,14,3,male
109 ms,18200 KB,India,Asia,53,289,254.5835556,1655.369011,28.19444444,46672.20963,62,52,46,10,6,14,3,male
93 ms,18200 KB,India,Asia,53,289,254.5835556,1655.369011,28.19444444,46672.20963,62,52,46,10,6,14,3,male
109 ms,18200 KB,India,Asia,53,289,254.5835556,1655.369011,28.19444444,46672.20963,62,52,46,10,6,14,3,male
93 ms,18200 KB,India,Asia,53,289,254.5835556,1655.369011,28.19444444,46672.20963,62,52,46,10,6,14,3,male
108 ms,21800 KB,India,Asia,53,289,254.5835556,1655.369011,28.19444444,46672.20963,62,52,46,10,6,14,3,male
109 ms,18200 KB,Iran,Asia,53,289,254.5835556,1655.369011,28.19444444,46672.20963,62,52,46,10,6,14,3,male
62 ms,11600 KB,China,Asia,73,450,378.8670746,2785.421051,41.83783784,116535.9943,77,0,-11,77,11,0,3,male
124 ms,16200 KB,Unknown,Unknown,55,304,271.4804827,1757.533353,38.66666667,67957.95631,65,49,40,16,9,12,3,male
93 ms,18300 KB,India,Asia,48,343,229.1368501,1915.642138,21,40228.48489,93,87,87,6,0,14,1,male
124 ms,15300 KB,India,Asia,59,279,290.8572701,1641.257411,36.15909091,59346.37592,49,44,44,5,0,10,2,male
171 ms,18600 KB,Brazil,South America,69,309,352.7497745,1887.534057,26.59375,50196.60883,59,44,36,15,8,11,3,male
390 ms,18500 KB,India,Asia,64,415,320.7232379,2490,50.14285714,124855.7143,75,70,70,5,0,19,2,male
561 ms,17600 KB,India,Asia,53,358,252.9035678,2050.595523,28.05,57519.20441,54,47,42,7,5,14,2,male
124 ms,27000 KB,Taiwan,Asia,64,392,321.6326782,2352,48.96153846,115157.5385,56,37,37,19,0,10,3,male
608 ms,16600 KB,Ukraine,Europe,80,455,426.079159,2876.477283,70.55813953,202958.8855,61,44,34,17,10,17,3,male
109 ms,21100 KB,India,Asia,0,0,0,0,0,0,61,40,37,21,3,12,2,male
93 ms,17200 KB,Bangladesh,Asia,67,340,339.9564924,2062.470325,38.23333333,78855.11542,63,51,50,12,1,9,2,male
592 ms,26400 KB,India,Asia,39,288,187.5249056,1522.195839,21.875,33298.03398,60,57,57,3,0,16,3,male
155 ms,18200 KB,Vietnam,Asia,49,264,232.8278745,1482.283399,38.75,57438.48171,67,49,33,18,16,12,4,male
592 ms,17600 KB,Bangladesh,Asia,57,287,278.3559659,1674.039434,36.85714286,61700.31057,63,57,53,6,4,12,4,male
280 ms,12700 KB,Syria,Asia,58,439,284.2247957,2571.653657,38.45454545,98891.77244,75,69,68,6,1,28,2,male
93 ms,18200 KB,India,Asia,53,289,254.5835556,1655.369011,28.19444444,46672.20963,64,52,44,12,8,14,3,male
124 ms,23100 KB,India,Asia,59,304,289.0701413,1788.323487,42.16,75395.71821,64,51,42,13,9,12,3,male
420 ms,18200 KB,India,Asia,50,288,239.420269,1625.430583,25.71428571,41796.78641,60,45,41,15,4,13,2,male
358 ms,21800 KB,India,Asia,58,300,284.9884404,1757.394299,29.95238095,52638.14351,64,55,55,9,0,12,3,female
109 ms,12000 KB,China,Asia,67,474,339.5249056,2875.326276,38.28125,110071.084,55,0,0,55,0,0,3,female
124 ms,21800 KB,India,Asia,60,284,297.5287411,1677.556929,30.22727273,50707.97081,58,52,52,6,0,13,3,male
576 ms,7700 KB,Armenia,Europe,56,357,271.0812322,2073.225707,44.81818182,92918.20669,64,53,50,11,3,15,2,male
390 ms,18200 KB,India,Asia,50,260,242.4407955,1467.402609,28.5,41820.97437,69,65,64,4,1,12,3,male
467 ms,19400 KB,Croatia,Europe,56,420,269.6764904,2439.089067,45.88,111905.4064,87,72,62,15,10,17,2,male
560 ms,17600 KB,India,Asia,51,263,240.7106228,1491.847865,27.78947368,41457.66698,56,51,51,5,0,10,2,male
436 ms,26000 KB,China,Asia,52,385,254.2364029,2194.669291,28.5,62548.07481,60,51,51,9,0,19,2,male
545 ms,21500 KB,Georgia,AsiaEurope,58,345,283.0128366,2021.003443,38.95833333,78734.92581,64,52,50,12,2,14,1,male
124 ms,19200 KB,Egypt,AsiaAfrica,60,306,296.7916995,1807.508522,41.82608696,75601.00863,58,40,31,18,9,11,4,male
545 ms,21500 KB,India,Asia,45,318,208.1057163,1746.409285,40.61538462,70931.08479,89,56,31,33,25,16,3,male
140 ms,16700 KB,China,Asia,69,344,353.7585727,2101.332413,43.44827586,91299.27036,63,49,42,14,7,12,2,male
124 ms,19600 KB,China,Asia,81,550,433.2506894,3486.917502,44,153424.3701,55,41,38,14,3,17,2,female
561 ms,18600 KB,Unknown,Unknown,53,321,256.7497745,1838.662466,37,68030.51124,100,54,19,46,35,14,3,male
108 ms,27000 KB,India,Asia,42,280,201.6270751,1509.848878,21,31706.82645,69,51,47,18,4,14,3,male
561 ms,18500 KB,Peru,South America,49,336,229.4868683,1886.542508,22.58823529,42613.66605,75,66,64,9,2,11,1,male
561 ms,14600 KB,India,Asia,51,341,244.720659,1934.297042,34.8,67313.53705,81,79,79,2,0,17,2,male
109 ms,19200 KB,Unknown,Unknown,59,351,289.5640056,2064.80771,35.72916667,73773.85882,74,43,31,31,12,14,3,male
608 ms,23500 KB,Egypt,AsiaAfrica,45,293,209.4845559,1609.112957,41.25,66375.90949,54,46,41,8,5,17,3,male
374 ms,12700 KB,India,Asia,42,287,199.17639,1547.5951,32.5,50296.84076,60,46,37,14,9,14,2,male
577 ms,15700 KB,India,Asia,44,273,200.5096868,1490.424832,33.21428571,49503.3962,50,43,38,7,5,10,2,male
374 ms,15200 KB,Iran,Asia,62,340,307.9068682,2024.426746,46.66666667,94473.24812,50,42,38,8,4,13,2,female
77 ms,11800 KB,China,Asia,66,380,333.6312234,2296.869765,45.93103448,105497.6044,70,0,0,70,0,0,2,female
124 ms,15300 KB,Poland,Europe,65,310,327.8032081,1866.934022,38,70943.49284,65,44,29,21,15,10,2,male
327 ms,22500 KB,China,Asia,51,330,242.4606049,1871.900363,27,50541.3098,83,67,67,16,0,13,3,female
139 ms,20200 KB,India,Asia,61,316,302.7888745,1874.112999,33.14583333,62119.0371,45,30,29,15,1,9,2,male
108 ms,27000 KB,India,Asia,49,254,231.5770955,1426.1363,34,48488.63421,69,51,38,18,13,13,2,male
405 ms,22100 KB,Iran,Asia,62,353,310.1726115,2101.831298,47.47826087,99791.29465,77,48,35,29,13,9,2,female
436 ms,16600 KB,China,Asia,75,404,392.2479866,2516.442751,52,130855.023,58,0,-5,58,5,0,2,male
62 ms,13700 KB,Unknown,Unknown,77,520,405.551932,3258.729001,56.02564103,182572.3812,56,48,45,8,3,26,1,male
374 ms,19200 KB,Bangladesh,Asia,48,271,226.2767055,1513.524838,36.42857143,55135.54766,67,50,45,17,5,14,3,male
592 ms,17600 KB,India,Asia,63,439,314.1308434,2624.025886,56.25,147601.4561,67,62,59,5,3,19,3,male
560 ms,25700 KB,India,Asia,51,356,246.0527434,2019.383422,23.78571429,48032.4771,52,30,29,22,1,10,2,male
109 ms,27000 KB,India,Asia,49,303,234.2230164,1701.257083,30.46153846,51822.90806,70,52,50,18,2,13,3,male
109 ms,19600 KB,Tajikistan,Asia,53,282,255.6041684,1615.273568,41.29411765,66701.29676,78,57,44,21,13,13,3,male
186 ms,18700 KB,Bangladesh,Asia,61,313,301.7363383,1856.320787,40.38461538,74966.801,59,52,47,7,5,11,3,male
93 ms,6800 KB,China,Asia,79,411,420.1071259,2590.853888,37.77777778,97876.70242,51,38,36,13,2,21,3,male
124 ms,23100 KB,India,Asia,40,307,201.4212455,1633.831925,19,31042.80658,76,58,52,18,6,12,2,female
62 ms,16500 KB,Unknown,Unknown,96,658,540.5307358,4332.905325,57.9,250875.2183,34,29,29,5,0,24,2,female
607 ms,19500 KB,India,Asia,62,353,310.1726115,2101.831298,33.06521739,69497.50877,56,50,46,6,4,15,2,male
124 ms,18200 KB,India,Asia,62,333,309.4603455,1982.747371,38,75344.40011,71,61,57,10,4,13,3,male
374 ms,18200 KB,India,Asia,55,295,265.9634675,1705.501115,27.125,46261.71776,81,66,56,15,10,12,3,male
108 ms,44500 KB,India,Asia,70,350,359.4212455,2145.249056,33.84375,72603.27274,62,44,41,18,3,10,3,male
514 ms,10800 KB,China,Asia,58,370,283.5668306,2167.452968,36.52173913,79159.15188,73,61,60,12,1,22,2,male
499 ms,10800 KB,China,Asia,58,370,283.5668306,2167.452968,36.52173913,79159.15188,73,61,60,12,1,22,2,male
701 ms,13100 KB,India,Asia,50,369,239.420269,2082.582934,27,56229.73922,112,75,45,37,30,17,2,male
389 ms,18200 KB,India,Asia,59,294,290.8572701,1729.497057,33.63636364,58173.9919,59,54,53,5,1,13,2,female
483 ms,20500 KB,Bangladesh,Asia,60,301,295.1851693,1777.974069,39.23076923,69751.29041,59,49,44,10,5,11,3,male
576 ms,21500 KB,India,Asia,57,293,278.3559659,1709.036774,33.42857143,57130.65788,76,54,46,22,8,9,2,male
93 ms,18200 KB,Malaysia,Asia,53,296,254.5835556,1695.464455,28.19444444,47802.67837,67,56,49,11,7,14,3,male
592 ms,30300 KB,Kuwait,Asia,72,451,372.2746801,2782.636176,35.94285714,100015.8945,81,71,70,10,1,8,2,male
358 ms,15700 KB,India,Asia,50,247,235.05865,1394.032479,29.33333333,40891.61938,62,48,36,14,12,9,2,male
561 ms,22500 KB,Lebanon,Asia,62,327,310.1726115,1947.022193,39.84782609,77584.60175,59,44,36,15,8,12,2,male
452 ms,16600 KB,China,Asia,75,402,392.2479866,2503.985114,52,130207.2259,59,0,-5,59,5,0,2,male
592 ms,20600 KB,Unknown,Unknown,59,305,290.159225,1794.20613,43.82608696,78633.03387,62,51,46,11,5,14,2,male
93 ms,10000 KB,Poland,Europe,72,399,372.5956925,2461.800076,44.31818182,109102.5033,60,41,33,19,8,16,3,male
93 ms,10000 KB,Poland,Europe,73,400,379.3421297,2475.929824,45.45454545,112542.2647,60,41,33,19,8,16,3,male
577 ms,39600 KB,Bangladesh,Asia,57,330,278.3559659,1924.853705,44.57142857,85793.47941,58,54,52,4,2,10,2,male
109 ms,31900 KB,Turkey,AsiaEurope,46,291,219.336581,1607.356529,30.6,49185.10979,56,36,36,20,0,10,2,male
561 ms,17600 KB,India,Asia,68,391,347.0121354,2380.197971,55.13793103,131239.1916,73,67,65,6,2,17,3,male
93 ms,11800 KB,China,Asia,77,520,405.6268983,3258.729001,64.32432432,209615.5412,53,6,6,47,0,4,1,male
109 ms,27900 KB,India,Asia,65,386,327.8032081,2324.633976,40.11111111,93243.6517,65,46,44,19,2,14,2,female
561 ms,21500 KB,India,Asia,55,269,264.5725015,1555.185763,28.5,44322.79424,80,64,50,16,14,10,2,male
124 ms,18900 KB,Egypt,AsiaAfrica,53,279,256.7497745,1598.089807,26.59375,42499.2008,57,53,51,4,2,12,2,male
545 ms,17600 KB,India,Asia,61,439,301.7363383,2603.593691,53.84615385,140193.5064,69,63,63,6,0,16,1,male
93 ms,18200 KB,India,Asia,56,285,270.5069309,1655.096153,29.41304348,48681.4151,59,40,38,19,2,11,3,male
109 ms,29900 KB,India,Asia,34,255,162,1297.303025,16,20756.84839,83,70,68,13,2,9,2,male
109 ms,24500 KB,China,Asia,66,467,333.1049912,2822.732054,54.75806452,154567.3439,75,49,36,26,13,21,4,male
93 ms,20400 KB,India,Asia,62,329,310.1726115,1958.930586,43.23913043,84702.45513,82,54,39,28,15,13,2,male
390 ms,18900 KB,India,Asia,58,287,284.2247957,1681.240546,36,60524.65964,68,51,47,17,4,11,3,male
545 ms,25100 KB,Ukraine,Europe,73,407,380.0574174,2519.258595,44.03225806,110928.6446,74,52,44,22,8,17,2,male
77 ms,10800 KB,China,Asia,93,550,517.9616502,3596.537346,61.11607143,219806.2333,46,0,-2,46,2,0,2,male
577 ms,26400 KB,Unknown,Unknown,56,251,273.4603973,1457.646085,28.23684211,41159.32236,52,28,28,24,0,9,2,male
405 ms,74100 KB,India,Asia,40,253,197.504662,1346.447808,24.66666667,33212.37926,58,48,45,10,3,11,3,male
561 ms,19300 KB,Vietnam,Asia,82,412,439.3544556,2619.311426,34.28571429,89804.96317,38,22,22,16,0,14,3,male
576 ms,21500 KB,India,Asia,69,361,352.582306,2205.177329,34.90909091,76980.73585,73,55,51,18,4,9,2,female
93 ms,33700 KB,South Korea,Asia,50,395,240.8554909,2229.323195,24.19230769,53932.47268,59,46,39,13,7,24,1,male
389 ms,18600 KB,India,Asia,64,347,321.6326782,2082,35.80769231,74551.61538,80,62,57,18,5,15,3,male
109 ms,22600 KB,Moldova,Asia,67,405,340.3026944,2456.766122,73.37931034,180275.8037,74,65,65,9,0,17,3,male
561 ms,21300 KB,Bangladesh,Asia,57,317,277.6324012,1849.026134,31.81818182,58832.64973,65,48,42,17,6,12,3,male
93 ms,19200 KB,India,Asia,66,381,335.0885565,2302.914159,33.84615385,77944.78694,74,51,46,23,5,10,2,male
93 ms,23100 KB,Egypt,AsiaAfrica,54,305,263.4212455,1755.240688,34.4375,60446.1012,48,40,40,8,0,9,2,male
93 ms,20200 KB,Unknown,Unknown,52,316,251.3531335,1801.338951,32.06666667,57762.93569,73,49,39,24,10,13,3,female
109 ms,30400 KB,South Korea,Asia,72,551,372.3949821,3399.628676,59.23529412,201378.0045,54,45,43,9,2,22,1,male
124 ms,15300 KB,Unknown,Unknown,66,311,334.0271833,1879.806571,42.75,80361.73092,63,42,33,21,9,13,3,male
109 ms,25000 KB,India,Asia,44,274,217.740327,1495.884264,23.4,35003.69177,72,49,43,23,6,10,2,male
156 ms,16100 KB,Kazakhstan,AsiaEurope,71,378,366.1306865,2324.604411,44.484375,103408.5744,64,39,32,25,7,13,4,male
389 ms,75100 KB,China,Asia,41,376,204.176133,2014.439554,19,38274.35152,50,35,31,15,4,19,2,male
109 ms,26000 KB,India,Asia,37,315,181.5249056,1640.97781,17.5,28717.11168,77,58,58,19,0,13,2,male
577 ms,30400 KB,China,Asia,66,466,333.3240179,2816.68766,64.8,182521.3603,53,49,49,4,0,19,3,male
530 ms,21500 KB,India,Asia,49,262,228.6387356,1471.053979,29.27777778,43069.1915,72,67,64,5,3,11,3,male
420 ms,23000 KB,India,Asia,49,323,235.7693245,1813.55128,33.91666667,61509.61423,87,61,50,26,11,16,2,male
124 ms,15300 KB,Brazil,South America,53,308,256.7497745,1764.1995,39.3125,69355.09284,73,42,28,31,14,9,2,male
389 ms,50500 KB,China,Asia,51,274,243.5249056,1554.244544,32.8125,50998.64909,64,57,54,7,3,12,2,male
171 ms,17700 KB,Malaysia,Asia,55,341,267.8084246,1971.443662,37,72943.41551,78,53,45,25,8,15,4,male
108 ms,20200 KB,Unknown,Unknown,53,324,258.0246044,1855.846227,32.93333333,61119.20242,73,51,43,22,8,14,3,female
109 ms,8400 KB,Croatia,Europe,62,289,310.1726115,1720.762734,37.30434783,64191.93154,70,40,22,30,18,8,2,female
93 ms,18600 KB,Tunisia,Africa,72,323,373.2397178,1992.885775,42.32258065,84344.06895,60,52,49,8,3,13,2,female
124 ms,16100 KB,China,Asia,66,344,333.3240179,2079.271577,55.2,114775.7911,48,45,45,3,0,12,1,female
639 ms,17600 KB,India,Asia,69,368,352.582306,2247.937,30.54545455,68664.25746,56,48,44,8,4,12,2,female
109 ms,16100 KB,China,Asia,66,344,333.3240179,2079.271577,55.2,114775.7911,48,45,45,3,0,12,1,female
61 ms,11800 KB,China,Asia,94,545,522.4078007,3572.250924,40.48,144604.7174,46,32,32,14,0,21,3,female
109 ms,36400 KB,Kazakhstan,AsiaEurope,53,342,256.7497745,1958.948795,26.59375,52095.79453,72,44,36,28,8,10,2,female
545 ms,22500 KB,India,Asia,56,287,272.5558619,1666.710863,36.9,61501.63083,69,57,50,12,7,12,3,female
733 ms,32100 KB,China,Asia,53,397,259.4336554,2273.98442,36.21428571,82350.72151,52,37,32,15,5,16,2,female
93 ms,10800 KB,China,Asia,69,456,353.0013311,2785.487152,64.96774194,180966.8105,74,0,-6,74,6,0,2,female
78 ms,11800 KB,China,Asia,82,487,439.460071,3096.127826,51.69767442,160062.6083,60,0,-3,60,3,0,2,female
639 ms,19600 KB,China,Asia,80,450,428.700868,2844.867643,33.98387097,96679.61489,43,30,30,13,0,22,8,female
139 ms,12300 KB,Finland,Europe,83,529,446.8336245,3372.395859,67.9673913,229212.949,74,57,47,17,10,16,3,female
93 ms,18200 KB,India,Asia,0,0,0,0,0,0,83,71,71,12,0,14,3,female
482 ms,25400 KB,China,Asia,57,302,280.1318683,1761.532784,38,66938.2458,62,45,43,17,2,12,3,female
436 ms,17500 KB,Romania,Europe,64,354,320.7232379,2124,27.64285714,58713.42857,67,55,52,12,3,21,1,female
514 ms,19500 KB,Egypt,AsiaAfrica,60,346,296.1564001,2043.784146,37.5,76641.90548,68,57,49,11,8,16,2,female
155 ms,35200 KB,Japan,Asia,70,431,359.2147805,2641.72098,38.12121212,100705.6059,50,48,48,2,0,26,3,female
530 ms,27300 KB,India,Asia,45,314,211.0274844,1724.441872,20.09090909,34645.60489,87,82,81,5,1,18,4,female
576 ms,21500 KB,India,Asia,64,319,320.7232379,1914,35.35714286,67673.57143,72,55,52,17,3,12,3,female
140 ms,15700 KB,Finland,Europe,77,535,406.0022373,3352.730799,59.58333333,199766.8768,64,53,53,11,0,17,2,female
109 ms,17600 KB,China,Asia,103,658,588.8198034,4399.717347,73.07258065,321498.7006,56,34,34,22,0,20,3,female
140 ms,1000 KB,Bangladesh,Asia,63,380,314.9612072,2271.366371,35.57692308,80808.22666,58,51,50,7,1,19,1,female
639 ms,30200 KB,India,Asia,49,331,235.7693245,1858.468958,26.20833333,48707.37395,72,61,55,11,6,18,2,female
1154 ms,19500 KB,China,Asia,77,499,405.551932,3127.126484,73.89473684,231078.1886,79,55,35,24,20,21,3,female
93 ms,19200 KB,Russia,AsiaEurope,56,279,272.5558619,1620.252023,28.8,46663.25827,85,55,36,30,19,14,3,female
529 ms,11700 KB,India,Asia,79,539,419.0808777,3397.737823,57.46341463,195245.6174,90,69,68,21,1,18,2,female
93 ms,11800 KB,China,Asia,84,504,453.2640759,3221.727981,51.13333333,164737.6908,69,0,-3,69,3,0,2,female
405 ms,42100 KB,India,Asia,70,487,359.7107722,2984.960829,41.51612903,123924.0189,79,60,56,19,4,20,2,female
93 ms,28800 KB,China,Asia,86,641,469.3966019,4119.235708,40.53846154,166987.4783,85,76,75,9,1,21,1,female
109 ms,30900 KB,India,Asia,67,378,340.3026944,2292.981714,41.93103448,96147.09532,86,61,58,25,3,11,3,female
546 ms,17500 KB,China,Asia,63,424,316.1697866,2534.366688,40.625,102958.6467,85,64,60,21,4,19,3,female
436 ms,21100 KB,China,Asia,62,382,308.3287327,2274.502991,29.07692308,66135.54849,88,0,-12,88,12,0,3,female
62 ms,11800 KB,China,Asia,93,566,516.0824975,3701.163887,35.08653846,129861.0291,81,53,51,28,2,19,3,female
78 ms,11800 KB,China,Asia,86,595,466.9609738,3823.627529,77.39130435,295915.5218,60,54,54,6,0,21,4,female
109 ms,8400 KB,Croatia,Europe,77,352,405.551932,2205.908862,33.86842105,74710.65015,74,45,28,29,17,8,2,female
109 ms,13700 KB,China,Asia,81,550,432.6080183,3486.917502,47.35714286,165130.4503,96,61,59,35,2,23,2,female
499 ms,13900 KB,China,Asia,74,451,385.5385456,2800.463468,64.38888889,180318.7311,80,63,52,17,11,21,3,female
124 ms,27000 KB,India,Asia,37,296,181.5249056,1541.998196,17.5,26984.96843,75,54,49,21,5,12,2,female
576 ms,19600 KB,India,Asia,56,288,273.4603973,1672.518218,34.07894737,56997.66031,79,68,60,11,8,11,2,female
1684 ms,24500 KB,China,Asia,67,566,339.6973857,3433.406482,37.74193548,129583.4059,95,80,80,15,0,24,4,female
374 ms,21100 KB,Kazakhstan,AsiaEurope,57,324,277.0156616,1889.856365,41.39130435,78223.61996,75,60,55,15,5,14,3,female
577 ms,30300 KB,India,Asia,47,381,219.7679748,2116.298352,23.57142857,49884.17545,85,73,67,12,6,17,1,female
124 ms,14900 KB,South Korea,Asia,85,503,459.8067162,3223.923641,62.45238095,201341.7074,75,50,46,25,4,20,1,female
233 ms,17600 KB,Unknown,Unknown,76,529,398.842491,3305.153655,79,261107.1387,62,41,39,21,2,23,3,female
358 ms,67000 KB,China,Asia,67,407,339.9564924,2468.898301,47.48333333,117231.521,83,50,42,33,8,13,2,female
561 ms,23400 KB,India,Asia,55,373,267.8084246,2156.447173,49.33333333,106384.7272,64,53,52,11,1,18,1,female
530 ms,20600 KB,Bangladesh,Asia,58,462,283.0128366,2706.38722,32.58333333,88183.11691,80,76,76,4,0,23,3,female
109 ms,32600 KB,India,Asia,41,363,208.1306865,1944.791378,19.5,37923.43186,100,53,30,47,23,11,2,female
78 ms,34300 KB,China,Asia,78,516,412.2983693,3243.267545,44.175,143271.3438,58,53,53,5,0,23,4,female
373 ms,21800 KB,India,Asia,64,453,322.9162238,2718,57.5,156285,82,52,44,30,8,13,3,female
779 ms,9800 KB,Iran,Asia,67,453,339.9564924,2747.938403,45.63333333,125397.5891,102,69,51,33,18,14,4,female
405 ms,18200 KB,Belarus,Europe,52,266,252.7242144,1516.316965,29.85714286,45272.89224,89,51,32,38,19,13,2,female
405 ms,18200 KB,Belarus,Europe,52,266,252.7242144,1516.316965,29.85714286,45272.89224,89,51,32,38,19,13,2,female
218 ms,233900 KB,China,Asia,103,717,590.1306865,4794.220878,56.3671875,270236.7471,88,73,73,15,0,31,4,female
546 ms,17500 KB,India,Asia,67,416,340.3026944,2523.493103,49.13793103,123999.2301,93,83,77,10,6,23,4,female
217 ms,32300 KB,Unknown,Unknown,43,371,221.6596322,2013.144224,20.5,41269.45659,98,82,76,16,6,19,2,female
686 ms,20700 KB,Bangladesh,Asia,69,447,354.26557,2730.510432,47.58928571,129943.0411,84,65,54,19,11,19,8,female
529 ms,27300 KB,Georgia,AsiaEurope,54,356,259.4122985,2048.739951,55.25,113192.8823,79,73,70,6,3,16,1,female
545 ms,26300 KB,China,Asia,49,383,239.3499675,2150.43387,25.35,54513.49861,79,69,65,10,4,17,4,female
358 ms,15600 KB,China,Asia,76,489,399.1845378,3055.236554,39.82857143,121685.7073,85,16,5,69,11,10,1,female
140 ms,23100 KB,India,Asia,60,431,300.3702549,2545.869847,45.31578947,115368.102,93,67,64,26,3,13,3,female
576 ms,22500 KB,Russia,AsiaEurope,59,523,288.6764386,3076.622315,82.5,253821.341,79,64,57,15,7,19,2,female
389 ms,22000 KB,China,Asia,67,513,341.2590864,3111.903755,37.03703704,115255.6946,94,63,62,31,1,19,2,female
93 ms,17600 KB,China,Asia,74,476,386.9094701,2955.699802,61.72580645,182442.9539,88,63,55,25,8,20,5,female
171 ms,19600 KB,China,Asia,91,627,502.5535519,4080.387239,57.75,235642.3631,67,56,55,11,1,22,3,female
93 ms,14700 KB,Serbia,Europe,74,458,385.8508604,2843.929641,40.58823529,115430.0854,77,61,58,16,3,22,2,female
577 ms,18600 KB,Russia,AsiaEurope,64,516,320.4063545,3096,80.86206897,250348.9655,85,78,74,7,4,27,2,female
670 ms,14900 KB,Armenia,Europe,78,520,412.2983693,3268.409154,68.42105263,223627.9947,87,73,68,14,5,22,2,female
389 ms,21800 KB,India,Asia,64,502,322.9162238,3012,57.5,173190,85,47,41,38,6,12,3,female
109 ms,15700 KB,Ukraine,Europe,71,430,365.8862514,2644.391261,50.09090909,132459.9623,76,59,51,17,8,12,1,female
623 ms,26000 KB,China,Asia,90,605,494.3950605,3927.571123,59.46808511,233565.1338,78,58,58,20,0,19,5,female
436 ms,28700 KB,India,Asia,57,310,277.0156616,1808.195904,30.30434783,54796.19762,68,52,43,16,9,10,3,female
358 ms,11800 KB,China,Asia,80,584,426.3322913,3692.006007,74.86363636,276396.9952,68,58,58,10,0,21,3,female
108 ms,26400 KB,India,Asia,78,403,412.2613731,2533.017094,43,108919.7351,68,46,30,22,16,15,1,female
421 ms,26000 KB,China,Asia,74,515,386.1246381,3197.868483,50.31818182,160910.9278,105,42,21,63,21,14,3,female
546 ms,28000 KB,China,Asia,84,582,453.2640759,3720.32874,46.73076923,173853.8238,67,47,44,20,3,37,10,female
389 ms,26000 KB,China,Asia,74,514,386.1246381,3191.65903,50.31818182,160598.4794,105,42,21,63,21,14,3,female
420 ms,26000 KB,China,Asia,74,515,386.1246381,3197.868483,50.31818182,160910.9278,105,42,21,63,21,14,3,female
404 ms,26000 KB,China,Asia,73,513,379.6596322,3175.379999,51.25,162738.2249,106,42,20,64,22,14,3,female
405 ms,26600 KB,India,Asia,50,340,242.4407955,1918.911105,22.16666667,42535.86282,82,60,58,22,2,12,3,female
77 ms,15900 KB,China,Asia,66,532,334.5126491,3215.617671,35.38888889,113797.1365,68,41,36,27,5,26,2,female
109 ms,30700 KB,Belarus,Europe,43,366,221.6596322,1986.0129,20.5,40713.26445,114,54,25,60,29,14,3,female
78 ms,11400 KB,China,Asia,86,542,466.7930215,3483.035497,67.42222222,234833.9933,77,39,29,38,10,18,2,female
592 ms,21300 KB,Unknown,Unknown,21,52,75.60964047,228.400506,14.4,3288.967286,104,87,83,17,4,27,3,female
639 ms,19400 KB,India,Asia,74,435,386.1246381,2701.112214,34.16666667,92288.00065,78,50,41,28,9,12,2,female
156 ms,15200 KB,Russia,AsiaEurope,64,484,325.5680503,2904,46.07142857,133791.4286,165,98,38,67,60,21,7,female
389 ms,26000 KB,India,Asia,50,443,240.8554909,2500.228292,35.57692308,88950.42962,91,47,35,44,12,9,2,female
421 ms,25700 KB,China,Asia,144,852,900.2346001,6108.776101,56.5,345145.8497,61,45,45,16,0,46,10,female
389 ms,21500 KB,Bangladesh,Asia,62,414,310.1726115,2465.037273,50.86956522,125395.3743,89,76,76,13,0,22,2,female
342 ms,15300 KB,China,Asia,82,616,440.5905816,3916.252035,48.34285714,189322.8127,86,59,53,27,6,28,6,female
530 ms,24400 KB,South Korea,Asia,89,683,487.7378322,4422.925933,67.90625,300344.3142,104,96,93,8,3,30,2,female
436 ms,28300 KB,India,Asia,63,437,315.5176503,2612.071327,51.68,134991.8462,94,72,67,22,5,20,2,female
732 ms,55400 KB,India,Asia,49,597,237.4749933,3351.981777,24.18181818,81057.01388,85,53,42,32,11,9,2,female
436 ms,43100 KB,Russia,AsiaEurope,77,599,405.551932,3753.805138,85.18421053,319764.9271,100,70,58,30,12,23,6,female
296 ms,9800 KB,Iran,Asia,61,362,303.4631705,2146.926916,49.56521739,106412.8993,81,54,43,27,11,11,1,female
217 ms,97900 KB,Unknown,Unknown,92,624,508.9533246,4070.702661,90.03921569,366522.8749,89,66,56,23,10,21,5,female
655 ms,117500 KB,South Korea,Asia,92,733,508.6701412,4781.770914,72.24,345435.1308,101,76,65,25,11,27,2,female
78 ms,14300 KB,Lithuania,Europe,75,569,392.9423377,3544.197835,100.5454545,356352.9823,89,67,49,22,18,27,3,female
62 ms,18500 KB,China,Asia,82,718,439.3192644,4564.722339,86,392566.1212,70,55,51,15,4,32,3,female
62 ms,11800 KB,China,Asia,105,668,600.8285737,4485.116006,79.4137931,356180.0745,79,57,49,22,8,27,5,female
421 ms,15700 KB,China,Asia,95,558,530.851908,3665.979429,50.90909091,186631.68,91,71,71,20,0,19,2,female
577 ms,15700 KB,Ukraine,Europe,75,465,392.4020294,2896.400691,36.57142857,105925.511,96,54,48,42,6,11,3,female
140 ms,12700 KB,China,Asia,81,752,433.6087556,4767.567202,66.95652174,319219.717,115,103,102,12,1,29,3,female
202 ms,24500 KB,Russia,AsiaEurope,72,440,372.3949821,2714.767001,42.47058824,115297.7514,91,52,43,39,9,13,2,female
124 ms,29400 KB,Vietnam,Asia,80,647,425.7903187,4090.287477,50.46153846,206402.1989,113,82,82,31,0,33,6,female
108 ms,6900 KB,China,Asia,85,511,460.4869215,3275.198768,40.0212766,131077.6358,125,77,67,48,10,13,2,female
62 ms,12800 KB,China,Asia,104,831,594.2093292,5568.065406,107.1610169,596679.5513,77,8,-2,69,10,11,3,female
62 ms,12800 KB,China,Asia,104,831,594.2093292,5568.065406,107.1610169,596679.5513,77,8,-2,69,10,11,3,female
156 ms,27400 KB,Bulgaria,Europe,75,502,392.9423377,3126.866983,80.18181818,250717.8799,104,73,51,31,22,23,4,female
93 ms,13700 KB,China,Asia,95,758,533.19324,4979.950551,49.72881356,247647.0325,124,92,91,32,1,25,3,female
249 ms,48000 KB,China,Asia,62,651,307.9068682,3876.181798,82.96296296,321579.527,106,68,58,38,10,19,3,female
78 ms,15000 KB,China,Asia,85,620,459.8067162,3973.82238,54.69767442,217358.8428,116,80,80,36,0,20,3,female
638 ms,75300 KB,Georgia,AsiaEurope,56,529,273.4603973,3072.090754,114.8947368,352967.0587,94,74,67,20,7,17,2,female
234 ms,112700 KB,China,Asia,97,670,545.3518546,4421.941604,49.8245614,220321.301,93,70,67,23,3,28,4,female
390 ms,5900 KB,Israel,Asia,76,456,398.9944238,2849.054946,47.77777778,136121.5141,81,59,54,22,5,7,2,female
78 ms,14800 KB,China,Asia,82,505,439.3192644,3210.563762,45,144475.3693,80,66,61,14,5,20,1,female
592 ms,15600 KB,India,Asia,60,425,296.7916995,2510.428503,40.2173913,100962.8855,122,76,49,46,27,14,3,female
358 ms,15300 KB,China,Asia,83,614,447.1829761,3914.274211,46.34722222,181415.7367,93,59,53,34,6,28,6,female
607 ms,29300 KB,Vietnam,Asia,85,557,459.8067162,3570.030751,56.82142857,202854.2473,95,72,70,23,2,18,2,female
233 ms,35500 KB,South Korea,Asia,73,807,379.3421297,4995.188419,52.12121212,260355.2752,77,60,56,17,4,47,3,female
639 ms,75300 KB,Georgia,AsiaEurope,56,539,273.4603973,3130.164303,114.8947368,359639.4039,96,74,67,22,7,17,2,female
358 ms,16600 KB,Antarctica,Antarctica,111,730,645.065676,4959.923582,82.6171875,409774.9366,85,56,56,29,0,28,6,female
124 ms,28000 KB,India,Asia,79,473,419.7398968,2981.688294,45.88571429,136816.8971,107,52,25,55,27,13,4,female
109 ms,6900 KB,China,Asia,85,535,460.4869215,3429.024151,40.0212766,137233.924,129,81,71,48,10,14,2,female
155 ms,33800 KB,Croatia,Europe,81,642,432.536756,4070.183702,53.65853659,218400.1011,123,89,81,34,8,28,5,female
124 ms,22100 KB,India,Asia,79,643,419.0078103,4053.331021,69.225,280591.8399,109,93,92,16,1,27,2,female
374 ms,13300 KB,Russia,AsiaEurope,80,556,425.7903187,3514.992021,69.38461538,243886.3694,95,68,54,27,14,21,1,female
171 ms,45000 KB,China,Asia,109,868,631.6688991,5874.783994,70.06153846,411596.4047,76,0,-3,76,3,0,1,female
1029 ms,7800 KB,Syria,Asia,59,415,290.159225,2441.296865,32.86956522,80244.36654,102,68,51,34,17,16,5,female
327 ms,16600 KB,China,Asia,81,765,432.536756,4849.985252,99.02439024,480266.8323,104,83,75,21,8,23,4,female
389 ms,17000 KB,China,Asia,85,456,459.8067162,2922.682267,43,125675.3375,91,47,35,44,12,19,2,female
389 ms,34800 KB,Bangladesh,Asia,52,348,252.7242144,1983.753022,29.85714286,59229.19737,102,61,56,41,5,12,2,female
374 ms,17100 KB,China,Asia,85,462,459.8067162,2961.138612,43,127328.9603,91,47,35,44,12,19,2,female
623 ms,27400 KB,India,Asia,51,404,250.9308716,2291.659838,30.90909091,70833.12227,116,61,41,55,20,23,2,female
93 ms,9900 KB,Russia,AsiaEurope,101,698,573.5532717,4647.431615,64.77966102,301059.0446,110,72,61,38,11,17,2,female
171 ms,20100 KB,Poland,Europe,58,572,295.2391057,3350.765129,41.53846154,139185.6284,107,66,55,41,11,13,5,female
155 ms,26400 KB,Russia,AsiaEurope,71,596,366.1306865,3665.249283,91.40625,335026.6923,105,85,79,20,6,29,2,female
124 ms,28000 KB,India,Asia,69,559,354.8592943,3414.665171,41.22222222,140760.0865,152,75,33,77,42,15,2,female
78 ms,14700 KB,China,Asia,130,800,787.9470571,5617.89425,94.375,530188.7699,130,92,75,38,17,26,12,female
171 ms,17600 KB,Iran,Asia,82,630,440.20115,4005.257763,81.77777778,327541.0793,109,62,48,47,14,15,4,female
78 ms,23500 KB,China,Asia,82,690,439.3544556,4386.710883,41.9047619,183824.0751,80,59,57,21,2,29,2,female
155 ms,32900 KB,Russia,AsiaEurope,82,697,439.3192644,4431.213747,65,288028.8936,81,61,56,20,5,28,2,female
124 ms,14900 KB,India,Asia,0,0,0,0,0,0,106,75,68,31,7,20,2,female
155 ms,127200 KB,China,Asia,109,599,631.1333893,4054.142411,45,182436.4085,92,75,71,17,4,20,6,female
576 ms,26400 KB,Iran,Asia,55,462,266.8279228,2670.988188,61.57894737,164476.641,89,63,54,26,9,16,1,female
1512 ms,27500 KB,Russia,AsiaEurope,79,599,419.2271063,3775.964668,54.48648649,205739.0479,123,66,52,57,14,16,3,female
358 ms,21500 KB,Unknown,Unknown,56,444,274.4798955,2578.465585,71.77777778,185076.5298,85,65,65,20,0,16,3,female
452 ms,80200 KB,China,Asia,79,572,419.0078103,3605.762588,51.79487179,186760.011,95,60,56,35,4,19,5,female
280 ms,12800 KB,China,Asia,92,736,508.9533246,4801.3416,82.40196078,395639.9622,111,58,48,53,10,17,3,female
124 ms,29400 KB,India,Asia,41,442,197.7269405,2368.037986,21.6,51149.6205,115,77,76,38,1,16,2,female
592 ms,31200 KB,Russia,AsiaEurope,80,603,426.079159,3812.122641,73.56976744,280456.9762,107,66,52,41,14,18,4,female
1887 ms,88000 KB,Bangladesh,Asia,66,602,336.5164318,3638.72526,63,229239.6914,117,68,36,49,32,22,3,female
140 ms,26000 KB,India,Asia,103,703,586.2775517,4700.609871,53.71428571,252489.9016,84,58,58,26,0,26,8,female
405 ms,17200 KB,India,Asia,73,677,378.9461511,4190.511226,42.36842105,177545.3441,170,113,91,57,22,22,4,female
607 ms,28400 KB,Iran,Asia,55,446,266.8279228,2578.486432,61.57894737,158780.4803,90,62,53,28,9,16,1,female
1263 ms,21100 KB,Russia,AsiaEurope,69,552,354.26557,3371.9055,33.67857143,113560.9602,103,89,83,14,6,25,1,female
155 ms,17200 KB,Russia,AsiaEurope,68,462,346.3298602,2812.407833,36.40322581,102380.7174,124,57,47,67,10,14,4,female
109 ms,20500 KB,Bangladesh,Asia,102,762,579.6081201,5084.388111,84.86842105,431503.991,119,112,107,7,5,30,4,female
139 ms,19200 KB,Unknown,Unknown,73,579,378.9461511,3583.90842,28.09210526,100679.5326,135,79,61,56,18,19,3,female
139 ms,160500 KB,China,Asia,89,751,487.7378322,4863.275807,54.66666667,265859.0774,124,81,55,43,26,27,6,female
389 ms,14300 KB,Kazakhstan,AsiaEurope,79,608,419.0078103,3832.698695,68.20512821,261409.7059,99,81,75,18,6,26,3,female
483 ms,10800 KB,Romania,Europe,55,476,265.9634675,2751.927224,21,57790.4717,99,92,92,7,0,28,1,female
155 ms,18500 KB,Japan,Asia,87,752,473.9427998,4845.093509,104.575,506675.6537,133,92,82,41,10,28,5,female
62 ms,11900 KB,China,Asia,106,824,608.4972857,5543.806455,53.66666667,297517.6131,119,83,81,36,2,48,9,female
140 ms,26000 KB,Russia,AsiaEurope,84,696,453.092115,4449.052926,106.3636364,473217.4476,126,80,53,46,27,21,5,female
108 ms,13800 KB,China,Asia,79,753,420.1071259,4746.746903,76.76470588,364382.6299,124,78,72,46,6,25,1,female
77 ms,47000 KB,China,Asia,92,883,508.1677,5760.305207,47.5,273614.4973,108,34,32,74,2,20,5,female
514 ms,13700 KB,China,Asia,113,727,657.9932198,4958.270106,72.875,361333.934,106,81,78,25,3,31,7,female
202 ms,73300 KB,China,Asia,113,714,661.0808625,4869.607779,46.65441176,227188.6865,111,71,68,40,3,26,5,female
124 ms,10800 KB,Poland,Europe,91,850,501.2172393,5531.625444,136.9565217,757592.1804,131,90,61,41,29,30,3,female
218 ms,18200 KB,South Korea,Asia,69,734,354.26557,4483.656951,105.4285714,472705.5471,100,76,70,24,6,28,5,female
109 ms,26000 KB,India,Asia,95,786,531.8959763,5163.906508,123.6666667,638603.1048,84,54,54,30,0,19,8,female
93 ms,15600 KB,Japan,Asia,92,682,508.4501668,4449.069254,62.30612245,277204.2537,109,65,55,44,10,25,4,female
1528 ms,74300 KB,Iran,Asia,113,1061,660.5118257,7236.209879,144.5223881,1045794.332,105,50,47,55,3,28,6,female
93 ms,11800 KB,India,Asia,79,799,419.7398968,5036.720818,78.57142857,395742.35,144,101,98,43,3,36,2,female
1310 ms,22200 KB,Russia,AsiaEurope,92,753,508.1990654,4912.242153,100.5319149,493837.1101,120,97,89,23,8,28,7,female
607 ms,28300 KB,Unknown,Unknown,68,532,348.0415947,3238.530232,35.68518519,115567.551,137,82,57,55,25,22,2,female
374 ms,28800 KB,China,Asia,100,881,564.8477751,5853.237303,79.64814815,466199.5119,133,87,87,46,0,33,3,female
530 ms,11800 KB,Romania,Europe,68,601,346.1173001,3658.565168,59.625,218141.9481,116,85,66,31,19,35,1,female
139 ms,22500 KB,Iran,Asia,0,0,0,0,0,0,111,75,65,36,10,16,4,female
1512 ms,33800 KB,Ukraine,Europe,86,779,466.9609738,5006.060244,57.39130435,287304.327,160,135,124,25,11,34,5,female
109 ms,47000 KB,China,Asia,108,846,623.7020245,5714.634827,73.92857143,422474.789,119,88,86,31,2,26,4,female
545 ms,247500 KB,China,Asia,13,28,40.05374781,103.6123121,5.5,569.8677166,141,113,104,28,9,45,5,female
124 ms,16600 KB,India,Asia,88,712,480.9553238,4599.115312,66.66666667,306607.6875,142,77,59,65,18,23,9,female
529 ms,247500 KB,China,Asia,13,28,40.05374781,103.6123121,5.5,569.8677166,141,113,104,28,9,45,5,female
124 ms,14000 KB,Japan,Asia,93,678,516.0824975,4433.549674,70.3902439,312078.6429,121,82,71,39,11,31,7,female
499 ms,25500 KB,Serbia,Europe,68,642,351.1753143,3908.151144,51.84782609,202629.1408,162,116,94,46,22,23,8,female
545 ms,37100 KB,China,Asia,97,1030,546.4971854,6797.910227,70.84745763,481614.6568,199,131,109,68,22,31,9,female
233 ms,89000 KB,China,Asia,91,730,502.1708162,4750.690087,97.25490196,462027.8987,120,78,55,42,23,27,4,female
560 ms,247500 KB,China,Asia,13,28,40.05374781,103.6123121,5.5,569.8677166,143,113,105,30,8,45,5,female
748 ms,82300 KB,Russia,AsiaEurope,77,659,405.7769322,4129.81233,64.34722222,265741.9518,130,75,60,55,15,16,5,female
202 ms,21600 KB,Russia,AsiaEurope,88,739,480.5611817,4773.519966,66.19565217,315986.2673,129,86,79,43,7,28,5,female
124 ms,17200 KB,India,Asia,98,764,550.7131734,5053.638321,58.16037736,293921.5118,132,102,96,30,6,33,16,female
155 ms,245600 KB,China,Asia,109,884,630.6524852,5983.074943,70.82539683,423753.6571,151,107,97,44,10,27,8,female
390 ms,25000 KB,Russia,AsiaEurope,87,781,473.6107211,5031.93887,71.86666667,361628.6735,146,88,74,58,14,21,3,female
1559 ms,40400 KB,Singapore,Asia,106,966,608.1416159,6499.171159,59.34745763,385709.285,161,85,44,76,41,29,8,female
124 ms,20100 KB,Russia,AsiaEurope,82,913,440.20115,5804.44498,77.08695652,447446.9978,142,98,88,44,10,34,3,female
109 ms,14300 KB,Bangladesh,Asia,76,747,398.842491,4667.201853,62.5,291700.1158,131,109,95,22,14,35,1,female
561 ms,24400 KB,Bangladesh,Asia,72,523,373.6840496,3226.870776,37.1,119716.9058,127,65,55,62,10,16,2,female
124 ms,18900 KB,Russia,AsiaEurope,71,977,368.5969538,6008.302936,105.9259259,636435.0517,162,121,115,41,6,33,2,female
124 ms,22000 KB,India,Asia,81,703,433.2506894,4456.914552,41.25,183847.7253,164,97,71,67,26,23,3,female
202 ms,29800 KB,Russia,AsiaEurope,89,730,487.5430078,4727.285405,98.74468085,466794.2886,131,89,77,42,12,22,4,female
467 ms,41700 KB,Ukraine,Europe,73,792,379.6596322,4902.341051,64.703125,317196.7858,153,114,85,39,29,44,2,female
452 ms,106100 KB,China,Asia,130,1171,787.2923715,8223.192709,62.94303797,517592.731,159,131,125,28,6,51,14,female
140 ms,25000 KB,India,Asia,109,930,632.9053075,6294.411422,122.8656716,773367.087,119,83,77,36,6,25,9,female
109 ms,18200 KB,India,Asia,63,657,318.7159976,3927.07291,33,129593.406,216,141,111,75,30,36,13,female
93 ms,10400 KB,India,Asia,91,861,502.1708162,5603.211185,67.84313725,380139.4255,142,115,111,27,4,41,2,female
171 ms,18700 KB,Russia,AsiaEurope,92,962,508.1677,6275.666602,119,746804.3256,198,114,93,84,21,32,5,female
420 ms,17200 KB,Japan,Asia,103,728,587.7428202,4867.772384,49.09166667,238967.0593,166,88,70,78,18,25,10,female
763 ms,24400 KB,India,Asia,78,760,412.4094067,4776.905686,42.66216216,203793.125,191,136,109,55,27,20,3,female
93 ms,13700 KB,India,Asia,89,787,487.5430078,5096.40221,76.40425532,389386.8157,163,141,135,22,6,46,3,female
124 ms,18600 KB,United States,North America,97,1072,545.3518546,7075.106567,118.5964912,839082.8139,179,0,-11,179,11,0,3,female
358 ms,20600 KB,India,Asia,49,607,246.1288162,3408.128875,57,194263.3459,170,128,114,42,14,28,4,female
561 ms,22200 KB,Bangladesh,Asia,66,373,334.5126491,2254.559007,38.27777778,86299.50864,162,75,47,87,28,12,4,female
1746 ms,32900 KB,Russia,AsiaEurope,88,1041,480.4627738,6724.268315,118.0111111,793538.3753,161,138,126,23,12,45,8,female
546 ms,20100 KB,India,Asia,74,744,387.4217091,4619.833304,60.86666667,281193.8538,200,124,116,76,8,20,10,female
420 ms,13700 KB,Bangladesh,Asia,65,838,327.3557123,5046.744227,42.94642857,216739.6405,194,124,87,70,37,44,4,female
498 ms,25300 KB,India,Asia,84,645,453.2640759,4123.044738,38.56666667,159012.0921,157,101,82,56,19,26,3,female
1341 ms,35800 KB,South Korea,Asia,124,1250,742.9206911,8692.745388,125.0526316,1087050.686,132,104,99,28,5,37,11,female
405 ms,16800 KB,Belarus,Europe,81,736,432.75063,4666.129602,67.89473684,316805.6414,179,74,61,105,13,22,4,female
124 ms,21600 KB,Taiwan,Asia,93,1013,516.4569079,6624.167876,143.1,947918.423,173,104,78,69,26,39,4,female
139 ms,17600 KB,Russia,AsiaEurope,81,968,432.536756,6136.974803,91.7375,562990.726,170,123,116,47,7,49,1,female
577 ms,23200 KB,Bangladesh,Asia,78,517,413.5983953,3249.552947,51.13636364,166170.3212,172,99,72,73,27,19,4,female
576 ms,22200 KB,Bangladesh,Asia,71,384,366.8663501,2361.502894,45.1,106503.7805,172,63,36,109,27,13,4,female
514 ms,27400 KB,Bangladesh,Asia,119,931,705.3002761,6419.075338,66.25694444,425308.318,157,87,69,70,18,34,8,female
186 ms,36100 KB,India,Asia,111,1192,646.0634012,8098.943713,84.20454545,681967.874,168,114,104,54,10,33,1,female
467 ms,31200 KB,Bangladesh,Asia,114,905,668.0313232,6183.765463,62.91176471,389031.5978,156,88,72,68,16,28,8,female
108 ms,23500 KB,South Korea,Asia,108,1071,621.7684232,7234.484515,81.42105263,589039.3444,164,100,79,64,21,29,10,female
108 ms,20000 KB,India,Asia,84,843,453.092115,5388.723587,81.4,438642.1,158,107,106,51,1,32,2,female
373 ms,30700 KB,China,Asia,104,1309,593.2900757,8770.875591,102,894629.3103,193,143,143,50,0,56,4,female
140 ms,17200 KB,Unknown,Unknown,72,576,373.2397178,3553.876801,52.90322581,188011.5469,153,93,82,60,11,19,6,female
530 ms,31300 KB,Bangladesh,Asia,114,984,668.0313232,6723.563774,67.30882353,452555.1675,169,101,85,68,16,32,8,female
327 ms,9800 KB,Unknown,Unknown,84,950,452.9890166,6072.701552,68.69512195,417164.9737,227,151,118,76,33,47,1,female
514 ms,31300 KB,Bangladesh,Asia,115,996,675.0131492,6818.108091,68.77205882,468895.3307,170,102,86,68,16,34,8,female
77 ms,23500 KB,China,Asia,107,1022,615.8588276,6889.77926,175.704918,1210568.1,180,120,117,60,3,46,12,female
155 ms,10400 KB,France,Europe,99,1462,557.3718925,9692.119379,92.96875,901064.2235,219,101,47,118,54,59,30,female
342 ms,248500 KB,Bangladesh,Asia,84,636,455.7586984,4065.513881,44.64705882,181513.2374,211,79,57,132,22,18,3,female
327 ms,248500 KB,Bangladesh,Asia,84,636,455.7586984,4065.513881,44.64705882,181513.2374,211,79,58,132,21,18,3,female
234 ms,21600 KB,India,Asia,87,916,474.2088866,5901.736242,73.23076923,432188.6848,272,175,157,97,18,42,11,female
421 ms,27700 KB,Bangladesh,Asia,8,69,24,207,0,0,225,58,3,167,55,11,2,female
233 ms,21600 KB,India,Asia,87,913,474.2088866,5882.407412,72.61538462,427153.2767,277,180,162,97,18,42,11,female
140 ms,28300 KB,India,Asia,133,1288,811.3210823,9087.203777,85.54216867,777339.1183,310,218,183,92,35,50,15,female
405 ms,16700 KB,India,Asia,67,465,341.8710649,2820.731474,56.76923077,160130.756,209,99,90,110,9,21,2,female
1029 ms,26400 KB,Bangladesh,Asia,80,780,425.7903187,4931.103914,35.67073171,175896.0847,337,103,-52,234,155,18,2,female
561 ms,17600 KB,China,Asia,164,1616,1052.071719,11889.80404,85.40952381,1015502.501,263,176,154,87,22,56,26,female
93 ms,16600 KB,South Korea,Asia,142,1462,874.2613731,10452.93029,89.02564103,930578.8195,199,111,80,88,31,60,33,female
576 ms,17600 KB,Russia,AsiaEurope,115,656,677.5639846,4490.641473,51.95833333,233326.2466,99,60,52,39,8,30,11,female
670 ms,213300 KB,China,Asia,309,7406,2358.546156,61258.45518,550,33692150.35,133,86,84,47,2,76,14,female
139 ms,16000 KB,China,Asia,153,1877,966.216349,13622.11698,79.13265306,1077954.257,411,265,221,146,44,73,43,female
343 ms,15600 KB,Bangladesh,Asia,49,373,235.7693245,2094.286772,30.83333333,64573.84213,276,60,15,216,45,27,17,female
108 ms,115600 KB,China,Asia,11,26,38.05374781,89.94522208,0,0,188,103,102,85,1,83,41,female
93 ms,119500 KB,China,Asia,11,26,38.05374781,89.94522208,0,0,190,104,103,86,1,83,41,female
545 ms,29400 KB,China,Asia,159,2006,1021.070351,14669.64321,94.43636364,1385347.76,327,225,194,102,31,62,18,female
109 ms,13700 KB,China,Asia,176,3507,1165.513992,26160.22669,98.55426357,2578201.876,381,141,84,240,57,130,92,female
