time,memory,country,continent,program_vocabulary,program_length,calculated_estimated_program_length,volume,difficulty,effort,loc,slocP,lsloc,comments,blankLine,cyclomatic_complexity,numberOfFunction,gender
1029 ms,13200 KB,China,Asia,47,251,217.5800856,1394.201802,53.28125,74284.81475,36,32,32,4,0,12,3,male
811 ms,13400 KB,Iran,Asia,51,223,240.7106228,1264.950851,39.57894737,50065.42317,39,34,34,5,0,11,3,male
311 ms,14200 KB,Finland,Europe,52,249,244.9233738,1419.40949,30.89130435,43847.41054,32,26,26,6,0,10,3,male
810 ms,15300 KB,Poland,Europe,50,223,235.05865,1258.57993,41.77777778,52580.67264,39,34,34,5,0,11,3,male
764 ms,15300 KB,Latvia,Europe,51,225,240.7106228,1276.295702,41.26315789,52663.99107,38,33,33,5,0,11,3,male
748 ms,19700 KB,France,Europe,53,233,252.9035678,1334.605466,39.6,52850.37645,41,36,36,5,0,11,3,male
748 ms,15500 KB,India,Asia,63,279,313.5800856,1667.661099,43.59375,72699.60102,40,28,24,12,4,11,3,male
779 ms,15300 KB,Iran,Asia,58,272,283.0128366,1593.370831,38.95833333,62075.07195,44,35,34,9,1,12,3,female
265 ms,19700 KB,India,Asia,57,248,276.0964047,1446.556724,38.4,55547.77818,43,31,24,12,7,11,3,male
733 ms,15300 KB,India,Asia,58,283,281.9620482,1657.808622,37.88888889,62812.52666,32,28,28,4,0,11,3,male
264 ms,14900 KB,China,Asia,73,324,379.3421297,2005.503157,37.5375,75281.57476,31,25,22,6,3,14,3,male
280 ms,16100 KB,China,Asia,54,241,258.1074956,1386.927888,39.27272727,54468.44069,38,32,32,6,0,11,3,female
264 ms,14200 KB,India,Asia,53,276,252.2386659,1580.906045,53.33333333,84314.98909,44,36,33,8,3,11,3,male
295 ms,15500 KB,Bangladesh,Asia,58,313,281.8126557,1833.548051,43.92857143,80545.14655,49,36,29,13,7,12,3,male
311 ms,14100 KB,China,Asia,60,314,294.6059378,1854.763647,46.85714286,86908.92517,43,37,36,6,1,12,3,female
483 ms,14000 KB,Iran,Asia,58,288,282.5614107,1687.098527,50.82,85738.34712,51,41,37,10,4,11,3,male
296 ms,15300 KB,Iran,Asia,60,263,294.8469685,1553.512227,47.05555556,73101.38089,38,30,27,8,3,11,3,male
264 ms,14200 KB,Finland,Europe,60,294,296.1564001,1736.625835,43.5,75543.22383,50,38,35,12,3,11,3,male
249 ms,16900 KB,Taiwan,Asia,61,314,300.7868035,1862.251524,51.66666667,96216.32874,42,31,24,11,7,13,3,male
1014 ms,14000 KB,China,Asia,54,243,258.1074956,1398.437663,37.09090909,51869.32423,45,39,38,6,1,11,3,female
280 ms,16100 KB,Bangladesh,Asia,50,251,235.05865,1416.607904,27.55555556,39035.41779,37,33,33,4,0,11,3,male
717 ms,16100 KB,India,Asia,47,269,215.9400989,1494.184401,40.27777778,60182.42727,50,42,42,8,0,11,3,male
780 ms,14200 KB,India,Asia,55,260,263.6191856,1503.153526,38.75,58247.19911,53,41,36,12,5,12,3,male
1029 ms,15200 KB,United States,America,46,277,209.0925853,1530.026662,44.76315789,68488.82505,38,29,24,9,5,10,3,male
810 ms,15300 KB,India,Asia,52,241,248.0323866,1373.805972,44.38888889,60981.72065,44,34,34,10,0,11,3,male
748 ms,16100 KB,Bangladesh,Asia,57,348,275.7915183,2029.845725,50.07692308,101648.4282,47,36,32,11,4,14,3,male
779 ms,16100 KB,India,Asia,64,295,320.1804545,1770,44.76666667,79237,50,42,40,8,2,14,3,male
763 ms,15500 KB,Indonesia,Asia,65,285,326.5538222,1716.374827,36.47058824,62597.19956,42,33,29,9,4,11,3,male
748 ms,15200 KB,India,Asia,51,292,238.9889445,1656.3482,37.56818182,62225.99033,55,47,47,8,0,11,3,male
779 ms,14200 KB,China,Asia,49,297,227.3200108,1667.568824,46.4,77375.19342,60,56,56,4,0,11,3,male
748 ms,14200 KB,India,Asia,57,295,276.504106,1720.702554,52.9375,91089.69146,51,41,36,10,5,12,3,male
218 ms,14100 KB,China,Asia,64,304,320.0450916,1824,37.79032258,68929.54839,48,35,34,13,1,12,3,male
748 ms,14200 KB,India,Asia,49,315,229.4868683,1768.633601,47.05882353,83229.81651,65,59,59,6,0,15,3,male
311 ms,15900 KB,China,Asia,54,307,257.6220106,1766.750463,41.7826087,73819.44327,45,38,38,7,0,11,3,male
264 ms,13400 KB,Vietnam,Asia,60,306,295.1851693,1807.508522,56.88461538,102819.4271,51,38,30,13,8,12,3,male
264 ms,14200 KB,Taiwan,Asia,57,287,277.0156616,1674.039434,53.2173913,89088.01162,49,41,40,8,1,13,3,male
358 ms,24600 KB,India,Asia,59,289,288.6764386,1700.083841,53.30769231,90627.54631,55,36,29,19,7,10,3,male
248 ms,14000 KB,China,Asia,65,324,326.4650059,1951.247171,45.890625,89543.95223,50,41,37,9,4,12,3,male
296 ms,14200 KB,China,Asia,56,265,271.0812322,1538.949054,51,78486.40177,41,33,33,8,0,11,3,male
311 ms,22700 KB,Mexico,America,35,223,164.7548875,1143.830113,16,18301.2818,38,31,31,7,0,8,3,male
1045 ms,30000 KB,Bangladesh,Asia,38,251,184.2797931,1317.229806,17.5,23051.5216,45,27,23,18,4,11,3,male
156 ms,12100 KB,China,Asia,66,388,333.1049912,2345.224918,38.08571429,89319.56617,43,39,39,4,0,11,4,male
311 ms,16100 KB,India,Asia,51,249,242.4606049,1412.43391,37,52260.05468,59,39,28,20,11,11,3,male
280 ms,16900 KB,Hong Kong,Asia,58,346,281.8126557,2026.861424,46.2,93640.9978,40,35,35,5,0,13,3,male
264 ms,16100 KB,China,Asia,53,258,252.2386659,1477.803477,36.57142857,54045.38431,44,38,38,6,0,11,3,female
296 ms,14200 KB,Syria,Asia,58,310,281.9620482,1815.974108,63.14814815,114675.402,46,31,22,15,9,11,3,male
249 ms,14100 KB,China,Asia,57,308,276.0964047,1796.530124,48,86233.44597,41,34,33,7,1,13,3,male
296 ms,22700 KB,India,Asia,36,218,171.2198934,1127.04365,16.5,18596.22023,41,30,27,11,3,11,3,male
296 ms,21100 KB,India,Asia,35,235,164.7548875,1205.381509,16,19286.10414,53,41,35,12,6,15,3,male
264 ms,12600 KB,India,Asia,54,258,257.6220106,1484.760976,51.2173913,76045.58388,41,36,36,5,0,11,3,male
763 ms,24700 KB,India,Asia,48,289,223.0669539,1614.054163,46.5,75053.51857,63,47,39,16,8,11,3,male
1029 ms,14000 KB,Iran,Asia,0,0,0,0,0,0,46,35,32,11,3,11,3,male
764 ms,28300 KB,India,Asia,51,268,242.4606049,1520.209992,35,53207.34971,60,45,39,15,6,11,3,male
764 ms,16100 KB,India,Asia,50,249,235.05865,1405.320191,31.11111111,43721.07262,59,48,45,11,3,9,3,male
249 ms,13400 KB,Argentina,America,53,246,251.2486429,1409.068432,30,42272.05295,53,37,26,16,11,11,3,male
732 ms,19700 KB,India,Asia,52,290,245.8187515,1653.127518,45.02380952,74430.0985,51,41,37,10,4,11,3,male
280 ms,13400 KB,Indonesia,Asia,54,309,258.1074956,1778.260238,55.27272727,98289.29316,50,39,35,11,4,14,3,male
1060 ms,21200 KB,India,Asia,34,209,158.3349731,1063.279734,15.5,16480.83587,76,47,25,29,22,12,3,male
748 ms,17800 KB,Bangladesh,Asia,50,237,233.6452798,1337.593917,34.5,46146.99014,54,42,38,12,4,12,3,male
794 ms,23000 KB,India,Asia,38,268,180.9737366,1406.444574,17,23909.55775,64,57,57,7,0,12,3,male
249 ms,12600 KB,India,Asia,52,244,247.1756287,1390.907291,49.5,68849.91092,59,47,41,12,6,10,3,male
312 ms,22300 KB,India,Asia,61,285,301.7363383,1690.260141,45.09615385,76224.23137,58,42,36,16,6,12,3,male
295 ms,13600 KB,South Korea,Asia,58,263,282.5614107,1540.649002,34.98,53891.90208,45,29,24,16,5,12,3,male
483 ms,15900 KB,Taiwan,Asia,49,273,231.5770955,1532.815787,36.26666667,55590.11922,68,49,36,19,13,11,3,male
311 ms,16100 KB,China,Asia,54,295,256.9778536,1697.691813,40.6,68926.28761,41,31,26,10,5,15,3,male
280 ms,21100 KB,India,Asia,44,249,212.401259,1359.398473,52.85714286,71853.91929,58,36,28,22,8,8,3,male
779 ms,14200 KB,India,Asia,51,295,239.4453837,1673.365476,43.57142857,72910.92431,74,49,34,25,15,8,3,male
265 ms,12800 KB,India,Asia,53,252,252.2386659,1443.435955,44.95238095,64885.88291,60,47,41,13,6,10,3,male
327 ms,22300 KB,India,Asia,59,321,290.159225,1888.328419,41.47826087,78324.57876,50,42,42,8,0,15,3,male
1029 ms,13200 KB,India,Asia,55,296,264.041925,1711.282475,57.04347826,97617.50467,53,37,32,16,5,11,3,male
249 ms,19000 KB,India,Asia,59,301,289.5640056,1770.675558,47.39583333,83922.64363,52,49,49,3,0,12,2,male
795 ms,24400 KB,Germany,Europe,60,318,294.4134357,1878.391209,50.5,94858.75607,48,33,26,15,7,13,3,male
265 ms,15500 KB,Peru,America,61,301,301.3556992,1785.151939,49.74074074,88794.77976,55,40,31,15,9,11,3,male
171 ms,12000 KB,China,Asia,75,430,392.9423377,2678.392037,39.67857143,106274.7698,38,0,0,38,0,0,3,female
249 ms,15900 KB,China,Asia,54,327,256.9778536,1881.848213,40.02,75311.56549,45,37,37,8,0,13,3,male
826 ms,11600 KB,India,Asia,51,327,239.4453837,1854.883087,36.42857143,67570.74102,62,54,53,8,1,13,3,male
264 ms,10000 KB,Turkmenistan,Asia,56,316,269.6764904,1835.124155,45.26,83057.71927,57,34,24,23,10,14,3,male
249 ms,12800 KB,India,Asia,55,258,264.041925,1491.590806,43.82608696,65370.58837,61,48,42,13,6,10,3,male
280 ms,15500 KB,Indonesia,Asia,58,299,283.5668306,1751.536318,51.73913043,90622.96599,55,40,32,15,8,12,3,male
280 ms,13600 KB,Vietnam,Asia,55,278,264.5725015,1607.218,36.75,59065.26151,46,39,39,7,0,14,3,male
264 ms,16200 KB,Bangladesh,Asia,65,355,326.4650059,2137.940574,56.24242424,120242.9607,51,34,25,17,9,11,3,male
841 ms,27100 KB,India,Asia,34,238,158.3349731,1210.816156,20.66666667,25023.5339,73,44,20,29,24,10,3,male
280 ms,14700 KB,Iran,Asia,0,0,0,0,0,0,50,38,38,12,0,14,3,female
452 ms,15900 KB,Poland,Europe,60,344,294.6059378,2031.970365,54.28571429,110306.9627,69,45,26,24,19,11,3,male
748 ms,31900 KB,India,Asia,58,291,281.9620482,1704.67247,43.05555556,73395.62022,53,29,15,24,14,12,3,male
311 ms,19200 KB,Syria,Asia,38,214,188.1173001,1123.056488,18,20215.01678,45,39,39,6,0,13,3,male
748 ms,13400 KB,Argentina,America,48,228,223.0669539,1273.37145,35.55882353,45279.59068,57,41,30,16,11,11,3,male
265 ms,14900 KB,Bangladesh,Asia,68,325,345.9899115,1978.425423,50.90909091,100719.8397,53,41,35,12,6,11,3,male
561 ms,26100 KB,India,Asia,40,244,191.1345461,1298.550455,24.5,31814.48615,61,47,47,14,0,11,3,male
1091 ms,30000 KB,Taiwan,Asia,41,265,197.7269405,1419.751281,18,25555.52306,48,27,23,21,4,11,3,male
295 ms,16100 KB,China,Asia,77,361,405.7769322,2262.309941,42.14634146,95348.08728,42,32,28,10,4,15,3,female
748 ms,14200 KB,India,Asia,56,343,269.4181505,1991.922738,52.5,104575.9438,89,60,38,29,22,13,3,male
234 ms,14000 KB,Bangladesh,Asia,65,299,326.4650059,1800.687976,38.78787879,69844.86695,45,34,30,11,4,12,3,male
795 ms,16100 KB,India,Asia,60,272,294.4615345,1606.674242,39.01724138,62687.99672,50,39,35,11,4,12,3,male
280 ms,12800 KB,India,Asia,55,263,264.041925,1520.497605,43.82608696,66637.46024,62,49,43,13,6,11,3,male
810 ms,16100 KB,India,Asia,52,290,245.3142135,1653.127518,36.81818182,60865.14954,57,41,32,16,9,11,3,male
249 ms,15900 KB,China,Asia,66,378,332.9300119,2284.780977,60.5,138229.2491,42,36,36,6,0,14,4,male
389 ms,20800 KB,India,Asia,39,237,190.8721876,1252.640326,24,30063.36782,57,48,48,9,0,12,3,male
280 ms,10900 KB,Italy,Europe,63,321,313.8551855,1918.706855,42.79310345,82107.42095,50,39,34,11,5,13,4,male
795 ms,16100 KB,India,Asia,49,300,228.6387356,1684.412953,48.22222222,81226.13574,59,42,34,17,8,12,3,male
186 ms,35200 KB,China,Asia,71,389,365.7235111,2392.251629,47.88235294,114546.6368,44,0,0,44,0,0,3,female
826 ms,13400 KB,Indonesia,Asia,59,239,288.3819626,1405.951689,24.88888889,34992.57537,47,38,38,9,0,12,3,male
748 ms,17800 KB,India,Asia,52,250,245.3142135,1425.10993,32.72727273,46639.96133,60,45,37,15,8,12,3,male
296 ms,26800 KB,Brazil,America,25,48,91.82263988,222.9050971,11.25,2507.682342,49,35,30,14,5,8,3,male
264 ms,14200 KB,Vietnam,Asia,57,312,275.7915183,1819.861684,63.78846154,116086.1771,46,32,24,14,8,11,3,male
748 ms,14200 KB,Bangladesh,Asia,53,251,252.9035678,1437.708034,36.3,52188.80164,60,44,34,16,10,12,3,male
249 ms,14200 KB,India,Asia,61,338,300.7868035,2004.58922,40.3,80784.94557,57,42,36,15,6,13,4,male
779 ms,17700 KB,India,Asia,47,362,217.5800856,2010.761164,64.90625,130510.9668,58,50,49,8,1,13,3,male
249 ms,12600 KB,Peru,America,41,229,197.7269405,1226.879409,21.6,26500.59524,61,44,33,17,11,12,3,male
265 ms,16900 KB,Poland,Europe,59,326,289.5640056,1917.741634,35.72916667,68519.31047,69,50,39,19,11,15,3,male
264 ms,20500 KB,Brazil,America,65,330,326.5538222,1987.381378,38.29411765,76105.01631,69,44,27,25,17,11,3,male
280 ms,15300 KB,Brazil,America,57,318,275.7915183,1854.859025,41.73076923,77404.69391,73,54,38,19,16,15,4,male
732 ms,16100 KB,Canada,America,60,330,294.8469685,1949.273897,46.44444444,90532.9432,51,40,36,11,4,11,3,male
748 ms,14200 KB,Brazil,America,65,366,326.4650059,2204.18662,51.046875,112516.8388,57,45,39,12,6,18,3,male
685 ms,11900 KB,Ukraine,Europe,66,312,332.9300119,1885.850965,41.5,78262.81506,72,54,44,18,10,15,3,male
280 ms,14500 KB,Canada,America,58,298,282.2114327,1745.678337,52.92307692,92386.66889,59,36,22,23,14,11,3,male
311 ms,20800 KB,Brazil,America,61,369,300.8814489,2188.442078,43.953125,96188.86819,54,44,39,10,5,12,3,male
748 ms,14200 KB,Brazil,America,72,366,372.2746801,2258.192551,51.08108108,115350.9168,55,31,22,24,9,17,3,male
280 ms,14200 KB,Brazil,America,73,367,378.9461511,2271.665613,50.19736842,114031.6357,55,31,22,24,9,17,3,male
280 ms,14500 KB,Canada,America,58,299,282.2114327,1751.536318,53.53846154,93774.55977,60,37,23,23,14,11,3,male
296 ms,14200 KB,Belarus,Europe,56,290,271.0812322,1684.132927,65.68181818,110616.9127,52,38,31,14,7,11,3,male
748 ms,16100 KB,United States,America,57,294,275.7915183,1714.869664,43.51923077,74629.80865,49,36,32,13,4,11,3,male
248 ms,14200 KB,Brazil,America,73,371,378.9461511,2296.424911,50.19736842,115274.4873,56,32,23,24,9,17,3,male
249 ms,14900 KB,Croatia,Europe,68,345,345.9474732,2100.17468,46.5,97658.12263,71,45,31,26,14,12,3,male
249 ms,16100 KB,Serbia,Europe,57,292,278.3559659,1703.203884,55.71428571,94892.78783,54,43,39,11,4,11,3,male
249 ms,16300 KB,Ukraine,Europe,56,295,271.0812322,1713.169702,51,87371.6548,53,41,35,12,6,11,3,male
1014 ms,40900 KB,Croatia,Europe,58,297,282.2114327,1739.820356,43.69230769,76016.7663,54,38,33,16,5,12,4,male
295 ms,16100 KB,Slovenia,Europe,57,336,276.0964047,1959.851045,45.44,89055.63147,60,47,41,13,6,16,4,male
249 ms,15300 KB,Brazil,America,80,374,427.0575866,2364.401107,52.10869565,123205.8577,55,29,18,26,11,10,3,male
233 ms,19200 KB,Canada,America,62,307,307.2067179,1827.938267,50.66666667,92615.53888,57,47,42,10,5,13,3,male
265 ms,16100 KB,Canada,America,59,314,288.3819626,1847.149917,53.33333333,98514.66227,65,37,20,28,17,11,3,male
296 ms,16100 KB,Colombia,America,62,322,307.2067179,1917.251212,49.06666667,94073.12613,53,37,37,16,0,12,3,male
311 ms,26600 KB,Ukraine,Europe,57,344,276.0964047,2006.514165,60.8,121996.0612,53,33,29,20,4,11,3,female
779 ms,32400 KB,Brazil,America,54,293,257.6220106,1686.182038,47.17391304,79543.80484,62,39,23,23,16,11,3,male
264 ms,13400 KB,Spain,Europe,58,307,281.8126557,1798.400166,41.78571429,75147.43549,72,36,16,36,20,12,3,male
249 ms,13600 KB,Romania,Europe,70,349,359.2147805,2139.119773,38.35135135,82038.13399,54,38,32,16,6,13,3,male
249 ms,14200 KB,Lithuania,Europe,60,309,294.8469685,1825.229194,46.44444444,84771.7559,56,43,37,13,6,12,3,male
748 ms,16800 KB,Switzerland,Europe,59,403,288.1860234,2370.705149,65.32142857,154857.847,64,58,54,6,4,14,3,male
264 ms,15300 KB,Ukraine,Europe,64,324,320.0450916,1944,53.75806452,104505.6774,61,43,31,18,12,14,3,male
249 ms,20500 KB,France,Europe,60,329,295.6213103,1943.367006,36.4,70738.55902,63,40,32,23,8,11,3,male
1029 ms,14000 KB,Cuba,America,62,305,307.9068682,1816.029875,49.25925926,89456.28642,59,44,36,15,8,15,3,male
312 ms,21200 KB,Belarus,Europe,65,327,326.7316235,1969.314275,50.75,99942.69945,55,37,32,18,5,13,3,male
265 ms,16100 KB,Brazil,America,70,345,359.0910367,2114.602641,41.82352941,88440.14574,79,40,18,39,22,12,3,male
312 ms,15300 KB,Belarus,Europe,57,265,276.504106,1545.715854,39.1875,60572.74002,66,46,32,20,14,15,3,male
810 ms,22400 KB,Belarus,Europe,33,253,151.9616054,1276.231712,15,19143.47568,48,43,43,5,0,12,3,male
280 ms,16100 KB,Mexico,America,52,337,247.1756287,1921.048185,36.47368421,70067.70485,59,38,35,21,3,9,3,female
296 ms,17200 KB,Ukraine,Europe,55,326,265.2124025,1884.723267,57.47619048,108326.7135,66,47,39,19,8,10,1,male
264 ms,15300 KB,Germany,Europe,45,314,214.6466251,1724.441872,22,37937.72119,64,32,21,32,11,9,3,male
264 ms,32400 KB,Brazil,America,55,305,264.041925,1763.314713,48.69565217,85865.75992,63,40,24,23,16,11,3,male
249 ms,16100 KB,Mexico,America,71,379,365.6422056,2330.754158,57.6,134251.4395,60,38,35,22,3,13,3,male
857 ms,22700 KB,Belarus,Europe,54,330,257.6220106,1899.112876,45.15217391,85749.07484,75,58,49,17,9,11,5,male
1107 ms,16000 KB,Romania,Europe,49,342,227.3200108,1920.230767,46.4,89098.70757,54,40,34,14,6,11,3,female
1076 ms,15400 KB,Bulgaria,Europe,57,308,276.504106,1796.530124,49.5,88928.24116,55,34,34,21,0,11,3,male
295 ms,16100 KB,Belarus,Europe,47,280,217.5800856,1555.284878,48.4375,75334.1113,61,56,56,5,0,11,3,male
265 ms,16100 KB,Serbia,Europe,61,301,302.2137048,1785.151939,43.92,78403.87314,57,44,44,13,0,11,3,male
342 ms,17000 KB,Brazil,America,64,346,320.4063545,2076,53.70689655,111495.5172,69,40,30,29,10,13,3,male
312 ms,17600 KB,Germany,Europe,50,278,235.05865,1568.992021,42.66666667,66943.65955,59,49,49,10,0,14,3,male
249 ms,16300 KB,Brazil,America,55,370,264.5725015,2139.103094,55.5,118720.2217,74,57,56,17,1,12,4,male
295 ms,17100 KB,United States,America,65,341,326.4650059,2053.627424,44.34375,91065.54109,61,49,44,12,5,13,3,male
733 ms,17600 KB,United States,America,68,359,346.6279634,2185.39916,42.23684211,92304.35926,58,38,28,20,10,14,3,male
342 ms,22700 KB,Belarus,Europe,56,335,270.5069309,1945.463899,48.06521739,93509.14523,76,59,50,17,9,11,5,male
264 ms,16100 KB,United States,America,73,382,378.8670746,2364.512981,56.43243243,133435.2191,64,35,23,29,12,11,3,male
498 ms,16000 KB,Cuba,America,57,325,278.3559659,1895.689255,54,102367.2197,61,44,34,17,10,12,3,male
795 ms,22700 KB,Ukraine,Europe,50,336,238.1282645,1896.33568,31.5,59734.57391,69,39,35,30,4,8,3,male
249 ms,13400 KB,Belarus,Europe,62,306,308.8461793,1821.984071,48.84,88985.70203,57,38,34,19,4,13,3,male
249 ms,17000 KB,Colombia,America,65,328,327.3557123,1975.336643,43.60714286,86138.78717,66,39,26,27,13,13,5,female
280 ms,16100 KB,Romania,Europe,57,295,277.0156616,1720.702554,56.17391304,96658.59565,64,48,39,16,9,12,3,male
1029 ms,15900 KB,Romania,Europe,45,271,209.4845559,1488.292189,33,49113.64224,66,51,46,15,5,12,3,male
795 ms,16100 KB,Ukraine,Europe,47,268,217.5800856,1488.629812,32.9375,49031.74444,95,47,14,48,33,11,3,male
1060 ms,14000 KB,Bosnia and Herzegovina,Europe,63,362,313.5800856,2163.775332,50.375,109000.1824,67,36,30,31,6,12,3,male
826 ms,20000 KB,Ukraine,Europe,55,323,265.9634675,1867.379187,59.5,111109.0617,48,45,44,3,1,9,1,male
295 ms,22700 KB,Belarus,Europe,51,301,249.1502365,1707.400028,52,88784.80145,56,44,44,12,0,14,3,male
764 ms,15400 KB,Romania,Europe,51,284,240.0186475,1610.968797,47.275,76158.54988,61,45,35,16,10,13,5,male
841 ms,15300 KB,Brazil,America,55,387,264.5725015,2237.386209,64.5,144311.4105,73,38,16,35,22,15,3,male
327 ms,14200 KB,Belarus,Europe,60,341,295.6213103,2014.249693,56,112797.9828,71,48,37,23,11,15,6,male
858 ms,13200 KB,Poland,Europe,50,298,233.1201147,1681.869145,32.45238095,54580.65819,60,45,39,15,6,13,3,female
280 ms,16100 KB,Mexico,America,69,398,352.4986422,2431.192734,55.07352941,133894.3645,56,33,31,23,2,10,3,male
623 ms,40200 KB,Serbia,Europe,60,356,296.1564001,2102.853052,40.5,85165.54861,70,51,40,19,11,15,3,male
764 ms,23200 KB,Belarus,Europe,49,361,227.9173406,2026.910254,58.42105263,118414.2306,57,52,52,5,0,12,3,male
265 ms,16100 KB,Poland,Europe,65,427,326.4650059,2571.551056,65.45454545,168319.7055,57,43,37,14,6,16,3,male
873 ms,75200 KB,Portugal,Europe,58,364,283.5668306,2132.305082,30.43478261,64896.24163,66,49,48,17,1,6,4,male
764 ms,23700 KB,Brazil,America,46,269,221.2790995,1485.838166,20.55555556,30542.22897,67,46,37,21,9,14,3,male
248 ms,18000 KB,United States,America,67,370,339.5249056,2244.453,56.328125,126425.8292,62,48,43,14,5,12,3,male
280 ms,16100 KB,Belarus,Europe,56,357,271.0812322,2073.225707,49.45454545,102530.435,78,58,48,20,10,11,5,male
748 ms,16100 KB,Argentina,America,54,289,260.2355283,1663.162488,46.97368421,78124.86951,73,54,42,19,12,12,3,male
264 ms,16100 KB,United States,America,53,285,252.9035678,1632.45733,47.025,76766.30592,60,38,27,22,11,11,3,male
280 ms,14100 KB,Croatia,Europe,76,392,398.842491,2449.187585,38,93069.12824,70,37,25,33,12,10,3,male
296 ms,23300 KB,Latvia,Europe,50,284,239.420269,1602.855158,20.57142857,32973.02039,61,46,46,15,0,11,2,male
249 ms,16100 KB,Peru,America,61,375,301.0709438,2224.026502,35.35714286,78635.22273,65,37,33,28,4,8,3,male
763 ms,19800 KB,Italy,Europe,57,328,277.0156616,1913.187925,36.95652174,70704.77113,68,59,59,9,0,12,3,male
436 ms,16000 KB,Brazil,America,61,433,301.3556992,2568.009267,59.81481481,153604.9988,64,39,34,25,5,11,3,male
265 ms,14200 KB,United States,America,61,374,300.7868035,2218.095764,52.74193548,116986.6637,61,38,38,23,0,14,3,male
296 ms,20400 KB,Belarus,Europe,54,320,263.4212455,1841.564001,45.125,83100.57553,65,43,36,22,7,12,4,male
795 ms,15900 KB,Belarus,Europe,42,309,193.2192809,1666.226084,52.8,87976.73722,68,46,41,22,5,15,3,male
1075 ms,16300 KB,Romania,Europe,64,395,320.1804545,2370,31.76470588,75282.35294,53,40,35,13,5,14,3,male
764 ms,15900 KB,Poland,Europe,52,382,246.4385619,2177.567972,61.6,134138.1871,62,49,44,13,5,12,3,male
780 ms,13400 KB,Romania,Europe,56,316,272.5558619,1835.124155,47.7,87535.42221,50,39,37,11,2,11,3,male
280 ms,15300 KB,Brazil,America,61,385,301.3556992,2283.333875,47.85185185,109261.7543,66,40,34,26,6,15,3,male
764 ms,16100 KB,Romania,Europe,55,300,265.9634675,1734.407914,45.5,78915.56009,66,44,30,22,14,16,3,female
249 ms,17200 KB,Colombia,America,64,344,322.2270913,2064,42.12,86935.68,67,43,33,24,10,15,5,male
1029 ms,12500 KB,Cuba,America,57,287,277.6324012,1674.039434,44.54545455,74570.84752,89,46,31,43,15,14,3,male
233 ms,16700 KB,United States,America,72,392,372.5956925,2418.610601,43.57692308,105395.6081,55,43,38,12,5,15,4,male
249 ms,16300 KB,Serbia,Europe,73,370,378.8670746,2290.235087,35.97222222,82384.84548,57,44,41,13,3,18,3,male
483 ms,64500 KB,Brazil,America,65,422,326.5538222,2541.439217,58.12903226,147731.4022,72,48,32,24,16,17,2,male
264 ms,23100 KB,Lithuania,Europe,69,364,352.582306,2223.502902,42.54545455,94599.94166,73,34,20,39,14,8,3,male
296 ms,19700 KB,Venezuela,America,77,425,407.1333893,2663.38428,34.48888889,91857.16449,67,25,16,42,9,7,3,male
265 ms,16900 KB,Brazil,America,68,418,345.9899115,2544.559468,44.78571429,113959.9133,78,50,35,28,15,15,4,male
810 ms,31300 KB,Czechia,Europe,40,373,194.1173001,1985.079179,22.5,44664.28154,96,58,37,38,21,8,3,male
311 ms,27200 KB,Ukraine,Europe,38,316,180.9737366,1658.345094,17,28191.8666,81,45,31,36,14,11,3,male
311 ms,27800 KB,Ukraine,Europe,80,479,426.079159,3028.203557,60.6627907,183699.2786,71,56,56,15,0,18,3,male
327 ms,24600 KB,Ukraine,Europe,67,387,339.9564924,2347.576517,57.35,134633.5132,71,44,38,27,6,12,4,male
327 ms,22700 KB,Ukraine,Europe,41,344,208.1306865,1842.99789,19.5,35938.45885,81,43,36,38,7,13,4,male
249 ms,15900 KB,United States,America,63,378,314.9612072,2259.411811,52.65384615,118966.7219,82,54,45,28,9,11,3,male
296 ms,20800 KB,Belarus,Europe,33,281,155.5800856,1417.474748,15.5,21970.85859,67,50,45,17,5,12,3,male
264 ms,16100 KB,Brazil,America,68,334,346.1173001,2033.212589,47.8125,97212.97691,71,42,30,29,12,11,3,male
311 ms,44700 KB,Ukraine,Europe,51,335,242.4606049,1900.26249,42,79811.02456,72,44,37,28,7,11,3,male
779 ms,13900 KB,Ukraine,Europe,83,495,446.1369639,3155.644519,73.21428571,231038.2594,78,40,22,38,18,17,6,female
436 ms,18500 KB,Cuba,America,87,387,474.942584,2493.419133,41.07,102404.7238,113,34,-18,79,52,14,3,male
248 ms,19700 KB,Belarus,Europe,50,341,235.9518742,1924.554961,69.88235294,134492.429,77,51,39,26,12,11,4,male
374 ms,21800 KB,Ukraine,Europe,57,534,276.504106,3114.763268,96.25,299795.9645,85,49,29,36,20,15,3,male
514 ms,41100 KB,Brazil,America,64,441,320,2646,49.5,130977,71,54,51,17,3,14,3,male
311 ms,14300 KB,Bulgaria,Europe,73,511,379.6596322,3163.00035,53.46341463,169104.7992,71,38,35,33,3,15,3,male
295 ms,16100 KB,United States,America,80,457,425.7903187,2889.121139,58.34615385,168569.1065,83,55,46,28,9,20,6,male
311 ms,22500 KB,Italy,Europe,42,292,196.9737366,1574.556687,27.625,43497.12849,70,48,37,22,11,11,3,male
280 ms,14400 KB,Poland,Europe,15,42,58.60335893,164.089405,0,0,85,48,30,37,18,16,3,male
327 ms,16100 KB,Belarus,Europe,70,451,361.711347,2764.306641,59.72222222,165090.5355,92,70,58,22,12,18,6,male
498 ms,41100 KB,Brazil,America,64,443,320,2658,49.5,131571,74,55,50,19,5,14,3,male
779 ms,16100 KB,Germany,Europe,51,334,240.7106228,1894.590064,48.84210526,92535.76735,82,59,51,23,8,13,4,female
342 ms,26100 KB,Bulgaria,Europe,63,427,314.9612072,2552.298527,61.90384615,157997.0954,87,65,54,22,11,14,3,male
218 ms,25100 KB,Mexico,America,55,349,265.9634675,2017.69454,60.375,121818.3079,76,47,37,29,10,13,3,male
342 ms,24600 KB,Belarus,Europe,0,0,0,0,0,0,76,43,42,33,1,11,3,male
327 ms,20500 KB,Cyprus,Europe,51,444,242.4606049,2518.556852,38,95705.16037,84,37,27,47,10,11,3,male
233 ms,16100 KB,Belarus,Europe,66,414,332.9300119,2502.379165,40.5,101346.3562,100,64,39,36,25,15,3,male
265 ms,24300 KB,Cuba,America,60,339,297.5287411,2002.435912,45.77272727,91656.95288,79,40,27,39,13,14,3,male
265 ms,10300 KB,Belarus,Europe,62,335,307.9068682,1994.655764,52.5,104719.4276,83,46,33,37,13,11,3,female
249 ms,16100 KB,Poland,Europe,71,405,366.1306865,2490.647583,53.625,133560.9767,91,54,37,37,17,17,4,male
280 ms,26300 KB,Belarus,Europe,37,284,181.5249056,1479.484756,17.5,25890.98323,97,41,16,56,25,11,3,female
264 ms,13400 KB,Colombia,America,85,530,460.2145365,3396.977196,58.07608696,197283.143,89,43,25,46,18,9,4,male
763 ms,15500 KB,United States,America,76,386,399.4510684,2411.70002,40.88095238,98592.59368,76,34,22,42,12,11,3,male
499 ms,16400 KB,Cuba,America,59,375,289.5640056,2205.991144,32.08333333,70775.54919,92,62,47,30,15,17,3,male
264 ms,20000 KB,Brazil,America,61,440,303.4631705,2609.524429,86.73913043,226347.8798,86,63,45,23,18,13,2,male
296 ms,28600 KB,Belarus,Europe,70,460,359.0498112,2819.470188,43.5,122646.9532,112,51,29,61,22,13,3,male
748 ms,19800 KB,Argentina,America,69,501,355.5408171,3060.370753,63.67307692,194863.2224,93,41,23,52,18,13,5,male
1045 ms,26600 KB,Brazil,America,61,396,302.7888745,2348.571986,44.70833333,105000.7392,84,39,30,45,9,11,3,male
265 ms,19700 KB,Romania,Europe,76,458,398.842491,2861.550801,63,180277.7005,85,59,51,26,8,16,3,male
265 ms,16900 KB,United States,America,49,425,248.8391595,2386.251684,25.08333333,59855.1464,67,36,30,31,6,14,5,male
296 ms,24600 KB,Ukraine,Europe,46,362,223.4212455,1999.529428,21.375,42739.94153,93,54,40,39,14,12,4,male
390 ms,28800 KB,Denmark,Europe,56,486,269.2634114,2822.374492,54.24074074,153087.6831,100,42,11,58,31,14,3,male
249 ms,16100 KB,Germany,Europe,65,459,327.3557123,2764.266826,54.17857143,149764.0277,104,54,33,50,21,10,5,male
795 ms,18000 KB,Belarus,Europe,74,436,385.4995491,2707.321667,48.5,131305.1009,79,53,53,26,0,18,3,male
264 ms,14700 KB,France,Europe,68,416,346.3298602,2532.384542,56.69354839,143569.8656,79,47,43,32,4,7,3,male
311 ms,29500 KB,Belarus,Europe,42,340,207.4212455,1833.387924,19,34834.37055,84,53,48,31,5,17,4,male
498 ms,26400 KB,Canada,America,58,367,282.5614107,2149.879025,55.44,119189.2932,94,46,25,48,21,12,4,male
249 ms,17700 KB,Brazil,America,78,557,412.2983693,3500.969036,56.05,196229.3145,100,64,51,36,13,19,5,male
249 ms,16100 KB,United States,America,68,511,346.3298602,3110.693512,41.77419355,129946.7128,113,52,18,61,34,14,3,male
264 ms,16100 KB,Greece,Europe,98,605,551.6892074,4001.899456,60.75,243115.3919,62,40,36,22,4,13,8,male
264 ms,13400 KB,Germany,Europe,82,531,439.8831639,3375.860114,57.16216216,192971.4633,86,45,34,41,11,15,5,male
280 ms,16100 KB,Canada,America,76,482,398.9944238,3011.501061,48.33333333,145555.8846,72,46,38,26,8,24,8,male
935 ms,17700 KB,Brazil,America,78,645,413.1887278,4054.084431,68.38636364,277244.0921,89,65,55,24,10,17,3,male
280 ms,13400 KB,Peru,America,67,416,339.5249056,2523.493103,38.28125,96602.47036,91,55,47,36,8,11,5,male
374 ms,28700 KB,United States,America,72,512,372.2746801,3159.001601,59.59459459,188259.4197,76,73,73,3,0,14,2,male
280 ms,14200 KB,United States,America,74,492,385.6555921,3055.051056,57.94285714,177018.3869,97,35,23,62,12,6,3,male
280 ms,14200 KB,United States,America,74,492,385.6555921,3055.051056,57.94285714,177018.3869,97,35,23,62,12,6,3,male
280 ms,19900 KB,Mexico,America,62,463,309.4603455,2756.792892,45.125,124400.2792,116,86,79,30,7,14,3,male
280 ms,14900 KB,United States,America,75,419,392.17102,2609.875031,50.63157895,132142.0937,107,54,39,53,15,15,3,male
280 ms,13400 KB,Peru,America,67,416,339.5249056,2523.493103,38.28125,96602.47036,91,55,47,36,8,11,5,male
295 ms,16100 KB,United States,America,70,531,361.0832696,3254.649282,59.25,192837.97,89,50,29,39,21,17,7,male
280 ms,16100 KB,Brazil,America,106,789,611.8071357,5308.329239,63.03030303,334585.6005,117,65,45,52,20,22,3,male
826 ms,18500 KB,Peru,America,106,666,611.8071357,4480.795023,63.63636364,285141.5014,86,45,45,41,0,21,5,male
280 ms,18500 KB,Peru,America,61,459,312.6872089,2722.208438,38.33333333,104351.3235,93,40,26,53,14,10,5,male
280 ms,36600 KB,Brazil,America,90,811,495.8441109,5264.892861,70.88461538,373199.9055,110,84,75,26,9,21,9,male
249 ms,11000 KB,United States,America,77,459,407.1333893,2876.455022,51.328125,147643.0429,93,52,40,41,12,15,6,male
280 ms,17700 KB,Brazil,America,78,557,412.2983693,3500.969036,56.05,196229.3145,120,64,51,56,13,19,5,male
732 ms,16100 KB,Guadeloupe,America,60,369,295.1851693,2179.64263,44.46153846,96910.26462,79,52,48,27,4,14,3,male
312 ms,22000 KB,Colombia,America,78,539,414.6457617,3387.831796,62.16129032,210591.9958,129,72,56,57,16,19,8,male
811 ms,22900 KB,Peru,America,47,580,230.1306865,3221.661534,21.9375,70675.1999,116,77,66,39,11,20,4,male
920 ms,45000 KB,United States,America,105,965,601.1597899,6479.246925,84.98305085,550626.1708,164,115,77,49,38,32,10,male
249 ms,15300 KB,United States,America,182,5891,1213.473346,44228.41823,943.7105263,41738823.84,79,53,36,26,17,35,15,male
264 ms,19000 KB,United States,America,182,5948,1213.473346,44656.36252,943.7105263,42142679.38,99,53,30,46,23,35,15,male
311 ms,20000 KB,United States,America,104,961,592.9567346,6439.122569,70.74,455503.5305,174,107,91,67,16,30,9,male
312 ms,16100 KB,Brazil,America,79,593,419.0808777,3738.141984,65.27631579,244012.1366,131,35,30,96,5,9,3,male
311 ms,27900 KB,United States,America,88,983,480.7253082,6349.621281,57.31707317,363941.7076,208,73,38,135,35,14,6,male
