time,memory,country,continent,program_vocabulary,program_length,calculated_estimated_program_length,volume,difficulty,effort,loc,slocP,lsloc,comments,blankLine,cyclomatic_complexity,numberOfFunction,gender
530 ms,19500 KB,India,Asia,55,224,263.6191856,1295.024576,26.47916667,34291.17158,35,28,25,7,3,10,2,male
389 ms,21100 KB,India,Asia,47,213,218.6033589,1183.127425,25.6,30288.06209,50,41,36,9,5,8,2,male
108 ms,20900 KB,India,Asia,46,242,217.5786534,1336.701993,35,46784.56977,45,36,29,9,7,10,2,male
108 ms,21800 KB,India,Asia,46,214,215.9932866,1182.042259,31.16666667,36840.31706,43,33,28,10,5,11,3,male
108 ms,18200 KB,United States,America,48,225,225.0683649,1256.616563,41.8,52526.57232,41,35,32,6,3,10,2,male
373 ms,21100 KB,India,Asia,48,221,225.0683649,1234.276713,25.3,31227.20083,54,40,30,14,10,10,2,male
561 ms,15700 KB,Bangladesh,Asia,51,211,240.7106228,1196.881747,23.57894737,28221.21172,35,33,33,2,0,10,2,male
592 ms,18600 KB,India,Asia,41,241,188.529325,1291.170033,26.66666667,34431.20088,58,56,56,2,0,10,2,male
499 ms,20600 KB,India,Asia,41,239,192.6252211,1280.454929,31.57142857,40425.79133,56,51,50,5,1,11,2,male
530 ms,26400 KB,India,Asia,41,235,190.4650059,1259.024721,26.8125,33757.60033,55,51,51,4,0,12,2,male
108 ms,11300 KB,China,Asia,77,403,405.7769322,2525.514976,41.70731707,105332.4539,35,30,30,5,0,20,2,male
108 ms,18200 KB,India,Asia,40,250,201.4212455,1330.482024,19,25279.15845,59,49,46,10,3,11,2,male
436 ms,16700 KB,Jordan,Asia,52,258,248.0323866,1470.713447,28.33333333,41670.21434,46,30,22,16,8,10,2,male
545 ms,23500 KB,Bangladesh,Asia,47,246,221.0794529,1366.428858,27.46153846,37524.23863,60,46,38,14,8,9,2,male
343 ms,16700 KB,China,Asia,56,315,271.0812322,1829.3168,27.81818182,50888.26736,38,35,35,3,0,15,5,male
343 ms,16700 KB,China,Asia,56,315,271.0812322,1829.3168,27.81818182,50888.26736,38,35,35,3,0,15,5,male
529 ms,18600 KB,India,Asia,41,225,192.6252211,1205.449201,38.85714286,46840.31181,52,40,40,12,0,10,2,male
561 ms,25500 KB,India,Asia,49,252,231.5770955,1414.906881,23.8,33674.78376,59,53,52,6,1,10,3,male
546 ms,18600 KB,India,Asia,43,238,203.5249056,1291.451012,26.25,33900.58906,68,58,50,10,8,12,2,male
530 ms,16500 KB,China,Asia,53,315,254.5835556,1804.294943,36.94444444,66658.67429,59,55,55,4,0,16,3,male
608 ms,24400 KB,India,Asia,66,304,333.1049912,1837.495812,41.77419355,76759.90571,56,53,53,3,0,14,3,male
592 ms,32300 KB,India,Asia,49,240,232.8278745,1347.530363,32.5,43794.73678,42,33,27,9,6,9,2,male
545 ms,18600 KB,India,Asia,58,295,284.2247957,1728.104394,36.81818182,63625.66176,59,54,53,5,1,13,3,male
77 ms,17600 KB,China,Asia,68,378,347.4830616,2301.060954,22.14285714,50952.06398,43,35,35,8,0,19,1,male
93 ms,14700 KB,Vietnam,Asia,67,323,340.7366244,1959.346809,40.39285714,79143.61573,53,42,35,11,7,18,1,male
109 ms,10800 KB,South Korea,Asia,79,406,419.2271063,2559.334984,45.80952381,117241.9169,39,33,31,6,2,21,1,male
62 ms,17600 KB,China,Asia,68,391,347.4830616,2380.197971,22.14285714,52704.38364,43,35,35,8,0,19,1,male
561 ms,24500 KB,China,Asia,70,407,359.0910367,2494.618188,54.52941176,136030.0624,48,44,44,4,0,14,2,male
420 ms,25000 KB,India,Asia,38,250,188.1173001,1311.981878,18,23615.67381,67,56,50,11,6,12,2,male
374 ms,15300 KB,Bangladesh,Asia,57,244,277.6324012,1423.225163,26.25,37359.66054,44,39,37,5,2,10,2,male
577 ms,17600 KB,India,Asia,50,286,235.9518742,1614.14287,33.97058824,54833.3828,98,80,72,18,8,12,2,male
93 ms,15300 KB,Iran,Asia,64,252,321.1317371,1512,33.57407407,50764,40,31,30,9,1,10,2,male
108 ms,15700 KB,Brazil,America,63,302,314.1308434,1805.138537,29.375,53025.94452,68,40,20,28,20,11,2,male
93 ms,11800 KB,China,Asia,68,475,345.9899115,2891.54485,71.59090909,207008.3245,50,45,45,5,0,18,2,male
560 ms,19600 KB,India,Asia,46,255,213.3029689,1408.508299,29.71428571,41852.81802,88,65,46,23,19,10,2,male
78 ms,19700 KB,India,Asia,46,250,217.5786534,1380.890489,23.86363636,32953.06849,43,39,38,4,1,13,2,male
109 ms,16600 KB,China,Asia,73,432,380.0574174,2674.004209,32.8452381,87828.30493,44,36,35,8,1,18,1,male
93 ms,10800 KB,China,Asia,70,475,359.0498112,2911.409433,48.5,141203.3575,30,23,21,7,2,15,1,male
93 ms,16500 KB,China,Asia,73,432,380.0574174,2674.004209,32.8452381,87828.30493,45,36,34,9,2,18,1,female
124 ms,15300 KB,Romania,Europe,61,263,302.7888745,1559.78392,35.45833333,55307.33816,35,30,27,5,3,10,2,male
78 ms,11300 KB,China,Asia,67,371,339.5249056,2250.51909,37.734375,84921.93127,61,48,44,13,4,18,2,male
109 ms,17200 KB,India,Asia,47,244,222.5444556,1355.31968,35,47436.18879,47,41,37,6,4,11,3,male
92 ms,19700 KB,India,Asia,51,271,243.5249056,1537.227268,25.15625,38670.87345,48,41,38,7,3,14,3,male
405 ms,9800 KB,Jordan,Asia,54,299,259.4122985,1720.711363,37.4,64354.60498,53,35,26,18,9,13,2,male
124 ms,16700 KB,Austria,Europe,71,330,365.8862514,2029.416549,38.57575758,78286.28083,62,52,47,10,5,15,2,male
560 ms,18600 KB,Ukraine,Europe,60,288,295.6213103,1701.184492,32.2,54778.14063,62,45,35,17,10,12,2,male
296 ms,22600 KB,India,Asia,48,290,226.2767055,1619.639125,26.71428571,43267.50234,65,53,46,12,7,14,3,male
109 ms,16900 KB,India,Asia,87,455,474.942584,2931.539291,48.84,143176.379,53,50,50,3,0,20,6,male
124 ms,18200 KB,India,Asia,48,265,226.2767055,1480.015063,30.35714286,44929.02869,57,50,50,7,0,13,2,male
389 ms,18200 KB,India,Asia,53,289,255.6041684,1655.369011,31.76470588,52582.30977,67,63,63,4,0,13,2,male
468 ms,18500 KB,India,Asia,56,257,271.7635715,1492.490215,27.5,41043.48091,51,48,48,3,0,13,2,male
577 ms,17600 KB,India,Asia,56,257,271.7635715,1492.490215,27.5,41043.48091,51,48,48,3,0,13,2,male
202 ms,26500 KB,Iran,Asia,66,308,332.9737366,1861.673389,37.1875,69230.97914,47,33,28,14,5,15,2,male
124 ms,22100 KB,India,Asia,60,303,300.3702549,1789.78785,30.21052632,54070.43296,53,44,40,9,4,10,2,male
499 ms,19600 KB,Hong Kong,Asia,54,250,258.1074956,1438.721876,25.45454545,36622.01138,42,37,36,5,1,11,2,male
109 ms,19600 KB,Indonesia,Asia,61,301,302.7888745,1785.151939,39.3125,70178.78559,49,42,39,7,3,11,2,male
124 ms,17200 KB,Vietnam,Asia,52,268,250.1173001,1527.717844,40.5,61872.5727,47,38,33,9,5,12,3,male
124 ms,18200 KB,India,Asia,58,270,283.5668306,1581.654869,36.52173913,57764.78651,54,41,35,13,6,11,2,male
77 ms,21500 KB,China,Asia,71,495,365.6422056,3044.124824,42.77777778,130220.8953,38,34,34,4,0,26,2,male
561 ms,18600 KB,India,Asia,64,337,320.4063545,2022,53.10344828,107375.1724,59,55,53,4,2,15,2,male
93 ms,11800 KB,China,Asia,88,469,480.7253082,3029.473429,36.63829787,110994.7499,43,32,32,11,0,13,2,female
77 ms,12700 KB,India,Asia,66,336,334.0271833,2030.916424,37.32142857,75796.70226,57,50,49,7,1,16,1,male
78 ms,6000 KB,South Korea,Asia,42,315,193.2192809,1698.579988,16,27177.27981,84,79,79,5,0,20,1,male
124 ms,19100 KB,Serbia,Europe,51,296,241.523656,1679.037901,33.91666667,56947.36882,74,55,38,19,17,12,3,male
78 ms,50900 KB,China,Asia,74,436,386.1246381,2707.321667,49.07575758,132863.8618,45,0,0,45,0,0,3,male
78 ms,50900 KB,China,Asia,74,436,386.1246381,2707.321667,49.07575758,132863.8618,45,0,0,45,0,0,3,male
109 ms,21800 KB,Bangladesh,Asia,56,271,273.4603973,1573.793184,27.26315789,42906.57207,62,43,32,19,11,13,2,male
373 ms,19200 KB,Bangladesh,Asia,52,255,248.0323866,1453.612128,29.27777778,42558.53286,49,41,37,8,4,11,2,male
546 ms,24500 KB,China,Asia,65,406,326.9987489,2445.081332,48.4137931,118375.6617,45,35,35,10,0,18,3,male
576 ms,17600 KB,India,Asia,67,295,339.6973857,1789.496311,34.25806452,61304.68008,44,39,38,5,1,12,3,male
405 ms,25500 KB,China,Asia,62,400,309.4603455,2381.678524,62.54166667,148954.1444,67,61,61,6,0,17,2,female
78 ms,20600 KB,China,Asia,80,405,425.7903187,2560.380878,42.57692308,109013.1397,53,38,35,15,3,18,2,female
545 ms,15600 KB,China,Asia,54,342,260.2355283,1968.171526,41.44736842,81575.53034,86,72,69,14,3,20,2,male
124 ms,19200 KB,India,Asia,45,254,214.6466251,1394.930686,20,27898.61373,54,40,35,14,5,10,2,male
124 ms,20800 KB,Vietnam,Asia,53,284,256.7497745,1626.729409,45.09375,73355.32929,50,38,32,12,6,12,3,male
405 ms,15300 KB,India,Asia,52,278,257.71338,1584.722242,31.68181818,50206.88193,53,37,31,16,6,11,2,male
546 ms,18600 KB,China,Asia,55,250,265.2124025,1445.339928,28.33333333,40951.29797,48,38,34,10,4,13,2,female
421 ms,25600 KB,India,Asia,68,356,345.9899115,2167.136771,34.46969697,74700.5478,51,45,45,6,0,13,2,male
124 ms,6400 KB,India,Asia,65,340,328.3421192,2047.605056,40.5,82928.00479,65,48,42,17,6,11,2,male
577 ms,15700 KB,India,Asia,57,279,280.1318683,1627.376314,30,48821.28942,58,43,40,15,3,10,2,male
109 ms,23100 KB,India,Asia,63,322,317.7671278,1924.684135,45.65909091,87879.32791,50,42,39,8,3,12,2,male
93 ms,15400 KB,Iran,Asia,54,332,258.7036718,1910.622651,33.78571429,64551.75098,38,27,22,11,5,18,3,male
77 ms,22100 KB,Mexico,America,45,310,214.6466251,1702.47446,38,64694.02947,47,38,37,9,1,17,3,male
124 ms,18200 KB,India,Asia,57,309,279.1883364,1802.363014,37,66687.43153,63,57,57,6,0,14,3,male
77 ms,20600 KB,China,Asia,79,404,419.0808777,2546.727422,44.23684211,112659.1789,56,42,39,14,3,18,2,female
108 ms,18200 KB,India,Asia,55,263,266.8279228,1520.497605,30.31578947,46095.08528,71,47,36,24,11,13,2,male
577 ms,16700 KB,India,Asia,52,254,249.0117739,1447.911688,26.76470588,38752.93048,57,50,49,7,1,11,3,male
124 ms,18100 KB,India,Asia,56,290,273.4603973,1684.132927,30.18421053,50834.22283,66,60,60,6,0,15,2,male
530 ms,31000 KB,India,Asia,32,241,149.2067179,1205,15,18075,74,67,66,7,1,11,2,male
577 ms,16600 KB,India,Asia,72,344,373.2397178,2122.4542,42.32258065,89827.73907,57,51,49,6,2,16,2,male
124 ms,17700 KB,India,Asia,53,252,256.7497745,1443.435955,27.75,40055.34774,58,54,54,4,0,13,2,male
389 ms,15300 KB,Ukraine,Europe,56,291,273.4603973,1689.940282,44.78947368,75691.5358,57,43,38,14,5,14,2,male
467 ms,22700 KB,Taiwan,Asia,58,369,284.9884404,2161.594987,38.76190476,83787.53903,52,49,48,3,1,16,1,female
576 ms,17600 KB,China,Asia,70,407,359.2147805,2494.618188,49.33333333,123067.8306,76,51,35,25,16,18,2,male
576 ms,18600 KB,India,Asia,53,277,254.5835556,1586.633966,28.19444444,44734.26321,59,54,53,5,1,14,3,male
561 ms,19600 KB,Bangladesh,Asia,46,257,215.9932866,1419.555423,32.58333333,46253.84752,51,42,38,9,4,13,2,male
560 ms,15700 KB,India,Asia,57,266,277.6324012,1551.548744,34.20454545,53070.01953,47,42,42,5,0,10,2,male
109 ms,21800 KB,India,Asia,53,289,254.5835556,1655.369011,28.19444444,46672.20963,62,52,46,10,6,14,3,male
405 ms,30900 KB,India,Asia,39,275,194.7497745,1453.48561,18.5,26889.48379,78,64,61,14,3,12,3,male
296 ms,10800 KB,China,Asia,75,435,392.4020294,2709.53613,46.28571429,125412.8152,51,40,36,11,4,24,2,male
93 ms,10800 KB,South Korea,Asia,70,423,359.4212455,2592.686716,42.52631579,110257.414,62,56,56,6,0,21,4,male
139 ms,17600 KB,Peru,America,67,338,340.3026944,2050.338146,47.82758621,98062.72445,76,57,41,19,16,15,3,male
342 ms,10800 KB,China,Asia,75,435,392.4020294,2709.53613,46.28571429,125412.8152,51,40,36,11,4,24,2,male
342 ms,10800 KB,China,Asia,75,435,392.4020294,2709.53613,46.28571429,125412.8152,52,40,35,12,5,24,2,male
124 ms,15300 KB,India,Asia,61,319,306.0981941,1891.905211,46.125,87264.12784,63,57,54,6,3,13,2,male
561 ms,17600 KB,India,Asia,51,257,241.523656,1457.813313,24.75,36080.87949,58,54,52,4,2,14,3,male
108 ms,11700 KB,China,Asia,63,443,314.4992626,2647.935006,42,111213.2703,67,61,61,6,0,25,2,female
483 ms,16600 KB,India,Asia,63,312,314.9612072,1864.911336,38.42307692,71655.63172,62,51,51,11,0,13,2,male
124 ms,17200 KB,India,Asia,47,269,227.9505705,1494.184401,21.11111111,31543.89291,57,45,41,12,4,11,2,male
327 ms,23500 KB,China,Asia,49,322,229.4868683,1807.93657,27.29411765,49346.03343,76,61,61,15,0,14,3,female
561 ms,19600 KB,India,Asia,53,282,253.6843594,1615.273568,30.42105263,49138.32223,57,52,52,5,0,12,2,male
514 ms,31200 KB,Ukraine,Europe,38,278,188.1173001,1458.923849,18,26260.62928,59,46,41,13,5,16,2,male
139 ms,14600 KB,China,Asia,65,444,326.7316235,2673.931309,30.91666667,82669.04297,48,44,44,4,0,30,5,male
530 ms,18600 KB,India,Asia,46,334,215.9932866,1844.869693,19.83333333,36589.91558,91,85,85,6,0,14,1,male
109 ms,19200 KB,India,Asia,56,325,272.5558619,1887.39035,27.9,52658.19076,71,44,35,27,9,13,2,male
93 ms,19200 KB,India,Asia,53,293,254.5835556,1678.280693,30.13888889,50581.51534,54,42,39,12,3,13,2,male
561 ms,17600 KB,India,Asia,47,241,222.5444556,1338.655913,24.79166667,33187.51118,59,46,38,13,8,12,2,male
93 ms,31700 KB,India,Asia,60,308,295.6213103,1819.322303,41.3,75138.01113,79,66,64,13,2,10,2,male
93 ms,19300 KB,Vietnam,Asia,64,348,322.2270913,2088,39,81432,53,33,24,20,9,18,3,male
389 ms,18200 KB,China,Asia,57,312,278.3559659,1819.861684,42.85714286,77994.07219,72,53,43,19,10,14,3,female
561 ms,17600 KB,India,Asia,61,303,301.7363383,1797.013413,35.67307692,64104.99772,79,75,73,4,2,12,3,male
93 ms,19200 KB,India,Asia,0,0,0,0,0,0,56,45,43,11,2,13,2,male
343 ms,41000 KB,Bangladesh,Asia,41,278,208.1306865,1489.399457,19.5,29043.28942,49,43,43,6,0,14,2,male
576 ms,15700 KB,China,Asia,47,266,221.0794529,1477.520635,32.69230769,48303.55921,57,54,53,3,1,13,2,male
498 ms,19300 KB,Vietnam,Asia,66,353,335.7560369,2133.671124,41,87480.51609,53,32,23,21,9,18,3,male
576 ms,18600 KB,India,Asia,72,298,372.2346001,1838.63765,28.5,52401.17304,50,47,46,3,1,13,2,male
171 ms,17700 KB,United States,America,54,292,260.2355283,1680.427151,27.63157895,46432.85548,64,54,48,10,6,14,3,male
93 ms,12000 KB,China,Asia,66,431,333.6312234,2605.133865,35.72413793,93066.16154,66,61,61,5,0,21,1,male
124 ms,23100 KB,Indonesia,Asia,45,316,214.6466251,1735.425578,28,48591.9162,52,41,37,11,4,10,2,male
109 ms,32800 KB,India,Asia,38,266,188.1173001,1395.948719,18,25127.07693,67,64,64,3,0,9,2,male
124 ms,18200 KB,India,Asia,57,312,279.1883364,1819.861684,45.325,82485.23085,66,57,56,9,1,12,4,male
124 ms,21800 KB,India,Asia,57,301,279.1883364,1755.699894,45.325,79577.09771,66,56,55,10,1,12,4,male
561 ms,90000 KB,India,Asia,0,0,0,0,0,0,80,61,50,19,11,11,3,male
108 ms,19200 KB,India,Asia,44,264,204.5187537,1441.289947,25.5,36752.89366,67,56,49,11,7,14,3,male
561 ms,31000 KB,India,Asia,32,241,149.2067179,1205,15,18075,74,67,66,7,1,11,2,female
529 ms,16500 KB,China,Asia,73,398,379.6596322,2463.550174,67.265625,165712.2422,46,40,39,6,1,19,2,male
93 ms,21500 KB,China,Asia,62,381,311.8982981,2268.548794,29.28571429,66436.07183,45,38,38,7,0,14,3,male
405 ms,19600 KB,Ukraine,Europe,45,289,206.8830545,1587.145545,29.89285714,47444.31504,58,36,31,22,5,13,2,male
389 ms,18200 KB,India,Asia,59,322,290.159225,1894.211062,32.08695652,60779.46799,68,58,54,10,4,13,3,male
124 ms,23100 KB,India,Asia,61,306,308.3880345,1814.805625,40.61111111,73701.27289,71,47,37,24,10,11,3,male
93 ms,18200 KB,India,Asia,53,289,254.5835556,1655.369011,28.19444444,46672.20963,57,52,51,5,1,14,3,male
545 ms,18600 KB,Bangladesh,Asia,55,281,267.8084246,1624.56208,34.94444444,56769.41933,52,43,39,9,4,11,2,male
390 ms,18200 KB,India,Asia,53,287,254.5835556,1643.91317,28.19444444,46349.21856,58,52,50,6,2,14,3,male
187 ms,9400 KB,Iran,Asia,71,385,365.8862514,2367.652641,66.21212121,156767.3037,58,46,43,12,3,13,1,male
389 ms,17200 KB,India,Asia,58,328,285.8598074,1921.417766,35.15,67537.83449,86,63,49,23,14,12,3,male
124 ms,6400 KB,Sweden,Europe,38,240,184.2797931,1259.502603,17.5,22041.29556,69,49,38,20,11,8,2,male
186 ms,15700 KB,China,Asia,83,553,446.8336245,3525.396806,47.05434783,165885.2475,55,13,10,42,3,9,2,male
404 ms,27000 KB,India,Asia,65,340,327.8032081,2047.605056,40.11111111,82131.71393,60,55,52,5,3,12,3,male
187 ms,15700 KB,China,Asia,83,553,446.8336245,3525.396806,47.05434783,165885.2475,55,13,10,42,3,9,2,male
93 ms,18200 KB,India,Asia,53,289,254.5835556,1655.369011,28.19444444,46672.20963,62,52,46,10,6,14,3,male
156 ms,17700 KB,India,Asia,53,289,254.5835556,1655.369011,28.19444444,46672.20963,62,52,46,10,6,14,3,male
108 ms,21800 KB,India,Asia,53,289,254.5835556,1655.369011,28.19444444,46672.20963,62,52,46,10,6,14,3,male
108 ms,18200 KB,India,Asia,53,289,254.5835556,1655.369011,28.19444444,46672.20963,62,52,46,10,6,14,3,male
607 ms,19300 KB,Iran,Asia,78,516,412.5946318,3243.267545,84,272434.4738,47,35,32,12,3,18,3,male
156 ms,17700 KB,India,Asia,53,289,254.5835556,1655.369011,28.19444444,46672.20963,62,52,46,10,6,14,3,male
576 ms,29400 KB,India,Asia,51,334,243.5249056,1894.590064,38.28125,72527.2759,85,80,77,5,3,15,2,male
108 ms,18200 KB,Vietnam,Asia,53,289,254.5835556,1655.369011,28.19444444,46672.20963,62,52,46,10,6,14,3,male
93 ms,18200 KB,India,Asia,53,289,254.5835556,1655.369011,28.19444444,46672.20963,62,52,46,10,6,14,3,male
140 ms,17700 KB,India,Asia,53,289,254.5835556,1655.369011,28.19444444,46672.20963,62,52,46,10,6,14,3,male
108 ms,18200 KB,India,Asia,53,289,254.5835556,1655.369011,28.19444444,46672.20963,62,52,46,10,6,14,3,male
93 ms,18200 KB,India,Asia,53,289,254.5835556,1655.369011,28.19444444,46672.20963,62,52,46,10,6,14,3,male
108 ms,18200 KB,India,Asia,53,289,254.5835556,1655.369011,28.19444444,46672.20963,62,52,46,10,6,14,3,male
108 ms,18200 KB,India,Asia,53,289,254.5835556,1655.369011,28.19444444,46672.20963,62,52,46,10,6,14,3,male
93 ms,18200 KB,India,Asia,53,289,254.5835556,1655.369011,28.19444444,46672.20963,62,52,46,10,6,14,3,male
93 ms,18200 KB,India,Asia,53,289,254.5835556,1655.369011,28.19444444,46672.20963,62,52,46,10,6,14,3,male
108 ms,18200 KB,India,Asia,53,289,254.5835556,1655.369011,28.19444444,46672.20963,62,52,46,10,6,14,3,male
109 ms,18200 KB,Romania,Europe,53,289,254.5835556,1655.369011,28.19444444,46672.20963,62,52,46,10,6,14,3,male
109 ms,18200 KB,Ukraine,Europe,53,289,254.5835556,1655.369011,28.19444444,46672.20963,62,52,46,10,6,14,3,male
109 ms,18200 KB,Singapore,Asia,53,289,254.5835556,1655.369011,28.19444444,46672.20963,62,52,46,10,6,14,3,male
108 ms,21800 KB,India,Asia,53,289,254.5835556,1655.369011,28.19444444,46672.20963,62,52,46,10,6,14,3,male
108 ms,21800 KB,India,Asia,53,289,254.5835556,1655.369011,28.19444444,46672.20963,62,52,46,10,6,14,3,male
109 ms,18200 KB,India,Asia,53,289,254.5835556,1655.369011,28.19444444,46672.20963,62,52,46,10,6,14,3,male
93 ms,18200 KB,India,Asia,53,289,254.5835556,1655.369011,28.19444444,46672.20963,62,52,46,10,6,14,3,male
109 ms,18200 KB,India,Asia,53,289,254.5835556,1655.369011,28.19444444,46672.20963,62,52,46,10,6,14,3,male
93 ms,18200 KB,India,Asia,53,289,254.5835556,1655.369011,28.19444444,46672.20963,62,52,46,10,6,14,3,male
108 ms,21800 KB,India,Asia,53,289,254.5835556,1655.369011,28.19444444,46672.20963,62,52,46,10,6,14,3,male
109 ms,18200 KB,Iran,Asia,53,289,254.5835556,1655.369011,28.19444444,46672.20963,62,52,46,10,6,14,3,male
62 ms,11600 KB,China,Asia,73,450,378.8670746,2785.421051,41.83783784,116535.9943,77,0,-11,77,11,0,3,male
93 ms,18300 KB,India,Asia,48,343,229.1368501,1915.642138,21,40228.48489,93,87,87,6,0,14,1,male
124 ms,15300 KB,India,Asia,59,279,290.8572701,1641.257411,36.15909091,59346.37592,49,44,44,5,0,10,2,male
171 ms,18600 KB,Brazil,America,69,309,352.7497745,1887.534057,26.59375,50196.60883,59,44,36,15,8,11,3,male
390 ms,18500 KB,India,Asia,64,415,320.7232379,2490,50.14285714,124855.7143,75,70,70,5,0,19,2,male
561 ms,17600 KB,India,Asia,53,358,252.9035678,2050.595523,28.05,57519.20441,54,47,42,7,5,14,2,male
124 ms,27000 KB,Taiwan,Asia,64,392,321.6326782,2352,48.96153846,115157.5385,56,37,37,19,0,10,3,male
608 ms,16600 KB,Ukraine,Europe,80,455,426.079159,2876.477283,70.55813953,202958.8855,61,44,34,17,10,17,3,male
109 ms,21100 KB,India,Asia,0,0,0,0,0,0,61,40,37,21,3,12,2,male
93 ms,17200 KB,Bangladesh,Asia,67,340,339.9564924,2062.470325,38.23333333,78855.11542,63,51,50,12,1,9,2,male
592 ms,26400 KB,India,Asia,39,288,187.5249056,1522.195839,21.875,33298.03398,60,57,57,3,0,16,3,male
155 ms,18200 KB,Vietnam,Asia,49,264,232.8278745,1482.283399,38.75,57438.48171,67,49,33,18,16,12,4,male
592 ms,17600 KB,Bangladesh,Asia,57,287,278.3559659,1674.039434,36.85714286,61700.31057,63,57,53,6,4,12,4,male
280 ms,12700 KB,Syria,Asia,58,439,284.2247957,2571.653657,38.45454545,98891.77244,75,69,68,6,1,28,2,male
93 ms,18200 KB,India,Asia,53,289,254.5835556,1655.369011,28.19444444,46672.20963,64,52,44,12,8,14,3,male
124 ms,23100 KB,India,Asia,59,304,289.0701413,1788.323487,42.16,75395.71821,64,51,42,13,9,12,3,male
420 ms,18200 KB,India,Asia,50,288,239.420269,1625.430583,25.71428571,41796.78641,60,45,41,15,4,13,2,male
358 ms,21800 KB,India,Asia,58,300,284.9884404,1757.394299,29.95238095,52638.14351,64,55,55,9,0,12,3,female
109 ms,12000 KB,China,Asia,67,474,339.5249056,2875.326276,38.28125,110071.084,55,0,0,55,0,0,3,female
124 ms,21800 KB,India,Asia,60,284,297.5287411,1677.556929,30.22727273,50707.97081,58,52,52,6,0,13,3,male
576 ms,7700 KB,Armenia,Europe,56,357,271.0812322,2073.225707,44.81818182,92918.20669,64,53,50,11,3,15,2,male
390 ms,18200 KB,India,Asia,50,260,242.4407955,1467.402609,28.5,41820.97437,69,65,64,4,1,12,3,male
467 ms,19400 KB,Croatia,Europe,56,420,269.6764904,2439.089067,45.88,111905.4064,87,72,62,15,10,17,2,male
560 ms,17600 KB,India,Asia,51,263,240.7106228,1491.847865,27.78947368,41457.66698,56,51,51,5,0,10,2,male
436 ms,26000 KB,China,Asia,52,385,254.2364029,2194.669291,28.5,62548.07481,60,51,51,9,0,19,2,male
545 ms,21500 KB,India,Asia,45,318,208.1057163,1746.409285,40.61538462,70931.08479,89,56,31,33,25,16,3,male
140 ms,16700 KB,China,Asia,69,344,353.7585727,2101.332413,43.44827586,91299.27036,63,49,42,14,7,12,2,male
124 ms,19600 KB,China,Asia,81,550,433.2506894,3486.917502,44,153424.3701,55,41,38,14,3,17,2,female
108 ms,27000 KB,India,Asia,42,280,201.6270751,1509.848878,21,31706.82645,69,51,47,18,4,14,3,male
561 ms,18500 KB,Peru,America,49,336,229.4868683,1886.542508,22.58823529,42613.66605,75,66,64,9,2,11,1,male
561 ms,14600 KB,India,Asia,51,341,244.720659,1934.297042,34.8,67313.53705,81,79,79,2,0,17,2,male
374 ms,12700 KB,India,Asia,42,287,199.17639,1547.5951,32.5,50296.84076,60,46,37,14,9,14,2,male
577 ms,15700 KB,India,Asia,44,273,200.5096868,1490.424832,33.21428571,49503.3962,50,43,38,7,5,10,2,male
374 ms,15200 KB,Iran,Asia,62,340,307.9068682,2024.426746,46.66666667,94473.24812,50,42,38,8,4,13,2,female
77 ms,11800 KB,China,Asia,66,380,333.6312234,2296.869765,45.93103448,105497.6044,70,0,0,70,0,0,2,female
124 ms,15300 KB,Poland,Europe,65,310,327.8032081,1866.934022,38,70943.49284,65,44,29,21,15,10,2,male
327 ms,22500 KB,China,Asia,51,330,242.4606049,1871.900363,27,50541.3098,83,67,67,16,0,13,3,female
139 ms,20200 KB,India,Asia,61,316,302.7888745,1874.112999,33.14583333,62119.0371,45,30,29,15,1,9,2,male
108 ms,27000 KB,India,Asia,49,254,231.5770955,1426.1363,34,48488.63421,69,51,38,18,13,13,2,male
405 ms,22100 KB,Iran,Asia,62,353,310.1726115,2101.831298,47.47826087,99791.29465,77,48,35,29,13,9,2,female
436 ms,16600 KB,China,Asia,75,404,392.2479866,2516.442751,52,130855.023,58,0,-5,58,5,0,2,male
374 ms,19200 KB,Bangladesh,Asia,48,271,226.2767055,1513.524838,36.42857143,55135.54766,67,50,45,17,5,14,3,male
592 ms,17600 KB,India,Asia,63,439,314.1308434,2624.025886,56.25,147601.4561,67,62,59,5,3,19,3,male
560 ms,25700 KB,India,Asia,51,356,246.0527434,2019.383422,23.78571429,48032.4771,52,30,29,22,1,10,2,male
109 ms,27000 KB,India,Asia,49,303,234.2230164,1701.257083,30.46153846,51822.90806,70,52,50,18,2,13,3,male
109 ms,19600 KB,Tajikistan,Asia,53,282,255.6041684,1615.273568,41.29411765,66701.29676,78,57,44,21,13,13,3,male
186 ms,18700 KB,Bangladesh,Asia,61,313,301.7363383,1856.320787,40.38461538,74966.801,59,52,47,7,5,11,3,male
93 ms,6800 KB,China,Asia,79,411,420.1071259,2590.853888,37.77777778,97876.70242,51,38,36,13,2,21,3,male
124 ms,23100 KB,India,Asia,40,307,201.4212455,1633.831925,19,31042.80658,76,58,52,18,6,12,2,female
607 ms,19500 KB,India,Asia,62,353,310.1726115,2101.831298,33.06521739,69497.50877,56,50,46,6,4,15,2,male
124 ms,18200 KB,India,Asia,62,333,309.4603455,1982.747371,38,75344.40011,71,61,57,10,4,13,3,male
374 ms,18200 KB,India,Asia,55,295,265.9634675,1705.501115,27.125,46261.71776,81,66,56,15,10,12,3,male
108 ms,44500 KB,India,Asia,70,350,359.4212455,2145.249056,33.84375,72603.27274,62,44,41,18,3,10,3,male
514 ms,10800 KB,China,Asia,58,370,283.5668306,2167.452968,36.52173913,79159.15188,73,61,60,12,1,22,2,male
499 ms,10800 KB,China,Asia,58,370,283.5668306,2167.452968,36.52173913,79159.15188,73,61,60,12,1,22,2,male
701 ms,13100 KB,India,Asia,50,369,239.420269,2082.582934,27,56229.73922,112,75,45,37,30,17,2,male
389 ms,18200 KB,India,Asia,59,294,290.8572701,1729.497057,33.63636364,58173.9919,59,54,53,5,1,13,2,female
483 ms,20500 KB,Bangladesh,Asia,60,301,295.1851693,1777.974069,39.23076923,69751.29041,59,49,44,10,5,11,3,male
576 ms,21500 KB,India,Asia,57,293,278.3559659,1709.036774,33.42857143,57130.65788,76,54,46,22,8,9,2,male
93 ms,18200 KB,Malaysia,Asia,53,296,254.5835556,1695.464455,28.19444444,47802.67837,67,56,49,11,7,14,3,male
592 ms,30300 KB,Kuwait,Asia,72,451,372.2746801,2782.636176,35.94285714,100015.8945,81,71,70,10,1,8,2,male
358 ms,15700 KB,India,Asia,50,247,235.05865,1394.032479,29.33333333,40891.61938,62,48,36,14,12,9,2,male
561 ms,22500 KB,Lebanon,Asia,62,327,310.1726115,1947.022193,39.84782609,77584.60175,59,44,36,15,8,12,2,male
452 ms,16600 KB,China,Asia,75,402,392.2479866,2503.985114,52,130207.2259,59,0,-5,59,5,0,2,male
93 ms,10000 KB,Poland,Europe,72,399,372.5956925,2461.800076,44.31818182,109102.5033,60,41,33,19,8,16,3,male
93 ms,10000 KB,Poland,Europe,73,400,379.3421297,2475.929824,45.45454545,112542.2647,60,41,33,19,8,16,3,male
577 ms,39600 KB,Bangladesh,Asia,57,330,278.3559659,1924.853705,44.57142857,85793.47941,58,54,52,4,2,10,2,male
561 ms,17600 KB,India,Asia,68,391,347.0121354,2380.197971,55.13793103,131239.1916,73,67,65,6,2,17,3,male
93 ms,11800 KB,China,Asia,77,520,405.6268983,3258.729001,64.32432432,209615.5412,53,6,6,47,0,4,1,male
109 ms,27900 KB,India,Asia,65,386,327.8032081,2324.633976,40.11111111,93243.6517,65,46,44,19,2,14,2,female
561 ms,21500 KB,India,Asia,55,269,264.5725015,1555.185763,28.5,44322.79424,80,64,50,16,14,10,2,male
545 ms,17600 KB,India,Asia,61,439,301.7363383,2603.593691,53.84615385,140193.5064,69,63,63,6,0,16,1,male
93 ms,18200 KB,India,Asia,56,285,270.5069309,1655.096153,29.41304348,48681.4151,59,40,38,19,2,11,3,male
109 ms,29900 KB,India,Asia,34,255,162,1297.303025,16,20756.84839,83,70,68,13,2,9,2,male
109 ms,24500 KB,China,Asia,66,467,333.1049912,2822.732054,54.75806452,154567.3439,75,49,36,26,13,21,4,male
93 ms,20400 KB,India,Asia,62,329,310.1726115,1958.930586,43.23913043,84702.45513,82,54,39,28,15,13,2,male
390 ms,18900 KB,India,Asia,58,287,284.2247957,1681.240546,36,60524.65964,68,51,47,17,4,11,3,male
545 ms,25100 KB,Ukraine,Europe,73,407,380.0574174,2519.258595,44.03225806,110928.6446,74,52,44,22,8,17,2,male
77 ms,10800 KB,China,Asia,93,550,517.9616502,3596.537346,61.11607143,219806.2333,46,0,-2,46,2,0,2,male
405 ms,74100 KB,India,Asia,40,253,197.504662,1346.447808,24.66666667,33212.37926,58,48,45,10,3,11,3,male
124 ms,15300 KB,Brazil,America,53,308,256.7497745,1764.1995,39.3125,69355.09284,73,42,28,31,14,9,2,male
109 ms,8400 KB,Croatia,Europe,62,289,310.1726115,1720.762734,37.30434783,64191.93154,70,40,22,30,18,8,2,female
109 ms,8800 KB,Belarus,Europe,57,418,280.1318683,2438.148026,21,51201.10854,51,41,41,10,0,26,1,male
109 ms,6300 KB,Croatia,Europe,67,372,340.7366244,2256.585179,42.48214286,95864.57394,82,61,55,21,6,12,1,male
390 ms,17200 KB,Serbia,Europe,51,267,244.720659,1514.537566,30,45436.12699,50,42,37,8,5,10,2,male
124 ms,22500 KB,Romania,Europe,64,370,321.1317371,2220,60.98148148,135378.8889,71,54,45,17,9,15,2,male
405 ms,15300 KB,Argentina,America,74,418,385.5385456,2595.551507,49.26315789,127865.0637,54,34,30,20,4,10,2,male
139 ms,15300 KB,Hungary,Europe,73,347,378.8670746,2147.869122,50.875,109272.8416,49,35,29,14,6,14,2,male
140 ms,7800 KB,Germany,Europe,68,432,346.1173001,2629.783947,38.8125,102068.4895,78,47,41,31,6,6,2,male
202 ms,28000 KB,Finland,Europe,98,574,552.6400215,3796.843451,70.34482759,267088.2979,38,29,26,9,3,15,3,male
404 ms,26400 KB,Colombia,America,54,278,261.1759501,1599.858726,23,36796.75069,60,47,45,13,2,12,2,male
421 ms,23000 KB,Greece,Europe,57,334,279.1883364,1948.185265,39.775,77489.0689,86,49,26,37,23,13,4,male
93 ms,12200 KB,Canada,America,75,413,392.6333688,2572.502119,36.77941176,94615.11471,53,44,44,9,0,14,2,male
576 ms,20600 KB,Belarus,Europe,62,338,308.8461793,2012.518353,43.66,87866.55129,68,54,46,14,8,15,4,male
561 ms,19400 KB,Serbia and Montenegro,Europe,65,403,326.9987489,2427.014229,49.65517241,120513.81,76,69,65,7,4,17,2,male
405 ms,70200 KB,Austria,Europe,80,438,425.8985773,2769.004506,52.5,145372.7365,79,59,53,20,6,18,4,male
108 ms,17100 KB,Brazil,America,69,375,353.3374044,2290.696671,38.35,87848.21734,56,47,41,9,6,15,2,male
124 ms,9900 KB,Chile,America,65,416,327.8032081,2505.30501,85.14814815,213322.0822,76,60,54,16,6,14,1,male
405 ms,20100 KB,Peru,America,64,408,320.7232379,2448,38.57142857,94422.85714,61,37,34,24,3,12,3,male
374 ms,11300 KB,United States,America,80,453,425.7542476,2863.833427,41.5,118849.0872,70,54,49,16,5,18,2,male
187 ms,34600 KB,Finland,Europe,68,521,347.0121354,3171.56814,78.67241379,249514.9211,93,64,42,29,22,17,4,male
483 ms,12700 KB,United States,America,66,420,333.3240179,2538.64553,48,121854.9854,93,77,68,16,9,22,2,male
124 ms,24000 KB,Latvia,Europe,43,280,205.7687845,1519.354131,18,27348.37436,61,47,47,14,0,12,3,male
124 ms,18600 KB,Lithuania,Europe,67,372,340.3026944,2256.585179,48.48275862,109405.4745,73,50,49,23,1,12,3,male
93 ms,11900 KB,Brazil,America,69,420,353.3374044,2565.580272,68.9,176768.4807,52,45,42,7,3,18,2,male
186 ms,27900 KB,Finland,Europe,83,504,446.2065082,3213.019873,59.53488372,191286.7646,65,54,49,11,5,15,3,male
139 ms,12300 KB,Finland,Europe,83,529,446.8336245,3372.395859,67.9673913,229212.949,74,57,47,17,10,16,3,female
265 ms,27900 KB,Norway,Europe,63,418,316.1697866,2498.503008,58.5,146162.426,69,49,41,20,8,14,3,male
436 ms,17500 KB,Romania,Europe,64,354,320.7232379,2124,27.64285714,58713.42857,67,55,52,12,3,21,1,female
421 ms,7400 KB,United States,America,45,305,214.6466251,1675.015194,24,40200.36467,85,54,39,31,15,11,3,male
124 ms,20500 KB,France,Europe,60,403,295.1851693,2380.47691,52.30769231,124517.2538,76,52,43,24,9,15,4,male
124 ms,17200 KB,Brazil,America,50,311,250.4773318,1755.239275,31.5,55290.03716,63,45,45,18,0,10,2,male
936 ms,8000 KB,Netherlands,Europe,67,343,345.2408849,2080.668592,63.40909091,131933.3039,71,60,53,11,7,14,3,male
140 ms,15700 KB,Finland,Europe,77,535,406.0022373,3352.730799,59.58333333,199766.8768,64,53,53,11,0,17,2,female
93 ms,8400 KB,Brazil,America,72,391,373.2397178,2412.440676,42.98387097,103696.0387,84,63,54,21,9,19,4,male
93 ms,12200 KB,Germany,Europe,68,438,348.0415947,2666.308724,63.01851852,168026.8257,68,52,45,16,7,22,3,male
171 ms,31300 KB,Hungary,Europe,52,366,250.1173001,2086.360937,45,93886.24216,73,55,48,18,7,12,3,male
155 ms,31900 KB,Hungary,Europe,52,366,250.1173001,2086.360937,45,93886.24216,74,56,49,18,7,12,3,male
124 ms,17200 KB,Poland,Europe,56,498,273.4603973,2892.062751,86.65789474,250620.0695,92,77,64,15,13,24,2,male
545 ms,11700 KB,Netherlands,Europe,69,476,354.8592943,2907.657641,54.44444444,158305.8049,83,62,49,21,13,23,4,male
1122 ms,34200 KB,Serbia,Europe,82,588,439.6362367,3738.240579,57.86363636,216308.1935,70,64,64,6,0,27,5,male
405 ms,29900 KB,Canada,America,81,481,432.6080183,3049.467851,47.82142857,145829.909,74,43,35,31,8,14,2,male
779 ms,3900 KB,Romania,Europe,75,535,392.2479866,3332.417999,86.125,287004.5002,77,65,59,12,6,21,4,male
607 ms,24400 KB,Colombia,America,57,295,278.3559659,1720.702554,48,82593.7226,68,47,38,21,9,10,2,male
280 ms,33900 KB,Argentina,America,71,532,366.4572094,3271.665468,33.5483871,109759.0996,67,49,47,18,2,13,3,male
592 ms,28400 KB,Ukraine,Europe,79,413,419.0808777,2603.461449,49.09210526,127809.4035,68,53,50,15,3,20,3,male
577 ms,17600 KB,Mexico,America,64,373,320.7232379,2238,43.07142857,96393.85714,74,64,62,10,2,12,4,male
108 ms,22500 KB,Brazil,America,61,434,303.4631705,2573.940005,39.65217391,102062.3167,97,64,56,33,8,13,2,male
577 ms,15700 KB,Ukraine,Europe,59,352,289.0701413,2070.690353,30.6,63363.12481,93,63,42,30,21,16,3,male
436 ms,20700 KB,Colombia,America,65,381,327.3557123,2294.522137,37.66071429,86413.34261,67,53,53,14,0,17,2,male
140 ms,10400 KB,Canada,America,67,476,351.6796778,2887.458455,38.23529412,110402.8233,68,42,39,26,3,16,4,male
93 ms,14700 KB,Germany,Europe,61,418,303.4631705,2479.048207,42.13043478,104443.3788,77,52,38,25,14,15,3,male
124 ms,20500 KB,Poland,Europe,73,511,378.8670746,3163.00035,28.77777778,91024.12117,72,55,52,17,3,18,1,male
608 ms,16700 KB,France,Europe,61,288,301.0709438,1708.052353,29.46428571,50326.54255,69,46,28,23,18,13,1,male
217 ms,26000 KB,Ukraine,Europe,44,443,220.8771238,2418.528207,25,60463.20518,99,58,36,41,22,21,3,male
109 ms,17600 KB,Latvia,Europe,87,634,474.5420279,4084.826176,74.83673469,305695.0528,102,77,60,25,17,30,3,male
592 ms,18500 KB,Romania,Europe,75,421,392.6333688,2622.332669,79.58823529,208706.8295,75,63,60,12,3,17,2,male
577 ms,42000 KB,Romania,Europe,60,383,296.1564001,2262.339098,36,81444.20753,81,73,72,8,1,25,4,male
530 ms,25300 KB,Belarus,Europe,41,341,208.1306865,1826.925234,19.5,35625.04205,59,34,32,25,2,14,2,male
93 ms,14700 KB,Germany,Europe,58,419,285.8598074,2454.494037,39.9,97934.31207,81,56,42,25,14,15,3,male
109 ms,19200 KB,Brazil,America,65,350,327.8032081,2107.828735,35.18518519,74164.34436,86,51,34,35,17,12,2,male
577 ms,25400 KB,Ukraine,Europe,65,415,329.6987322,2499.282642,41,102470.5883,102,76,66,26,10,15,6,male
124 ms,18200 KB,United States,America,63,324,314.4992626,1936.638695,38.66666667,74883.36288,71,51,40,20,11,10,4,male
421 ms,24500 KB,Ukraine,Europe,65,415,329.6987322,2499.282642,41,102470.5883,103,77,67,26,10,15,6,male
109 ms,8400 KB,Croatia,Europe,77,352,405.551932,2205.908862,33.86842105,74710.65015,74,45,28,29,17,8,2,female
108 ms,17700 KB,United States,America,61,381,305.1157897,2259.610926,60,135576.6555,82,53,41,29,12,12,3,male
109 ms,23100 KB,United States,America,60,349,296.1564001,2061.504818,45,92767.7168,61,46,40,15,6,12,2,male
109 ms,19200 KB,Germany,Europe,68,396,346.3298602,2410.635285,47.14516129,113649.7893,85,55,42,30,13,12,2,male
530 ms,5900 KB,United States,America,59,362,293.5877466,2129.516784,35.78947368,76214.2849,77,67,62,10,5,16,2,male
124 ms,29400 KB,Poland,Europe,64,432,322.2270913,2592,74.88,194088.96,84,69,62,15,7,19,4,male
124 ms,25000 KB,Belarus,Europe,41,334,208.1306865,1789.42237,19.5,34893.73621,129,35,-40,94,75,14,2,male
108 ms,14700 KB,Italy,Europe,65,436,328.3421192,2625.752366,49.5,129974.7421,64,59,59,5,0,21,1,male
124 ms,11400 KB,Brazil,America,73,409,379.6596322,2531.638245,57.015625,144342.9368,58,50,47,8,3,18,2,male
109 ms,10900 KB,Brazil,America,85,557,461.2380824,3570.030751,66.12244898,236059.1762,77,54,37,23,17,25,2,male
592 ms,40100 KB,Brazil,America,84,536,454.1955001,3426.282139,54,185019.2355,75,57,52,18,5,25,3,male
109 ms,12300 KB,United States,America,82,529,439.460071,3363.14501,56.23076923,189112.231,70,52,44,18,8,21,4,male
93 ms,11900 KB,Brazil,America,72,410,373.2397178,2529.669251,58.19354839,147210.4299,60,52,49,8,3,18,2,male
109 ms,13300 KB,Brazil,America,73,402,379.6596322,2488.309473,56.375,140278.4465,60,52,49,8,3,18,2,male
155 ms,29000 KB,Poland,Europe,79,511,419.7398968,3221.231962,37.08571429,119461.6882,81,49,41,32,8,12,3,male
234 ms,25300 KB,Canada,America,81,535,432.6080183,3391.819752,61.38461538,208205.5509,79,65,60,14,5,19,4,male
483 ms,7800 KB,Bosnia and Herzegovina,Europe,76,425,399.1845378,2655.369193,43.53658537,115605.7076,76,49,44,27,5,12,2,male
389 ms,7900 KB,Spain,Europe,67,418,339.4387425,2535.625282,50.47058824,127974.4995,101,58,28,43,30,15,3,male
530 ms,18600 KB,Croatia,Europe,84,533,453.5050955,3407.105186,60.7173913,206870.5388,87,61,44,26,17,24,4,male
140 ms,32900 KB,Canada,America,70,456,361.0832696,2794.953056,48,134157.7467,74,64,64,10,0,24,3,male
482 ms,22100 KB,Germany,Europe,49,428,246.1288162,2403.095813,24,57674.29952,83,49,34,34,15,16,5,male
109 ms,13700 KB,Colombia,America,72,424,373.6840496,2616.048201,44.1,115367.7256,75,60,58,15,2,16,4,male
124 ms,14700 KB,Romania,Europe,90,584,494.2988412,3791.242208,86.56521739,328189.7059,111,82,59,29,23,25,4,male
327 ms,24600 KB,Czechia,Europe,76,442,398.9944238,2761.583961,72.22222222,199447.7305,84,62,49,22,13,19,2,male
108 ms,22000 KB,Bulgaria,Europe,61,369,301.7363383,2188.442078,51.15384615,111947.2294,71,56,48,15,8,11,1,male
358 ms,28500 KB,Belarus,Europe,42,280,201.6270751,1509.848878,21,31706.82645,74,46,38,28,8,11,2,male
436 ms,29000 KB,Belarus,Europe,41,279,195.0346806,1494.757009,20.41666667,30517.95561,74,46,38,28,8,11,2,male
405 ms,80100 KB,Ukraine,Europe,81,553,433.6087556,3505.937052,49.07608696,172057.6716,86,65,59,21,6,19,5,male
405 ms,18200 KB,Belarus,Europe,52,266,252.7242144,1516.316965,29.85714286,45272.89224,89,51,32,38,19,13,2,female
405 ms,18200 KB,Belarus,Europe,52,266,252.7242144,1516.316965,29.85714286,45272.89224,89,51,32,38,19,13,2,female
592 ms,15600 KB,United States,America,65,468,326.4650059,2818.468136,57.234375,161313.2622,70,61,59,9,2,17,1,male
93 ms,28500 KB,Belarus,Europe,42,284,201.6270751,1531.418148,21,32159.78111,74,46,38,28,8,11,2,male
109 ms,27400 KB,Ukraine,Europe,69,503,354.26557,3072.587802,68.08928571,209210.3087,77,57,57,20,0,20,4,male
124 ms,14300 KB,United States,America,64,402,322.2270913,2412,46.8,112881.6,97,60,39,37,21,14,4,male
93 ms,22100 KB,Poland,Europe,66,372,333.6312234,2248.514612,39.55172414,88932.62967,101,64,43,37,21,12,4,male
109 ms,28500 KB,Belarus,Europe,42,288,201.6270751,1552.987418,21,32612.73577,74,46,38,28,8,11,2,male
405 ms,15300 KB,Serbia,Europe,78,464,412.4094067,2916.42663,79.22972973,231067.6936,83,69,60,14,9,20,4,male
545 ms,11700 KB,Canada,America,67,434,339.6973857,2632.682709,48.19354839,126878.3215,65,61,59,4,2,25,1,male
109 ms,19600 KB,Brazil,America,103,693,586.8962871,4633.744865,86.50862069,400858.8769,74,51,42,23,9,31,4,male
374 ms,11900 KB,Spain,Europe,70,446,359.0498112,2733.660226,41,112080.0692,70,59,57,11,2,20,1,male
374 ms,18200 KB,Germany,Europe,72,410,373.2397178,2529.669251,56.20967742,142191.8926,89,66,47,23,19,22,4,male
389 ms,14300 KB,Germany,Europe,59,378,290.159225,2223.639073,39.91304348,88752.20299,69,52,46,17,6,18,3,male
608 ms,18600 KB,France,Europe,74,428,385.6555921,2657.64604,46.21794872,122830.9484,73,57,53,16,4,19,2,male
156 ms,1000 KB,Brazil,America,77,629,406.0022373,3941.808734,59.16666667,233223.6834,68,49,38,19,11,18,1,male
140 ms,28300 KB,Ukraine,Europe,62,356,308.3287327,2119.693886,47.07692308,99788.66604,83,61,55,22,6,13,2,male
124 ms,5900 KB,United States,America,59,416,292.5692484,2447.179509,90.675,221898.0019,65,52,43,13,9,15,1,male
171 ms,25500 KB,Poland,Europe,65,480,328.9735285,2890.73655,68,196570.0854,70,60,60,10,0,20,2,male
93 ms,12300 KB,United States,America,71,442,366.8663501,2718.188227,59.45,161596.2901,79,59,51,20,8,21,4,male
576 ms,11700 KB,Ukraine,Europe,62,466,308.8461793,2774.655481,52.54,145780.399,62,57,57,5,0,27,3,male
561 ms,26400 KB,Ukraine,Europe,53,468,256.7497745,2680.666773,33.53125,89886.10772,98,72,70,26,2,12,2,male
93 ms,14700 KB,Serbia,Europe,74,458,385.8508604,2843.929641,40.58823529,115430.0854,77,61,58,16,3,22,2,female
62 ms,19400 KB,Poland,Europe,71,646,365.6422056,3972.736639,57.08571429,226786.5087,86,72,64,14,8,29,3,male
92 ms,13300 KB,Belarus,Europe,87,494,473.7434822,3182.814087,79.09756098,251752.8313,85,73,69,12,4,21,3,male
670 ms,14900 KB,Armenia,Europe,78,520,412.2983693,3268.409154,68.42105263,223627.9947,87,73,68,14,5,22,2,female
93 ms,19000 KB,Cuba,America,87,610,474.2088866,3930.195532,61.75,242689.5741,101,67,40,34,27,26,3,male
124 ms,11300 KB,Slovenia,Europe,69,452,354.8592943,2761.053054,45.88888889,126701.6568,88,83,80,5,3,23,2,male
139 ms,14800 KB,Brazil,America,70,481,359.0910367,2948.185131,34.94117647,103013.0569,105,49,21,56,28,17,9,male
561 ms,19600 KB,Serbia,Europe,50,337,236.9737366,1901.979536,36.125,68709.01074,99,71,59,28,12,10,3,male
202 ms,40400 KB,Brazil,America,103,605,586.5585808,4045.332819,62.54385965,253010.7281,96,59,43,37,16,22,4,male
389 ms,80100 KB,Ukraine,Europe,82,575,440.20115,3655.592403,50.47826087,184527.9469,89,65,59,24,6,19,5,male
156 ms,49500 KB,Ukraine,Europe,82,525,439.460071,3337.714802,60.31395349,201310.7754,102,67,41,35,26,22,6,male
468 ms,25500 KB,Armenia,Europe,67,544,340.3026944,3299.95252,84.51724138,278902.8836,102,92,88,10,4,24,3,male
109 ms,15700 KB,Ukraine,Europe,71,430,365.8862514,2644.391261,50.09090909,132459.9623,76,59,51,17,8,12,1,female
108 ms,25000 KB,Bulgaria,Europe,95,538,529.1438761,3534.582317,74.41666667,263031.8341,70,54,49,16,5,23,6,male
109 ms,14300 KB,Serbia,Europe,65,458,327.3557123,2758.244458,46.25,127568.8062,88,66,46,22,20,25,2,male
124 ms,23300 KB,France,Europe,67,391,340.3026944,2371.840873,46.51724138,110331.4944,75,48,45,27,3,10,3,male
358 ms,7400 KB,Austria,Europe,98,600,550.9789163,3968.825906,63.14814815,250624.0063,91,72,63,19,9,12,4,male
218 ms,37400 KB,Romania,Europe,63,580,314.9612072,3466.822356,103.1730769,357682.7296,93,84,77,9,7,25,3,male
140 ms,24000 KB,Germany,Europe,48,346,239.3111166,1932.397025,23.42857143,45273.30173,98,73,59,25,14,16,4,male
265 ms,25500 KB,United Kingdom,Europe,79,577,419.0808777,3637.281492,40.31707317,146644.544,83,63,63,20,0,31,3,male
436 ms,14200 KB,Argentina,America,80,513,425.7903187,3243.149113,47.30769231,153425.9003,89,53,39,36,14,15,6,male
763 ms,41100 KB,Peru,America,76,565,398.9944238,3530.079045,50.55555556,178465.1073,81,56,49,25,7,11,4,male
498 ms,5800 KB,Romania,Europe,50,315,239.420269,1777.8147,19.28571429,34286.42635,107,82,64,25,18,17,2,male
108 ms,8800 KB,Bulgaria,Europe,85,749,460.2145365,4800.633811,108.9456522,523008.1814,117,99,89,18,10,33,3,male
108 ms,21100 KB,Brazil,America,72,464,372.3949821,2862.845201,54.76470588,156782.8754,96,66,39,30,27,19,3,male
139 ms,14400 KB,Poland,Europe,72,591,372.8771238,3646.425676,50,182321.2838,91,69,66,22,3,13,2,male
389 ms,19700 KB,Armenia,Europe,71,534,365.8862514,3283.964962,62.09210526,203908.2981,90,59,45,31,14,28,1,male
685 ms,39200 KB,Peru,America,71,554,366.4572094,3406.959904,47.09677419,160456.8213,83,59,53,24,6,10,4,male
93 ms,11800 KB,Brazil,America,81,640,432.9647657,4057.504002,118.9189189,482513.9894,111,80,55,31,25,33,2,male
592 ms,31300 KB,Brazil,America,66,462,333.3240179,2792.510083,40.8,113934.4114,118,67,46,51,21,14,5,male
624 ms,23300 KB,Poland,Europe,71,482,367.3587806,2964.178112,42.72413793,126641.9545,115,82,64,33,18,20,3,male
124 ms,9200 KB,Poland,Europe,95,677,532.5126722,4447.792247,52.31034483,232665.5462,110,73,59,37,14,13,4,male
109 ms,30700 KB,Belarus,Europe,43,366,221.6596322,1986.0129,20.5,40713.26445,114,54,25,60,29,14,3,female
93 ms,18200 KB,Canada,America,54,314,261.1759501,1807.034676,29,52404.00559,69,52,44,17,8,14,3,male
93 ms,10800 KB,Spain,Europe,78,568,412.4094067,3570.10846,71.74390244,256133.5131,91,73,66,18,7,27,1,male
93 ms,11800 KB,Brazil,America,81,648,432.9647657,4108.222802,118.9189189,488545.4143,112,82,58,30,24,33,2,male
109 ms,19600 KB,Serbia,Europe,71,536,366.4572094,3296.264456,81.93548387,270081.0232,100,75,63,25,12,24,2,male
717 ms,67700 KB,Brazil,America,79,547,419.2271063,3448.168069,44.83783784,154608.4007,125,74,43,51,31,18,5,male
670 ms,69700 KB,Brazil,America,108,616,623.7020245,4161.010701,52.5,218453.0618,113,65,39,48,26,17,4,male
436 ms,2100 KB,Peru,America,66,566,334.0271833,3421.127072,96.35714286,329650.03,93,55,28,38,27,18,1,male
389 ms,11300 KB,Germany,Europe,81,534,432.75063,3385.479902,38.47368421,130251.8846,71,39,32,32,7,16,3,male
186 ms,37300 KB,Brazil,America,114,742,668.0313232,5070.004391,85.57352941,433858.1698,82,50,42,32,8,22,4,male
78 ms,16500 KB,United States,America,107,945,623.7595057,6370.686302,57.84722222,368526.5062,93,64,53,29,11,40,4,male
108 ms,11900 KB,United States,America,68,386,347.4830616,2349.760657,61.42857143,144342.4403,77,48,30,29,18,19,4,male
77 ms,12400 KB,United States,America,68,386,347.4830616,2349.760657,61.42857143,144342.4403,77,48,30,29,18,19,4,male
654 ms,19400 KB,Romania,Europe,69,579,354.26557,3536.83566,84.92857143,300378.4,130,92,69,38,23,27,4,male
109 ms,39200 KB,Brazil,America,115,743,675.0131492,5086.199108,87.43382353,444705.8352,83,51,43,32,8,23,4,male
171 ms,5500 KB,Canada,America,78,424,412.2983693,2665.010541,50,133250.527,89,51,43,38,8,10,2,male
155 ms,24100 KB,Ukraine,Europe,39,312,194.7497745,1649.045492,18.5,30507.34161,97,60,53,37,7,14,2,male
530 ms,13900 KB,Ukraine,Europe,82,600,439.3544556,3814.531203,71.9047619,274282.9579,136,121,117,15,4,22,4,male
186 ms,20500 KB,Czechia,Europe,93,685,515.2115894,4479.323786,75,335949.2839,88,67,56,21,11,28,6,male
124 ms,11800 KB,Croatia,Europe,87,623,474.942584,4013.953798,58.46,234655.739,106,76,60,30,16,22,3,male
109 ms,12700 KB,Slovenia,Europe,100,746,567.2905595,4956.316718,65.66666667,325464.7978,115,83,74,32,9,27,3,male
109 ms,26500 KB,Brazil,America,93,697,515.7710242,4557.793691,59.70588235,272127.0939,116,81,58,35,23,32,3,male
561 ms,26300 KB,Bolivia,America,59,481,297.3293845,2829.551307,30.90625,87450.82007,107,83,83,24,0,20,3,male
701 ms,54700 KB,Ukraine,Europe,72,780,372.2746801,4812.541501,79.28571429,381565.7904,138,113,102,25,11,26,7,male
93 ms,9800 KB,United States,America,82,525,439.8831639,3337.714802,49.33333333,164660.5969,91,79,71,12,8,24,3,male
78 ms,11800 KB,Poland,Europe,87,643,473.6107211,4142.812668,45.73333333,189464.6327,112,67,47,45,20,29,1,male
78 ms,14300 KB,Lithuania,Europe,75,569,392.9423377,3544.197835,100.5454545,356352.9823,89,67,49,22,18,27,3,female
217 ms,25500 KB,Monaco,Europe,41,415,204.176133,2223.384082,19,42244.29756,97,71,65,26,6,14,3,male
108 ms,39200 KB,Brazil,America,114,742,668.0313232,5070.004391,85.57352941,433858.1698,82,50,42,32,8,22,4,male
187 ms,31300 KB,Croatia,Europe,91,710,504.0920843,4620.534195,71.34545455,329654.1124,101,72,55,29,17,23,8,male
124 ms,15700 KB,Brazil,America,79,614,419.2271063,3870.521379,57.32432432,221875.0229,118,90,71,28,19,29,2,male
577 ms,15700 KB,Ukraine,Europe,75,465,392.4020294,2896.400691,36.57142857,105925.511,96,54,48,42,6,11,3,female
576 ms,29400 KB,Brazil,America,75,555,392.6333688,3456.994373,48.23529412,166749.1404,145,83,40,62,43,20,8,male
171 ms,27500 KB,Brazil,America,99,732,557.8973145,4852.689046,82.5,400346.8463,86,59,48,27,11,30,5,male
405 ms,4200 KB,Armenia,Europe,76,521,402.6841379,3255.170235,53.14285714,172989.0467,105,70,63,35,7,8,1,male
1497 ms,29000 KB,Poland,Europe,78,618,412.2983693,3884.378571,67.925,263846.4145,79,48,43,31,5,18,4,male
187 ms,72700 KB,United States,America,54,491,269.4968818,2825.649764,22.75,64283.53212,60,26,20,34,6,9,2,male
639 ms,36200 KB,Serbia,Europe,79,529,419.0078103,3334.700016,43.58974359,145358.7186,84,69,67,15,2,19,4,male
156 ms,27400 KB,Bulgaria,Europe,75,502,392.9423377,3126.866983,80.18181818,250717.8799,104,73,51,31,22,23,4,female
139 ms,12800 KB,United Kingdom,Europe,91,661,503.0010296,4301.652257,59.86792453,257530.9927,142,99,65,43,34,33,4,male
171 ms,41100 KB,Brazil,America,101,689,573.0922822,4587.507712,58.93965517,270386.1226,108,74,60,34,14,20,4,male
109 ms,18200 KB,Brazil,America,72,571,372.5956925,3523.027176,65,228996.7664,93,73,57,20,16,23,4,male
124 ms,17600 KB,France,Europe,80,769,426.3322913,4861.562705,110,534771.8975,123,91,77,32,14,32,3,male
498 ms,26000 KB,Ukraine,Europe,65,507,329.6987322,3053.340481,61.5,187780.4396,95,64,57,31,7,20,2,male
124 ms,4500 KB,France,Europe,62,466,309.4603455,2774.655481,84.70833333,235036.4413,77,56,45,21,11,13,3,male
155 ms,3500 KB,United Kingdom,Europe,77,472,407.1333893,2957.923247,42.890625,126867.1768,88,53,45,35,8,13,3,male
389 ms,134500 KB,Armenia,Europe,89,570,487.3483806,3691.168056,66.47727273,245378.7855,100,76,68,24,8,22,6,male
280 ms,17500 KB,Serbia,Europe,66,452,335.0885565,2732.066142,50.76923077,138704.8964,115,112,111,3,1,24,4,male
218 ms,20600 KB,Colombia,America,109,762,631.6688991,5157.356455,77.84615385,401480.3641,122,89,65,33,24,28,2,male
561 ms,12600 KB,Netherlands,Europe,88,619,480.7253082,3998.388172,76.32978723,305196.1184,67,52,43,15,9,23,3,male
545 ms,13700 KB,Armenia,Europe,60,620,296.7916995,3662.272169,66.76086957,244496.4746,97,66,54,31,12,31,3,male
124 ms,17700 KB,Latvia,Europe,105,797,601.9899688,5351.253678,91.96721311,492139.8874,121,90,77,31,13,29,7,male
623 ms,12600 KB,Netherlands,Europe,87,616,473.7434822,3968.853193,77.09782609,305989.9533,67,52,43,15,9,23,3,male
187 ms,20600 KB,United States,America,99,677,558.1897755,4488.074432,47.6,213632.343,103,63,52,40,11,18,3,male
77 ms,13700 KB,United States,America,79,559,419.0078103,3523.813438,59.475,209578.8042,108,67,58,41,9,22,4,male
140 ms,17700 KB,United States,America,75,641,392.2479866,3992.672781,79.625,317916.5702,97,59,40,38,19,16,1,male
171 ms,27000 KB,Bulgaria,Europe,45,418,216.7497745,2295.594594,27.75,63702.74999,105,86,76,19,10,17,3,male
390 ms,10300 KB,Canada,America,64,592,321.1317371,3552,74,262848,92,71,66,21,5,26,1,male
561 ms,15600 KB,Cyprus,Europe,69,555,352.7497745,3390.231074,56.078125,190117.8019,123,91,67,32,24,36,1,male
109 ms,23500 KB,Brazil,America,119,799,705.3002761,5508.959393,90.73611111,499861.5516,92,57,47,35,10,24,5,male
155 ms,33800 KB,Croatia,Europe,81,642,432.536756,4070.183702,53.65853659,218400.1011,123,89,81,34,8,28,5,female
436 ms,4000 KB,Iceland,Europe,42,343,214.8771238,1849.564876,20,36991.29752,92,73,67,19,6,16,2,male
124 ms,17600 KB,France,Europe,82,820,439.6362367,5213.192644,104.7894737,546287.7134,120,88,74,32,14,32,3,male
156 ms,8800 KB,Ukraine,Europe,90,512,495.0699333,3323.828785,69.6,231338.4835,84,44,29,40,15,19,1,male
561 ms,15600 KB,Romania,Europe,73,533,379.1044231,3299.17649,44.16176471,145697.4559,107,89,80,18,9,23,4,male
124 ms,39200 KB,Brazil,America,112,793,652.5195839,5398.232453,81.70769231,441077.1163,94,60,50,34,10,24,5,male
529 ms,13700 KB,Venezuela,America,93,705,516.0824975,4610.106962,59.92307692,276251.7941,97,48,33,49,15,23,1,male
374 ms,15700 KB,Poland,Europe,76,530,398.9944238,3311.401582,52.77777778,174768.4168,109,79,69,30,10,20,5,male
467 ms,13900 KB,Ukraine,Europe,64,453,323.7015572,2718,41,111438,92,49,41,43,8,11,3,male
140 ms,29000 KB,Poland,Europe,91,527,501.2172393,3429.607775,52.13333333,178796.8854,96,61,44,35,17,18,4,male
373 ms,9900 KB,Croatia,Europe,86,846,466.9609738,5436.619982,147.826087,803674.2583,123,104,98,19,6,31,1,male
93 ms,23500 KB,Brazil,America,117,798,690.1154872,5482.551046,90.64285714,496954.0913,96,61,51,35,10,25,5,male
639 ms,95400 KB,Brazil,America,82,631,439.460071,4011.615315,51.82051282,207883.9629,148,86,46,62,40,20,7,male
389 ms,19600 KB,Germany,Europe,74,668,387.4217091,4147.914848,81.4,337640.2686,117,88,81,29,7,24,4,male
124 ms,42100 KB,Brazil,America,97,609,548.6850768,4019.346921,37.25806452,149753.0869,109,68,43,41,25,27,3,male
171 ms,20100 KB,Poland,Europe,58,572,295.2391057,3350.765129,41.53846154,139185.6284,107,66,55,41,11,13,5,female
202 ms,52400 KB,Slovakia,Europe,82,609,439.460071,3871.749171,65.05128205,251862.2473,100,57,53,43,4,15,1,male
124 ms,11800 KB,Poland,Europe,66,606,334.0271833,3662.902836,63.10714286,231155.3326,123,78,54,45,24,27,6,male
436 ms,16600 KB,Belarus,Europe,63,505,323.5707183,3018.526361,64.94117647,196026.6531,120,87,74,33,13,21,5,male
109 ms,19200 KB,Netherlands,Europe,75,514,393.3293845,3201.612807,37.625,120460.6819,102,57,43,45,14,20,4,male
327 ms,31300 KB,United States,America,46,487,234.4773318,2689.974673,21,56489.46812,123,67,49,56,18,21,3,male
389 ms,11800 KB,Belarus,Europe,62,459,308.3287327,2732.976106,60.23076923,164609.2532,69,66,65,3,1,12,1,male
717 ms,197900 KB,Germany,Europe,96,731,536.1564001,4813.607588,83,399529.4298,98,81,78,17,3,25,6,male
124 ms,25000 KB,Poland,Europe,74,567,388.0148382,3520.760058,50.43103448,177555.5719,106,64,55,42,9,19,9,male
124 ms,18900 KB,Belarus,Europe,90,743,494.2667787,4823.446851,108.5,523343.9833,99,67,49,32,18,38,3,male
280 ms,39200 KB,Brazil,America,113,817,659.9956879,5572.086212,80.82575758,450368.0894,101,62,50,39,12,25,6,male
124 ms,39200 KB,Brazil,America,107,784,615.4791118,5285.310117,84.99166667,449207.3157,94,60,50,34,10,24,5,male
124 ms,39200 KB,Brazil,America,107,786,615.4791118,5298.793051,84.99166667,450353.2528,94,59,49,35,10,24,5,male
638 ms,60700 KB,Canada,America,97,764,544.452116,5042.333411,61.85454545,311891.2412,84,70,69,14,1,28,2,male
545 ms,61100 KB,Canada,America,97,759,544.452116,5009.333847,61.85454545,309850.0681,84,69,68,15,1,28,2,male
139 ms,20500 KB,Brazil,America,78,577,413.1887278,3626.67708,78.29411765,283947.482,106,78,71,28,7,24,7,male
171 ms,39200 KB,Brazil,America,108,819,622.4916358,5532.252864,86.8,480199.5486,102,63,51,39,12,26,6,male
717 ms,60400 KB,Venezuela,America,65,844,329.6987322,5082.878434,74.3125,377721.4036,113,86,70,27,16,27,5,male
545 ms,28300 KB,Finland,Europe,0,0,0,0,0,0,102,75,67,27,8,16,3,male
124 ms,8800 KB,Poland,Europe,86,535,467.8705569,3438.051644,47.19387755,162254.9883,99,63,48,36,15,24,4,male
171 ms,8900 KB,Cuba,America,76,659,398.9944238,4117.384231,114.4444444,471211.7509,80,74,70,6,4,33,1,male
249 ms,96900 KB,Ukraine,Europe,89,492,489.1726399,3186.060848,44.47115385,141687.8021,92,65,57,27,8,15,3,male
108 ms,13300 KB,Spain,Europe,89,590,488.323496,3820.682724,62.79,239900.6683,101,74,64,27,10,26,1,male
561 ms,13700 KB,Cyprus,Europe,77,645,405.7769322,4042.077319,59.26829268,239567.0216,115,82,76,33,6,29,2,male
171 ms,2500 KB,Chile,America,63,575,315.5176503,3436.935956,55.48,190681.2068,103,82,76,21,6,13,2,male
93 ms,9400 KB,Ukraine,Europe,71,520,365.7235111,3197.868502,41.35294118,132241.2681,88,63,56,25,7,21,1,male
124 ms,41100 KB,Netherlands,Europe,92,733,509.2999891,4781.770914,79.95,382302.5846,119,66,41,53,25,30,5,male
1263 ms,6800 KB,Italy,Europe,65,494,329.6987322,2975.0497,55.52083333,165177.2385,89,52,38,37,14,18,3,male
77 ms,11800 KB,Germany,Europe,95,726,530.4235573,4769.715172,74.40740741,354902.14,126,104,95,22,9,36,3,male
202 ms,86100 KB,Mexico,America,94,859,522.2541717,5630.391824,111.6111111,628414.2874,147,91,59,56,32,32,3,male
139 ms,20600 KB,Brazil,America,91,755,501.2172393,4913.384953,80.24444444,394271.8459,120,95,79,25,16,35,2,male
405 ms,20600 KB,Brazil,America,87,600,473.5443757,3865.766098,61.39534884,237340.0581,126,79,54,47,25,21,2,male
420 ms,19200 KB,Belarus,Europe,78,505,413.1887278,3174.128121,50.47058824,160200.1134,114,80,69,34,11,22,6,male
390 ms,14600 KB,United States,America,75,487,394.3401072,3033.434702,48,145604.8657,97,54,43,43,11,17,2,male
93 ms,12200 KB,Ukraine,Europe,94,673,522.2541717,4411.238297,60.43333333,266585.8344,134,82,54,52,28,27,7,male
608 ms,50900 KB,Poland,Europe,59,632,290.8572701,3717.830407,89.13636364,331393.8831,105,67,49,38,18,18,2,male
436 ms,22400 KB,United States,America,85,704,459.8067162,4512.211219,53.75,242531.353,125,101,95,24,6,39,4,male
389 ms,11800 KB,Hungary,Europe,85,642,459.8067162,4114.828981,57.8452381,238023.2621,133,88,69,45,19,25,1,male
343 ms,48500 KB,Canada,America,67,733,340.7366244,4446.443377,73.125,325146.1719,99,77,71,22,6,18,2,male
389 ms,10300 KB,Italy,Europe,73,702,379.1044231,4345.25684,105.5294118,458552.3983,111,87,76,24,11,33,4,male
109 ms,5900 KB,Poland,Europe,113,809,663.1093772,5517.524781,59.74647887,329652.6777,112,64,60,48,4,17,3,male
311 ms,12300 KB,Peru,America,93,672,515.149526,4394.314721,53.64130435,235716.7734,107,74,68,33,6,18,3,male
124 ms,12700 KB,Germany,Europe,84,686,452.9546635,4385.129752,121,530600.7,136,97,73,39,24,24,4,male
108 ms,10400 KB,Poland,Europe,80,659,425.7903187,4166.150615,61.82926829,257590.0441,117,93,86,24,7,28,5,male
124 ms,54300 KB,Lithuania,Europe,83,673,447.6031056,4290.401537,98.05714286,420704.5165,126,103,102,23,1,15,1,male
93 ms,10400 KB,Slovenia,Europe,82,751,439.6362367,4774.521555,68.31578947,326175.2094,110,60,51,50,9,23,3,male
140 ms,27000 KB,Armenia,Europe,87,689,473.9427998,4439.188069,72.85,323394.8508,141,88,81,53,7,19,5,male
109 ms,17600 KB,Bulgaria,Europe,63,437,315.5176503,2612.071327,33.44,87347.66516,147,97,69,50,28,17,4,male
1326 ms,17700 KB,Poland,Europe,78,672,412.5946318,4223.790291,56,236532.2563,124,101,93,23,8,20,4,male
1684 ms,55800 KB,Croatia,Europe,69,684,353.7585727,4178.230728,57.93103448,242049.2284,105,82,80,23,2,23,3,male
108 ms,18200 KB,Ukraine,Europe,77,664,405.551932,4161.146263,66.74358974,277729.839,96,77,70,19,7,24,1,male
592 ms,18700 KB,United States,America,62,454,311.8982981,2703.205125,27.33333333,73887.60675,98,75,67,23,8,30,2,male
1278 ms,15300 KB,Poland,Europe,81,680,432.536756,4311.098002,52.19512195,225018.286,123,97,89,26,8,21,5,male
171 ms,27000 KB,Bulgaria,Europe,64,561,321.6326782,3366,104.5,351747,130,103,84,27,19,17,3,male
546 ms,78600 KB,Czechia,Europe,77,601,405.6268983,3766.338711,36.5375,137612.6007,101,79,75,22,4,26,1,male
171 ms,11800 KB,Brazil,America,79,603,419.0078103,3801.179791,74.87179487,284601.1536,118,72,55,46,17,21,3,male
156 ms,45600 KB,United States,America,65,472,330.5192567,2842.557608,43.82608696,124578.1769,115,78,69,37,9,19,5,male
124 ms,17700 KB,Brazil,America,108,758,623.7020245,5120.204727,77.5,396815.8663,131,91,66,40,25,29,7,male
623 ms,5800 KB,Lithuania,Europe,43,359,217.6320113,1948.029047,20,38960.58094,99,68,57,31,11,16,2,male
156 ms,27400 KB,Cuba,America,92,675,508.6701412,4403.40432,72.66,319951.3579,132,82,55,50,27,18,5,male
78 ms,19600 KB,Belarus,Europe,51,417,243.5249056,2365.401368,28.4375,67266.10139,164,71,18,93,53,16,4,male
109 ms,15300 KB,United States,America,72,537,378.1173001,3313.249726,69,228614.2311,96,58,35,38,23,25,7,male
108 ms,34800 KB,Peru,America,47,629,238.0869722,3493.836388,21,73370.56414,132,110,98,22,12,42,4,male
124 ms,29000 KB,Colombia,America,65,509,331.4368801,3065.385217,45.93181818,140798.7164,101,76,71,25,5,13,2,male
109 ms,18200 KB,Croatia,Europe,90,592,494.2667787,3843.177033,70.5,270943.9808,126,74,55,52,19,19,5,male
124 ms,58200 KB,Lithuania,Europe,94,730,522.9001971,4784.849862,102.7619048,491700.2858,139,116,115,23,1,17,1,male
140 ms,58300 KB,Croatia,Europe,94,730,522.9001971,4784.849862,102.7619048,491700.2858,139,116,115,23,1,17,1,male
639 ms,4200 KB,United States,America,71,586,365.8862514,3603.751812,81.18181818,292559.1244,109,98,93,11,5,19,3,male
187 ms,45900 KB,Germany,Europe,86,604,467.8705569,3881.463912,52.97297297,205612.6829,128,72,51,56,21,19,6,male
124 ms,10900 KB,Denmark,Europe,67,590,339.9564924,3578.992622,70.91666667,253810.2268,128,61,26,67,35,19,2,male
498 ms,19500 KB,Romania,Europe,61,620,301.7363383,3677.057149,53.84615385,197995.385,130,100,96,30,4,38,5,male
1700 ms,29300 KB,United States,America,83,633,446.2065082,4035.39996,52.09302326,210216.184,125,81,42,44,39,23,3,male
1669 ms,29400 KB,United States,America,83,633,446.2065082,4035.39996,52.09302326,210216.184,125,81,42,44,39,23,3,male
109 ms,10800 KB,Ukraine,Europe,92,755,508.1677,4925.289277,103,507304.7955,114,90,85,24,5,29,4,male
483 ms,10800 KB,Romania,Europe,55,476,265.9634675,2751.927224,21,57790.4717,99,92,92,7,0,28,1,female
93 ms,12300 KB,United States,America,90,721,494.2667787,4680.626082,72,337005.0779,110,79,68,31,11,30,6,male
93 ms,9800 KB,Poland,Europe,122,930,728.926341,6445.585724,65.67105263,423288.3993,117,73,61,44,12,30,11,male
217 ms,115000 KB,Cuba,America,102,640,579.2957256,4270.352219,65.71428571,280623.1458,122,92,74,30,18,29,3,male
93 ms,12300 KB,United States,America,90,720,494.2667787,4674.134229,72,336537.6645,111,80,69,31,11,30,6,male
124 ms,20100 KB,United States,America,90,721,494.2667787,4680.626082,72,337005.0779,110,79,68,31,11,30,6,male
358 ms,34300 KB,Romania,Europe,77,686,407.1333893,4299.015567,56.953125,244842.371,130,0,-27,130,27,0,6,male
155 ms,4000 KB,Lithuania,Europe,81,502,432.75063,3182.604701,43.56578947,138652.6864,119,68,45,51,23,14,4,male
171 ms,20200 KB,United States,America,90,724,494.2667787,4700.101642,72,338407.3182,111,80,69,31,11,30,6,male
155 ms,20100 KB,United States,America,90,723,494.2667787,4693.609789,72,337939.9048,112,81,70,31,11,30,6,male
124 ms,19600 KB,Cuba,America,80,731,425.8985773,4621.329437,97.26315789,449485.0947,165,103,56,62,47,31,3,male
140 ms,58300 KB,Lithuania,Europe,94,745,522.9001971,4883.168694,105.2380952,513895.3721,143,120,119,23,1,18,1,male
155 ms,126300 KB,Ukraine,Europe,82,543,439.3544556,3452.150739,53.80952381,185758.5874,120,90,76,30,14,20,6,male
670 ms,29200 KB,Croatia,Europe,104,867,593.5404068,5809.281236,112.9649123,656244.9452,133,87,63,46,24,27,11,male
592 ms,35400 KB,Cuba,America,80,826,425.7903187,5221.912606,96.71794872,505052.6757,149,120,115,29,5,27,4,male
171 ms,8900 KB,Cuba,America,79,637,419.0078103,4015.508337,55.38461538,222397.3848,119,93,80,26,13,28,3,male
109 ms,15700 KB,Romania,Europe,77,593,405.6268983,3716.204419,84.86486486,315375.1858,118,97,81,21,16,28,3,male
966 ms,33800 KB,Canada,America,88,729,481.614055,4708.92565,86.26,406191.9266,138,78,47,60,31,25,8,male
77 ms,13300 KB,United States,America,80,518,425.7903187,3274.758753,46.78205128,153199.9319,128,95,81,33,14,20,3,male
1840 ms,75500 KB,United States,America,109,854,631.1333893,5780.029413,81.9140625,473465.6906,123,91,76,32,15,28,6,male
62 ms,17000 KB,Mexico,America,84,724,453.092115,4628.037814,109.0909091,504876.8524,122,94,78,28,16,31,5,male
140 ms,12700 KB,Poland,Europe,97,737,543.7947753,4864.135765,80.11320755,389681.5181,112,81,65,31,16,24,5,male
124 ms,10800 KB,Poland,Europe,91,850,501.2172393,5531.625444,136.9565217,757592.1804,131,90,61,41,29,30,3,female
452 ms,11300 KB,United States,America,71,622,371.104776,3825.142708,75.39583333,288399.8221,124,72,70,52,2,23,4,male
1153 ms,26400 KB,Ireland,Europe,68,598,347.0121354,3640.302779,57.15517241,208062.133,153,122,118,31,4,23,3,male
405 ms,13300 KB,Belarus,Europe,75,642,393.7950768,3998.901599,78.77419355,315010.2486,146,87,65,59,22,27,1,male
374 ms,182200 KB,United States,America,92,719,508.6701412,4690.441046,57.96,271857.963,137,84,55,53,29,26,7,male
452 ms,40700 KB,Sweden,Europe,50,633,252.9808689,3572.560968,24.57142857,87782.92665,116,87,76,29,11,19,4,male
296 ms,14700 KB,Canada,America,101,752,573.0922822,5006.975035,55.97413793,280261.1112,102,43,31,59,12,18,3,male
795 ms,41400 KB,Croatia,Europe,104,893,593.5404068,5983.492668,112.9649123,675924.7244,135,89,65,46,24,30,11,male
405 ms,10400 KB,Ukraine,Europe,101,760,573.0922822,5060.240727,86.37068966,437056.4814,125,87,72,38,15,21,2,male
77 ms,11800 KB,Belarus,Europe,83,610,446.1369639,3888.774053,74.7804878,290804.4207,135,88,69,47,19,29,2,male
374 ms,9400 KB,Belarus,Europe,88,900,480.4627738,5813.488457,112.7555556,655503.1207,144,97,72,47,25,40,3,male
109 ms,17900 KB,United States,America,83,543,446.2065082,3461.646411,48.37209302,167447.0822,113,65,53,48,12,16,1,male
93 ms,26600 KB,Ukraine,Europe,74,642,386.4773318,3986.469061,59.71875,238066.9492,118,48,40,70,8,14,3,male
93 ms,26400 KB,United States,America,86,729,467.8705569,4684.747006,71.73469388,336058.8924,146,108,92,38,16,23,3,male
93 ms,15800 KB,Brazil,America,93,970,515.7710242,6342.984047,76.17647059,483186.1377,145,102,82,43,20,53,4,male
421 ms,14800 KB,Poland,Europe,73,548,380.0574174,3392.023858,65.03225806,220590.9709,110,72,71,38,1,20,2,male
108 ms,11900 KB,Spain,Europe,74,660,385.8508604,4098.239221,72.35294118,296519.6613,125,68,61,57,7,22,1,male
1762 ms,79300 KB,Bosnia and Herzegovina,Europe,109,854,631.1333893,5780.029413,81.9140625,473465.6906,120,91,79,29,12,28,6,male
592 ms,18600 KB,Armenia,Europe,86,763,466.7930215,4903.240008,53.23170732,261007.837,142,90,76,52,14,25,3,male
592 ms,22900 KB,Armenia,Europe,87,769,473.6107211,4954.623548,58.39285714,289314.6251,147,96,83,51,13,26,3,male
77 ms,8800 KB,Ukraine,Europe,59,721,297.3293845,4241.385639,26.875,113987.239,132,69,56,63,13,26,3,male
139 ms,26500 KB,Belarus,Europe,63,753,318.7159976,4500.891782,122,549108.7975,157,131,108,26,23,39,11,male
218 ms,49000 KB,Belarus,Europe,92,869,508.9533246,5668.97534,84.81372549,480806.9183,124,82,66,42,16,26,4,male
374 ms,9400 KB,Belarus,Europe,87,867,473.6107211,5586.032011,105.9333333,591746.991,155,96,65,59,31,38,5,male
109 ms,29700 KB,Germany,Europe,93,654,515.3357736,4276.609862,92.04081633,393622.6629,94,45,41,49,4,16,7,male
748 ms,60400 KB,Venezuela,America,67,1096,341.8710649,6648.433753,82.78846154,550413.602,134,86,68,48,18,27,5,male
1341 ms,53800 KB,Ukraine,Europe,97,745,545.3518546,4916.935067,82.10526316,403706.2476,131,114,108,17,6,23,2,male
155 ms,14600 KB,Hungary,Europe,80,601,426.3322913,3799.478785,37.88888889,143958.0295,126,73,61,53,12,18,5,male
93 ms,13300 KB,Saint Pierre and Miquelon,America,95,868,529.7522498,5702.634668,87.65384615,499857.8619,124,101,96,23,5,36,2,male
93 ms,12200 KB,Brazil,America,101,1026,572.345265,6831.324981,114.5089286,782247.7043,108,92,88,16,4,30,2,male
171 ms,22800 KB,Canada,America,90,1017,495.0699333,6602.214599,70,462155.0219,96,84,84,12,0,47,1,male
390 ms,9400 KB,Belarus,Europe,89,798,487.4132344,5167.635278,82.26086957,425094.1716,169,116,87,53,29,37,3,male
78 ms,13900 KB,United States,America,107,951,616.7836264,6411.135104,95.33333333,611194.8799,140,99,82,41,17,34,3,male
530 ms,11800 KB,Romania,Europe,68,601,346.1173001,3658.565168,59.625,218141.9481,116,85,66,31,19,35,1,female
1669 ms,9600 KB,Brazil,America,103,757,587.2909311,5061.680899,89.86440678,454864.9513,147,114,106,33,8,23,8,male
109 ms,10400 KB,United States,America,78,670,412.5946318,4211.219487,72.85714286,306817.4197,107,79,72,28,7,28,1,male
124 ms,11700 KB,Venezuela,America,101,891,575.2908578,5932.466431,69.19354839,410488.4031,144,83,62,61,21,32,5,male
295 ms,104700 KB,Brazil,America,75,706,392.6333688,4397.545995,67.52941176,296963.6943,135,95,73,40,22,18,5,male
561 ms,9900 KB,Chile,America,76,691,398.8804611,4317.317912,69.25641026,299001.9405,105,87,79,18,8,28,1,male
421 ms,27400 KB,United States,America,78,769,413.5983953,4833.474306,74.31818182,359215.0223,163,94,65,69,29,32,8,male
561 ms,17300 KB,Mexico,America,81,800,432.75063,5071.880002,64.51162791,327195.2355,92,86,84,6,2,40,1,male
78 ms,11300 KB,Chile,America,81,744,432.536756,4716.848402,60.97560976,287612.7074,136,120,115,16,5,35,2,male
171 ms,66600 KB,Cuba,America,85,778,459.8067162,4986.506148,63.47619048,316524.4141,123,88,64,35,24,40,3,male
155 ms,21600 KB,United States,America,82,849,439.460071,5397.561652,90.41025641,487994.9329,140,102,91,38,11,42,3,male
763 ms,49800 KB,United States,America,107,875,615.1541399,5898.783613,66.71186441,393518.8526,136,99,95,37,4,26,8,male
202 ms,20200 KB,United States,America,90,786,494.2667787,5102.596534,80.5,410759.021,139,86,74,53,12,32,7,male
499 ms,122300 KB,Cuba,America,102,759,581.4346098,5064.370835,54.44262295,275717.6318,121,56,39,65,17,23,2,male
171 ms,25500 KB,Cuba,America,80,845,425.7542476,5342.02924,42.5,227036.2427,141,82,64,59,18,31,4,male
93 ms,13400 KB,Brazil,America,83,537,446.2065082,3423.396175,39.06976744,133751.2924,151,89,66,62,23,18,2,male
343 ms,50900 KB,United States,America,82,821,439.460071,5219.550196,93.41860465,487603.0962,144,93,75,51,18,24,8,male
327 ms,50900 KB,United States,America,82,835,439.460071,5308.555924,93.41860465,495917.8871,147,94,73,53,21,25,8,male
93 ms,14800 KB,United States,America,113,978,659.9956879,6670.135025,103.6136364,691116.945,151,100,81,51,19,42,8,male
405 ms,10400 KB,United States,America,95,782,530.4235573,5137.627086,66.05555556,339368.8114,137,72,47,65,25,24,1,male
171 ms,35300 KB,United States,America,88,786,480.4627738,5077.113252,86,436631.7397,156,89,61,67,28,27,7,male
156 ms,35300 KB,United States,America,94,808,522.6230769,5296.107792,78.83333333,417509.8309,151,89,61,62,28,26,7,male
249 ms,35300 KB,United States,America,109,868,631.6688991,5874.783994,75.81538462,445399.008,146,85,56,61,29,28,6,male
592 ms,16600 KB,United States,America,69,467,353.7585727,2852.680921,49.65517241,141650.363,113,73,59,40,14,16,5,male
124 ms,27400 KB,Canada,America,99,918,557.4885414,6085.749377,78.63461538,478550.5616,113,60,47,53,13,29,9,male
124 ms,22600 KB,Argentina,America,80,945,426.6582949,5974.22205,81.64285714,487752.5573,189,131,113,58,18,25,10,male
467 ms,48600 KB,Canada,America,92,1080,509.2999891,7045.446913,79.61538462,560925.9657,146,94,86,52,8,23,3,male
390 ms,10400 KB,United States,America,108,850,624.7832923,5741.654377,69.79230769,400723.3089,139,66,54,73,12,25,5,male
592 ms,98000 KB,United States,America,109,914,631.6688991,6186.120473,80.55384615,498315.7969,148,87,58,61,29,28,6,male
1388 ms,95600 KB,United States,America,143,1122,889.4613924,8033.37564,66.24456522,532167.4765,164,110,86,54,24,34,16,male
124 ms,18600 KB,United States,America,97,1072,545.3518546,7075.106567,118.5964912,839082.8139,179,0,-11,179,11,0,16,female
701 ms,129300 KB,United States,America,109,937,631.6688991,6341.788712,82.92307692,525880.6332,149,88,59,61,29,28,6,male
358 ms,88400 KB,Mexico,America,106,951,609.3751625,6398.252352,70.25806452,449528.8266,187,132,114,55,18,35,6,male
873 ms,160600 KB,United States,America,109,960,631.6688991,6497.456952,85.29230769,554183.0975,150,89,60,61,29,28,6,male
701 ms,129300 KB,United States,America,106,942,609.3751625,6337.701068,82.67741935,523984.769,156,94,64,62,30,28,6,male
1356 ms,65600 KB,Brazil,America,89,1313,487.7378322,8502.637995,108.90625,925990.4191,166,118,106,48,12,38,9,male
639 ms,129800 KB,Brazil,America,109,937,631.6688991,6341.788712,82.92307692,525880.6332,149,88,59,61,29,28,6,male
1419 ms,67100 KB,United States,America,89,915,487.4132344,5925.296089,85.06521739,504036.5999,162,97,72,65,25,26,7,male
1497 ms,34200 KB,United States,America,74,723,386.4773318,4489.434783,42,188556.2609,212,138,102,74,36,38,13,male
109 ms,19200 KB,United States,America,103,1051,586.2775517,7027.512054,62.94642857,442356.7855,109,63,58,46,5,46,26,male
748 ms,58500 KB,United States,America,100,862,564.6454601,5727.004036,88.67924528,507866.3956,152,75,61,77,14,19,6,male
577 ms,15700 KB,United States,America,117,993,687.5797841,6822.272167,65.8359375,449150.684,197,96,59,101,37,43,18,male
311 ms,52600 KB,Brazil,America,101,1293,574.6521014,8609.067447,92.13114754,793163.2632,198,121,80,77,41,30,5,male
483 ms,236900 KB,Cuba,America,85,926,459.8746234,5935.096007,101.5681818,602816.9103,152,91,76,61,15,28,3,male
561 ms,14300 KB,United States,America,95,556,531.8959763,3652.839718,40.66666667,148548.8152,164,92,54,72,38,18,2,male
202 ms,67100 KB,United States,America,89,939,487.4132344,6080.713692,85.06521739,517257.2321,167,101,75,66,26,26,7,male
280 ms,74500 KB,United States,America,95,1069,529.5086837,7023.175645,116.9019608,821023.0039,172,107,77,65,30,34,7,male
389 ms,105800 KB,United States,America,96,1069,536.6378566,7039.324913,114.6538462,807085.6756,172,107,77,65,30,34,7,male
374 ms,137100 KB,United States,America,96,1069,536.6378566,7039.324913,114.6538462,807085.6756,172,107,77,65,30,34,7,male
436 ms,168500 KB,United States,America,96,1069,536.6378566,7039.324913,114.6538462,807085.6756,172,107,77,65,30,34,7,male
218 ms,89100 KB,Venezuela,America,129,1298,778.965429,9100.572978,70.90909091,645313.3566,180,100,77,80,23,48,20,male
171 ms,15600 KB,United States,America,113,873,662.3791956,5954.016234,59.27857143,352945.5766,160,92,70,68,22,22,7,male
295 ms,66600 KB,United States,America,89,958,487.4132344,6203.752627,85.06521739,527723.5658,172,103,75,69,28,28,7,male
483 ms,130300 KB,United States,America,118,1119,700.4907862,7701.677572,97.46666667,750656.8407,169,101,74,68,27,26,7,male
1185 ms,137100 KB,United States,America,96,1126,536.6378566,7414.667776,119.7307692,887763.8764,188,120,87,68,33,36,7,male
842 ms,105800 KB,United States,America,96,1126,536.6378566,7414.667776,119.7307692,887763.8764,188,120,87,68,33,36,7,male
499 ms,74500 KB,United States,America,95,1126,529.5086837,7397.657415,122.0784314,903094.4131,188,120,87,68,33,36,7,male
1278 ms,168500 KB,United States,America,96,1126,536.6378566,7414.667776,119.7307692,887763.8764,188,120,87,68,33,36,7,male
733 ms,240000 KB,Argentina,America,102,840,579.6081201,5604.837287,61.57894737,345139.9803,168,70,63,98,7,24,3,male
109 ms,8800 KB,Peru,America,96,940,537.6344164,6189.864751,90.57272727,560632.9319,118,101,101,17,0,34,2,male
982 ms,61600 KB,Brazil,America,182,2038,1210.672106,15300.88548,135.0916031,2067021.147,175,129,108,46,21,65,15,male
1107 ms,61600 KB,Brazil,America,181,2035,1203.571223,15262.18638,132.4427481,2021365.906,175,129,108,46,21,65,15,male
654 ms,36200 KB,Canada,America,115,1420,673.2936924,9720.595872,76.1015625,739752.5343,137,104,98,33,6,80,21,male
404 ms,13200 KB,Brazil,America,109,1054,629.2687494,7133.666278,125.8474576,897753.7647,170,130,114,40,16,38,5,male
1091 ms,52400 KB,Bolivia,America,93,928,515.149526,6068.339377,78.78723404,478107.6747,156,106,102,50,4,26,6,male
1091 ms,52400 KB,Bolivia,America,93,928,515.149526,6068.339377,78.78723404,478107.6747,156,106,102,50,4,26,6,male
1481 ms,76000 KB,Brazil,America,98,1451,553.2066264,9597.943984,119.6440678,1148337.061,238,178,123,60,55,61,3,male
826 ms,64200 KB,Brazil,America,182,2038,1210.672106,15300.88548,135.0916031,2067021.147,175,129,108,46,21,65,15,male
467 ms,28300 KB,United States,America,64,1194,321.6326782,7164,93.53846154,670109.5385,128,102,102,26,0,21,1,male
1123 ms,56100 KB,Bolivia,America,108,1137,622.8406536,7680.30709,115.5737705,887642.0489,166,116,111,50,5,36,11,male
1029 ms,74900 KB,Brazil,America,194,2171,1310.256525,16499.41078,142.4609929,2350522.442,210,154,122,56,32,73,16,male
1107 ms,56100 KB,Bolivia,America,108,1138,622.8406536,7687.061977,115.5737705,888422.7367,167,117,112,50,5,36,11,male
171 ms,36900 KB,United States,America,99,1098,557.8973145,7279.033569,47.91666667,348787.0252,275,102,15,173,87,13,4,male
186 ms,41100 KB,United States,America,53,705,266.5486654,4038.18392,25.8,104185.1451,231,152,122,79,30,35,4,male
187 ms,18500 KB,United States,America,160,1603,1023.923493,11737.05074,81.25471698,953690.7358,206,104,82,102,22,56,36,male
530 ms,63700 KB,United States,America,110,879,639.1450031,5960.815188,62.66666667,373544.4185,273,139,82,134,57,27,8,male
124 ms,15700 KB,United States,America,164,1810,1055.706876,13317.16913,104.1972477,1387612.37,233,128,100,105,28,68,39,male
249 ms,69100 KB,Canada,America,172,1629,1120.737671,12097.38529,89.55172414,1083341.71,203,112,92,91,20,47,27,male
249 ms,69100 KB,Canada,America,172,1629,1120.737671,12097.38529,89.55172414,1083341.71,203,111,90,92,21,47,27,male
1091 ms,162200 KB,United States,America,96,682,538.6054173,4490.944425,66.71052632,299593.2663,292,148,110,144,38,41,10,male
1466 ms,236200 KB,Cuba,America,157,2024,1003.529777,14764.3124,106.0747664,1566120.988,303,202,181,101,21,75,14,male
967 ms,169600 KB,Cuba,America,155,1967,987.1885888,14312.13671,105,1502774.354,303,200,179,103,21,74,14,male
77 ms,14200 KB,United States,America,121,2008,716.3315329,13893.07738,124.2857143,1726711.046,351,113,83,238,30,39,17,male
93 ms,14200 KB,United States,America,121,2010,716.3315329,13906.91511,124.2857143,1728430.878,351,113,83,238,30,39,17,male
420 ms,43000 KB,United States,America,121,2008,716.3315329,13893.07738,124.2857143,1726711.046,351,113,83,238,30,39,17,male
280 ms,46100 KB,United States,America,181,2327,1188.720515,17452.14138,86.22457627,1504803.495,312,192,159,120,33,105,62,male
155 ms,38700 KB,United States,America,115,1197,675.5720375,8194.051591,90,737464.6432,448,169,116,279,53,55,7,male
62 ms,15400 KB,Canada,America,334,4057,2564.740211,34012.68831,113.0666667,3845701.292,194,137,131,57,6,156,83,male
358 ms,101500 KB,Canada,America,348,4220,2700.691796,35629.22155,114.7263158,4087609.323,213,141,131,72,10,158,87,male
389 ms,101800 KB,Canada,America,360,4355,2816.221414,36982.02023,116.2424242,4298879.685,217,149,139,68,10,162,88,male
327 ms,101800 KB,Canada,America,359,4413,2806.566831,37456.83807,121.3175676,4544172.483,215,147,137,68,10,163,88,male
312 ms,101800 KB,Canada,America,365,4449,2864.566866,37868.78756,120.263245,4554223.277,218,150,140,68,10,164,89,male
