time,memory,country,continent,program_vocabulary,program_length,calculated_estimated_program_length,volume,difficulty,effort,loc,slocP,lsloc,comments,blankLine,cyclomatic_complexity,numberOfFunction,gender
31 ms,0 KB,India,Asia,27,124,128.3819626,589.6060503,0,0,13,9,9,4,0,5,2,male
31 ms,0 KB,China,Asia,43,135,193.2092968,732.5457419,28,20511.28077,17,10,8,7,2,6,2,male
31 ms,0 KB,India,Asia,56,149,269.2634114,865.2958834,23.62962963,20446.62124,14,10,10,4,0,5,2,male
31 ms,0 KB,China,Asia,55,169,263.0928815,977.0497916,25.65384615,25065.08504,17,13,13,4,0,6,2,male
31 ms,300 KB,China,Asia,32,121,145.6363364,605,14.5,8772.5,20,15,15,5,0,7,2,male
31 ms,0 KB,China,Asia,32,123,145.6363364,615,14.5,8917.5,20,15,15,5,0,7,2,male
31 ms,0 KB,India,Asia,28,130,134.6059378,624.9561399,0,0,15,11,11,4,0,5,2,male
46 ms,0 KB,India,Asia,29,128,126.9663202,621.8215674,13,8083.680376,18,15,15,3,0,6,2,male
31 ms,0 KB,China,Asia,45,162,205.8100768,889.6802016,26,23131.68524,26,21,21,5,0,7,2,male
31 ms,0 KB,United States,America,31,122,142.8814489,604.4119499,14.5,8763.973273,24,19,19,5,0,7,2,male
31 ms,300 KB,South Korea,Asia,42,160,185.583273,862.7707876,16.91176471,14590.97656,23,17,15,6,2,5,2,male
30 ms,0 KB,Iran,Asia,44,152,197.8688309,829.833606,29.38235294,24382.46389,30,24,24,6,0,7,3,male
31 ms,0 KB,China,Asia,54,177,256.9778536,1018.615088,16.81034483,17123.27087,23,18,18,5,0,5,2,male
31 ms,0 KB,China,Asia,54,177,256.9778536,1018.615088,16.81034483,17123.27087,23,18,18,5,0,5,2,male
31 ms,3600 KB,Vietnam,Asia,54,159,257.6220106,915.0271128,37.06521739,33915.67886,28,20,17,8,3,6,3,male
31 ms,0 KB,Vietnam,Asia,41,130,181.6849315,696.4817606,23.14285714,16118.57789,27,17,15,10,2,6,2,male
31 ms,0 KB,Iran,Asia,29,129,140.8814489,626.6795484,0,0,19,13,11,6,2,6,2,male
31 ms,0 KB,China,Asia,47,169,216.6935862,938.7255159,25.58823529,24020.32938,17,13,13,4,0,7,2,male
31 ms,200 KB,China,Asia,31,121,142.8814489,599.4577536,14.5,8692.137427,33,28,28,5,0,6,2,male
31 ms,0 KB,China,Asia,41,160,181.6849315,857.2083207,19.28571429,16531.87476,23,19,19,4,0,7,2,male
31 ms,0 KB,China,Asia,44,178,200.5096868,971.7788281,31.07142857,30194.55645,30,25,25,5,0,6,2,male
31 ms,0 KB,China,Asia,36,119,171.2198934,615.2210752,16.5,10151.14774,19,15,15,4,0,6,3,male
31 ms,0 KB,China,Asia,39,151,170.317149,798.095735,18,14365.72323,34,27,24,7,3,5,2,male
31 ms,800 KB,South Korea,Asia,34,128,172.9737366,651.1952437,0,0,39,34,34,5,0,8,2,male
46 ms,0 KB,Bulgaria,Europe,36,145,171.2198934,749.6391252,22,16492.06075,31,27,27,4,0,8,3,male
31 ms,0 KB,China,Asia,37,109,171.6096405,567.8304169,19.2,10902.344,31,26,25,5,1,7,2,male
30 ms,0 KB,Mexico,America,33,133,143.8917376,670.9044179,18,12076.27952,30,22,17,8,5,6,2,male
31 ms,0 KB,Indonesia,Asia,37,115,177.7286241,599.087137,17,10184.48133,36,29,26,7,3,6,2,male
46 ms,0 KB,China,Asia,34,118,162,600.3206153,16,9605.129844,37,33,33,4,0,5,2,male
31 ms,0 KB,China,Asia,42,167,186.2114327,900.5170096,21.9375,19755.0919,34,27,24,7,3,6,2,male
31 ms,0 KB,Finland,Europe,33,119,151.9616054,600.2829002,15,9004.243503,38,20,12,18,8,6,2,male
46 ms,0 KB,India,Asia,29,130,130.3819626,631.5375294,13.5,8525.756646,36,28,25,8,3,6,2,male
31 ms,0 KB,Ukraine,Europe,45,146,202.1494206,801.8105521,25.09090909,20118.15567,30,21,17,9,4,5,2,male
31 ms,0 KB,India,Asia,30,118,136.6059378,579.0130903,14,8106.183264,32,20,15,12,5,6,2,male
31 ms,0 KB,South Korea,Asia,35,128,156.3912239,656.5482262,19.33333333,12693.26571,30,22,19,8,3,6,2,male
46 ms,0 KB,China,Asia,45,140,204.8814489,768.8594335,29,22296.92357,26,23,23,3,0,6,2,female
31 ms,0 KB,Syria,Asia,30,112,136.6059378,549.5717467,14,7694.004454,29,20,15,9,5,6,2,male
31 ms,0 KB,Iran,Asia,34,131,150.1157128,666.4576322,18.66666667,12440.54247,29,21,16,8,5,6,2,male
46 ms,0 KB,China,Asia,58,214,281.8126557,1253.607933,34.06666667,42706.24358,25,18,15,7,3,5,2,male
31 ms,0 KB,China,Asia,37,126,171.6096405,656.3911241,19.2,12602.70958,37,24,16,13,8,6,3,male
31 ms,0 KB,India,Asia,34,108,152.4910893,549.4459869,14.5,7966.966809,30,24,23,6,1,5,2,male
46 ms,0 KB,Romania,Europe,43,160,190.4804869,868.2023608,24.15,20967.08701,31,24,20,7,4,7,3,male
31 ms,3700 KB,Taiwan,Asia,41,165,185.2604657,883.9960808,19.09090909,16876.28881,27,23,23,4,0,6,2,male
31 ms,0 KB,China,Asia,31,123,142.8814489,609.3661462,14.5,8835.80912,31,22,18,9,4,6,2,male
31 ms,0 KB,United States,America,40,131,180.4259988,697.1725804,18,12549.10645,26,21,19,5,2,6,2,male
31 ms,0 KB,South Korea,Asia,38,159,167.8252188,834.4204746,16.8,14018.26397,30,20,17,10,3,6,2,male
31 ms,0 KB,China,Asia,31,110,142.8814489,544.9615941,14.5,7901.943115,30,24,22,6,2,6,2,male
31 ms,0 KB,Ukraine,Europe,39,127,181.9747809,671.2460818,22,14767.4138,32,24,20,8,4,6,2,male
31 ms,0 KB,Bangladesh,Asia,33,109,155.5800856,549.838959,15.5,8522.503865,32,24,20,8,4,7,2,male
31 ms,0 KB,Bangladesh,Asia,32,136,139.991603,680,13.5,9180,40,28,20,12,8,6,2,male
31 ms,300 KB,India,Asia,33,127,146.2155783,640.6380532,19.6,12556.50584,31,21,15,10,6,6,2,male
31 ms,0 KB,Serbia,Europe,36,133,174.9737366,687.6000252,17,11689.20043,27,19,16,8,3,6,2,female
31 ms,0 KB,South Korea,Asia,35,132,158.8163583,677.0653582,18,12187.17645,30,14,11,16,3,5,2,male
31 ms,0 KB,China,Asia,35,174,152.3819626,892.4952449,16.875,15060.85726,44,41,40,3,1,9,2,male
31 ms,0 KB,Ukraine,Europe,32,159,160,795,0,0,28,22,22,6,0,6,2,male
31 ms,0 KB,China,Asia,51,165,242.4606049,935.9501814,32,29950.40581,32,21,18,11,3,6,2,male
31 ms,0 KB,China,Asia,53,239,250.9205489,1368.972989,51.35416667,70302.46702,26,18,15,8,3,7,2,male
31 ms,0 KB,China,Asia,33,153,151.9616054,771.7923003,15,11576.8845,32,24,24,8,0,7,2,male
46 ms,300 KB,China,Asia,48,174,220.1383297,971.7834751,30.43478261,29576.01881,24,16,12,8,4,5,2,male
31 ms,200 KB,China,Asia,32,135,145.6363364,675,14.5,9787.5,41,25,16,16,9,6,2,male
31 ms,0 KB,China,Asia,32,136,145.6363364,680,14.5,9860,41,25,16,16,9,6,2,male
31 ms,300 KB,China,Asia,57,217,275.5886804,1265.737133,40,50629.48532,33,25,21,8,4,9,2,female
31 ms,0 KB,Iran,Asia,44,172,197.8688309,939.0222384,27,25353.60044,29,16,11,13,5,6,2,male
31 ms,0 KB,South Korea,Asia,35,136,158.8163583,697.5824903,18,12556.48483,30,14,11,16,3,5,2,male
31 ms,200 KB,China,Asia,33,136,151.9616054,686.0376002,15,10290.564,28,22,20,6,2,8,2,male
31 ms,300 KB,China,Asia,32,139,149.2067179,695,15,10425,29,25,25,4,0,6,2,male
31 ms,0 KB,China,Asia,32,139,149.2067179,695,15,10425,29,25,25,4,0,6,2,male
46 ms,0 KB,India,Asia,42,179,187.9089067,965.2248187,32,30887.1942,33,24,19,9,5,5,2,male
31 ms,0 KB,Vietnam,Asia,48,143,220.6206284,798.6496376,28.28571429,22590.37546,33,24,21,9,3,5,2,male
31 ms,0 KB,Croatia,Europe,32,128,145.6363364,640,14.5,9280,41,26,19,15,7,6,2,male
31 ms,0 KB,India,Asia,32,152,145.6363364,760,19.33333333,14693.33333,33,25,25,8,0,7,2,male
31 ms,0 KB,South Korea,Asia,32,132,139.991603,660,13.5,8910,39,35,35,4,0,7,2,male
46 ms,0 KB,Bangladesh,Asia,30,155,136.6059378,760.5680423,14,10647.95259,29,23,21,6,2,6,2,male
31 ms,0 KB,China,Asia,44,182,197.8688309,993.6165546,36.52941176,36296.22826,29,14,11,15,3,5,2,male
31 ms,0 KB,Singapore,Asia,41,196,179.5259683,1050.080193,29.64705882,31131.78925,34,23,16,11,7,8,3,male
31 ms,0 KB,Argentina,America,38,127,175.509775,666.4867942,21.33333333,14218.38494,39,27,20,12,7,10,3,male
31 ms,3700 KB,China,Asia,56,269,269.6764904,1562.178474,46.77419355,73069.6383,19,14,14,5,0,6,2,male
31 ms,0 KB,India,Asia,29,139,126.9663202,675.2593583,13,8778.371658,35,21,14,14,7,7,2,male
31 ms,0 KB,Iran,Asia,37,149,169.0898606,776.2085515,18.08333333,14036.43797,41,25,19,16,6,6,2,male
31 ms,200 KB,Cuba,America,27,130,118.0964047,618.1353753,12.5,7726.692191,37,23,14,14,9,5,2,male
31 ms,0 KB,China,Asia,42,172,186.9853215,927.4785967,15.3,14190.42253,31,27,27,4,0,8,2,female
31 ms,0 KB,Romania,Europe,27,133,114.7939875,632.4000378,12,7588.800453,22,11,6,11,5,6,2,male
31 ms,0 KB,Brazil,America,32,164,137.7212077,820,19.5,15990,31,24,20,7,4,7,2,male
31 ms,0 KB,Ukraine,Europe,51,206,239.4453837,1168.51962,40.71428571,47575.44169,52,43,39,9,4,6,3,male
31 ms,0 KB,United States,America,46,173,209.0925853,955.5762184,31.26315789,29874.3302,27,19,16,8,3,5,2,male
31 ms,0 KB,Armenia,Europe,26,131,112.0391,615.7576031,12,7389.091237,33,30,30,3,0,8,2,male
31 ms,0 KB,Mexico,America,38,169,184.2797931,886.8997498,17.5,15520.74562,26,19,19,7,0,8,3,male
31 ms,0 KB,Belarus,Europe,37,132,169.0898606,687.6478443,18.08333333,12434.96518,42,25,13,17,12,6,2,male
31 ms,0 KB,Romania,Europe,31,147,142.8814489,728.2668576,14.5,10559.86944,40,35,35,5,0,8,2,male
31 ms,200 KB,United Kingdom,Europe,28,150,120.8512922,721.1032383,12.5,9013.790479,41,30,30,11,0,6,2,male
31 ms,0 KB,Romania,Europe,35,151,164.7548875,774.5217356,16,12392.34777,44,31,22,13,9,7,3,male
31 ms,0 KB,Serbia,Europe,51,197,240.7106228,1117.467792,32.84210526,36699.99487,49,41,38,8,3,8,3,male
31 ms,200 KB,Brazil,America,48,185,221.5920716,1033.218063,33.57894737,34694.37495,38,24,14,14,10,6,2,male
31 ms,0 KB,Belarus,Europe,31,137,139.3608253,678.7248945,14,9502.148523,37,30,26,7,4,7,2,male
46 ms,0 KB,Ukraine,Europe,40,143,177.6254878,761.0357176,24.5,18645.37508,33,24,18,9,6,5,2,male
31 ms,3900 KB,Romania,Europe,31,151,133.8210731,748.0836429,23.4,17505.15724,51,39,31,12,8,8,3,male
31 ms,0 KB,United States,America,32,149,142.6059378,745,14,10430,39,24,20,15,4,5,2,male
31 ms,200 KB,United States,America,32,129,149.2067179,645,15,9675,34,25,20,9,5,5,2,male
31 ms,3600 KB,Canada,America,46,165,212.1834446,911.3877227,31,28253.01941,30,27,26,3,1,7,2,male
46 ms,0 KB,Romania,Europe,33,159,155.5800856,802.058665,15.5,12431.90931,41,28,21,13,7,6,2,male
46 ms,0 KB,Romania,Europe,38,177,184.2797931,928.8831699,17.5,16255.45547,58,44,34,14,10,12,6,male
31 ms,0 KB,Ukraine,Europe,32,172,139.991603,860,18.9,16254,30,20,15,10,5,6,3,male
31 ms,0 KB,Mexico,America,50,178,239.420269,1004.606402,27,27124.37285,57,34,17,23,17,6,2,male
31 ms,0 KB,Peru,America,57,295,275.4873867,1720.702554,58,99800.74814,56,40,28,16,12,10,5,male
31 ms,0 KB,Romania,Europe,41,160,192.6252211,857.2083207,24.28571429,20817.91636,49,30,20,19,10,8,4,male
31 ms,3600 KB,Canada,America,29,165,130.3819626,801.5668642,13.5,10821.15267,40,31,28,9,3,6,2,male
31 ms,0 KB,Ukraine,Europe,34,163,162,829.2564431,16,13268.10309,53,24,9,29,15,5,2,male
31 ms,0 KB,Germany,Europe,35,160,164.7548875,820.6852827,16,13130.96452,41,27,21,14,6,7,3,male
31 ms,0 KB,Brazil,America,37,168,166.8582023,875.1881654,19.28571429,16878.6289,72,42,24,30,18,7,2,male
31 ms,4000 KB,Canada,America,34,135,158.3349731,686.8074836,15.5,10645.516,43,28,22,15,6,5,2,male
31 ms,0 KB,Romania,Europe,34,142,162,722.4197235,16,11558.71558,47,42,42,5,0,12,2,male
31 ms,0 KB,Armenia,Europe,45,219,205.8100768,1202.715828,47,56527.64392,42,29,26,13,3,7,2,male
31 ms,0 KB,Hungary,Europe,39,220,194.7497745,1162.788488,18.5,21511.58703,48,31,25,17,6,7,2,male
31 ms,0 KB,Belarus,Europe,50,184,238.1282645,1038.469539,30.33333333,31500.24268,45,30,29,15,1,6,2,male
31 ms,0 KB,Finland,Europe,37,308,169.0898606,1604.511637,20.66666667,33159.90716,38,30,30,8,0,7,3,female
31 ms,0 KB,Ukraine,Europe,58,284,284.2247957,1663.666603,49.09090909,81670.90595,46,29,26,17,3,13,2,female
31 ms,0 KB,France,Europe,39,198,190.8721876,1046.509639,18,18837.17351,58,42,31,16,11,9,2,male
31 ms,0 KB,Brazil,America,41,235,188.529325,1259.024721,24.88888889,31335.72639,44,21,13,23,8,7,3,male
31 ms,0 KB,Ukraine,Europe,58,290,284.2247957,1698.814489,49.09090909,83396.34762,49,32,29,17,3,15,2,female
30 ms,0 KB,Ukraine,Europe,56,220,270.0391,1277.618083,38,48549.48715,65,46,30,19,16,9,3,male
31 ms,100 KB,United States,America,44,277,214.9310205,1512.262558,22.16666667,33521.82004,49,32,24,17,8,15,3,male
31 ms,0 KB,Bulgaria,Europe,42,197,194.994331,1062.286532,22,23370.30371,66,45,30,21,15,9,4,female
31 ms,0 KB,Ukraine,Europe,29,146,130.3819626,709.2652253,13.5,9575.080541,55,31,27,24,4,7,2,male
31 ms,0 KB,Spain,Europe,39,211,190.8721876,1115.219868,18,20073.95763,56,33,21,23,12,10,2,male
31 ms,0 KB,Mexico,America,34,225,158.3349731,1144.679139,15.5,17742.52666,59,26,13,33,13,7,3,male
31 ms,0 KB,United States,America,46,197,214.5707223,1088.141705,25.38461538,27622.05867,43,28,26,15,2,7,2,male
30 ms,0 KB,Brazil,America,43,221,205.7687845,1199.204511,23.14285714,27753.01868,64,38,24,26,14,10,4,male
31 ms,200 KB,Colombia,America,61,281,301.3556992,1666.537192,51.62962963,86042.69798,64,42,27,22,15,11,3,male
46 ms,0 KB,Mexico,America,28,179,124.2114327,860.516531,13,11186.7149,51,42,36,9,6,10,2,male
31 ms,0 KB,Belarus,Europe,30,161,136.6059378,790.0093859,14,11060.1314,52,22,6,30,16,8,2,male
31 ms,200 KB,Romania,Europe,32,211,149.2067179,1055,15,15825,46,36,30,10,6,12,2,male
46 ms,0 KB,United States,America,31,222,139.3608253,1099.831581,14,15397.64213,39,20,20,19,0,11,2,male
15 ms,0 KB,France,Europe,48,212,227.6306219,1184.01205,24.23076923,28689.52275,51,25,16,26,9,6,3,male
31 ms,0 KB,Romania,Europe,32,200,149.2067179,1000,15,15000,65,50,41,15,9,11,4,male
46 ms,800 KB,Ukraine,Europe,38,189,175.509775,991.8583,26.66666667,26449.55467,52,35,28,17,7,9,3,male
31 ms,3600 KB,Mexico,America,36,216,171.2198934,1116.7038,16.5,18425.61271,53,44,39,9,5,12,3,male
31 ms,0 KB,Sweden,Europe,38,216,184.2797931,1133.552343,17.5,19837.166,47,36,29,11,7,15,4,male
31 ms,0 KB,Brazil,America,41,210,188.529325,1125.085921,24.88888889,28002.13848,42,21,13,21,8,7,3,male
31 ms,0 KB,Peru,America,37,212,177.7286241,1104.404114,17,18774.86993,56,37,25,19,12,9,5,male
31 ms,0 KB,Peru,America,48,233,224,1301.296263,32,41641.48041,47,26,20,21,6,6,3,male
31 ms,0 KB,Germany,Europe,40,304,184,1617.866141,20,32357.32282,59,39,32,20,7,9,4,male
31 ms,100 KB,Cuba,America,41,302,183.9009989,1617.980705,56.79166667,91887.82089,54,35,24,19,11,11,4,male
31 ms,100 KB,Argentina,America,55,337,265.9634675,1948.318223,22.75,44324.23958,50,32,28,18,4,8,5,male
31 ms,0 KB,Poland,Europe,15,42,58.60335893,164.089405,0,0,50,29,22,21,7,6,2,male
31 ms,0 KB,United States,America,69,375,353.0013311,2290.696671,49.64516129,113722.0057,51,35,27,16,8,12,5,male
31 ms,100 KB,Romania,Europe,34,196,150.1157128,997.1427169,28,27919.99607,64,40,22,24,18,10,3,male
31 ms,0 KB,Ukraine,Europe,45,278,211.0274844,1526.735161,23.18181818,35392.49691,50,30,29,20,1,7,3,male
31 ms,0 KB,Poland,Europe,34,228,158.3349731,1159.941528,15.5,17979.09368,65,43,31,22,12,10,4,male
31 ms,0 KB,Ukraine,Europe,57,257,275.5886804,1499.052734,40,59962.10935,42,27,22,15,5,6,2,male
31 ms,0 KB,Ukraine,Europe,60,251,298.3693524,1482.629539,32.5,48185.46003,85,33,-2,52,35,7,3,male
31 ms,0 KB,Brazil,America,52,286,251.3531335,1630.325759,35.76666667,58311.31799,51,33,32,18,1,8,3,male
31 ms,0 KB,Hungary,Europe,34,217,158.3349731,1103.979437,15.5,17111.68127,54,38,32,16,6,6,2,male
31 ms,0 KB,Brazil,America,39,256,190.8721876,1353.062968,18,24355.13342,50,28,21,22,7,5,2,male
31 ms,0 KB,Brazil,America,52,286,251.3531335,1630.325759,35.76666667,58311.31799,51,33,32,18,1,8,3,male
31 ms,0 KB,Cuba,America,84,453,453.8154506,2895.719793,49.20212766,142475.5749,76,48,25,28,23,12,4,male
30 ms,0 KB,Ukraine,Europe,42,224,201.6270751,1207.879103,18,21741.82385,57,31,27,26,4,7,2,male
31 ms,200 KB,Poland,Europe,53,307,255.6041684,1758.47158,40.23529412,70752.6212,52,24,20,28,4,8,2,male
31 ms,0 KB,Belarus,Europe,38,171,173.2315701,897.3956048,19.92857143,17883.81241,57,29,20,28,9,8,2,female
31 ms,0 KB,Romania,Europe,68,408,345.9474732,2483.684839,67.5,167648.7266,54,35,24,19,11,6,2,male
31 ms,0 KB,Belarus,Europe,34,192,155.2067179,976.7928655,15,14651.89298,49,21,18,28,3,6,2,male
31 ms,0 KB,Slovakia,Europe,70,391,359.2147805,2396.54966,24.08108108,57711.50667,58,39,34,19,5,8,5,male
31 ms,0 KB,Slovakia,Europe,46,281,217.5786534,1552.12091,27.04545455,41977.81551,56,26,21,30,5,7,2,male
31 ms,0 KB,Belarus,Europe,62,339,307.3464548,2018.472549,43.5,87803.55589,69,23,11,46,12,5,2,male
31 ms,0 KB,Italy,Europe,30,231,133.1368501,1133.491728,13.5,15302.13832,67,51,40,16,11,11,2,male
30 ms,0 KB,Mexico,America,40,251,201.4212455,1335.803952,19,25380.27508,71,39,22,32,17,11,4,male
31 ms,0 KB,Venezuela,America,68,342,346.1173001,2081.912292,30.66666667,63845.31028,63,15,6,48,9,5,2,male
31 ms,0 KB,Ukraine,Europe,40,306,186.1164904,1628.509997,42.42857143,69095.35273,62,20,13,42,7,7,2,male
31 ms,0 KB,United States,America,41,248,200.7497745,1328.672897,18.5,24580.4486,70,39,27,31,12,6,2,male
31 ms,0 KB,Lithuania,Europe,45,347,212.7441865,1905.673024,35,66698.55585,67,47,32,20,15,9,2,female
31 ms,0 KB,Belarus,Europe,34,213,150.1157128,1083.629585,16.33333333,17699.28322,69,36,25,33,11,7,2,male
30 ms,0 KB,Canada,America,46,318,214.5707223,1756.492702,27.92307692,49046.68083,53,28,22,25,6,13,6,male
31 ms,0 KB,Lithuania,Europe,55,313,265.9634675,1809.56559,28,50667.83653,73,36,21,37,15,11,5,male
31 ms,300 KB,Cuba,America,44,467,203.01955,2549.554566,134.6666667,343340.0149,64,44,31,20,13,16,2,male
31 ms,200 KB,Czechia,Europe,70,463,359.2147805,2837.858037,72.31818182,205228.7335,88,53,46,35,7,8,3,male
31 ms,0 KB,Belarus,Europe,33,201,155.5800856,1013.923218,15.5,15715.80988,99,33,6,66,27,8,4,male
15 ms,0 KB,France,Europe,52,383,251.3531335,2183.268412,33.3,72702.83812,68,39,29,29,10,7,4,male
30 ms,3900 KB,Ukraine,Europe,89,527,489.1726399,3412.711518,53.72115385,183334.8005,81,33,12,48,21,14,7,male
31 ms,200 KB,Cuba,America,92,532,511.3291757,3470.534961,52.07142857,180715.7133,88,49,25,39,24,11,5,female
31 ms,0 KB,United States,America,48,365,251.8882768,2038.511313,22.5,45866.50454,79,41,41,38,0,10,6,male
46 ms,200 KB,Cuba,America,54,396,259.4122985,2278.935451,45.05,102666.0421,87,49,28,38,21,12,6,male
31 ms,0 KB,United States,America,64,348,321.6326782,2088,46.03846154,96128.30769,68,25,14,43,11,11,6,male
93 ms,800 KB,Cuba,America,43,400,203.5249056,2170.505902,19.6875,42731.83494,87,62,53,25,9,10,4,male
31 ms,0 KB,Brazil,America,69,437,354.26557,2669.425188,60.03571429,160260.8479,68,34,27,34,7,10,4,male
46 ms,200 KB,Mexico,America,39,387,179.6514845,2045.450659,27.42857143,56103.7895,83,69,65,14,4,18,3,male
31 ms,0 KB,Mexico,America,35,293,168.4650059,1502.879924,16.5,24797.51875,78,65,65,13,0,10,3,male
31 ms,0 KB,Chile,America,38,311,178.0746464,1632.105457,16.5,26929.74004,71,55,47,16,8,12,3,male
31 ms,200 KB,United States,America,88,485,486.0548164,3132.824335,41.60526316,130341.9809,90,34,17,56,17,10,5,male
31 ms,0 KB,United States,America,40,237,188.4835116,1261.296958,22.66666667,28589.39773,68,45,37,23,8,11,5,male
46 ms,0 KB,United States,America,67,338,339.5249056,2050.338146,56.875,116612.9821,81,48,33,33,15,8,3,male
46 ms,7100 KB,Brazil,America,66,399,334.5126491,2411.713254,64.27777778,155019.5686,93,59,53,34,6,14,8,male
31 ms,0 KB,United States,America,37,218,163.1352628,1135.660834,20.22222222,22965.58575,114,38,7,76,31,9,4,male
31 ms,0 KB,United States,America,96,518,536.2766595,3411.010575,50.54347826,172404.3389,105,64,46,41,18,19,10,male
31 ms,0 KB,Canada,America,70,455,363.2297941,2788.823773,37.8,105417.5386,61,33,22,28,11,25,17,male
31 ms,0 KB,United States,America,95,502,530.851908,3298.067515,77.81818182,256649.6176,74,27,17,47,10,11,8,male
31 ms,0 KB,United States,America,75,483,392.9423377,3008.519428,58.54545455,176135.1374,98,34,22,64,12,11,4,male
31 ms,0 KB,United States,America,105,1136,605.0606984,7627.382908,174.9090909,1334098.61,122,48,26,74,22,21,14,male
46 ms,3700 KB,Peru,America,78,696,412.2613731,4374.639944,50,218731.9972,120,58,33,62,25,23,9,male
30 ms,0 KB,United States,America,79,609,419.4466845,3839.002476,52.55555556,201760.9079,121,60,38,61,22,13,7,male
31 ms,300 KB,Cuba,America,48,518,224,2893.010575,70,202510.7403,140,102,97,38,5,18,5,male
31 ms,0 KB,United States,America,69,671,359.1731716,4098.81991,40.59090909,166374.8264,152,63,37,89,26,30,18,male
31 ms,0 KB,Brazil,America,108,1095,621.7684232,7396.601815,50.10526316,370608.6804,143,75,60,68,15,36,28,male
31 ms,0 KB,United States,America,149,1721,930.7537111,12424.18902,79.5505618,988351.2167,233,129,99,104,30,78,56,male
31 ms,0 KB,United States,America,132,1742,799.6361326,12271.33456,110.96,1361627.282,215,127,93,88,34,60,47,male
31 ms,0 KB,United States,America,134,1878,815.0172944,13270.1155,109.9285714,1458764.84,234,140,100,94,40,67,47,male
