time,memory,country,continent,program_vocabulary,program_length,calculated_estimated_program_length,volume,difficulty,effort,loc,slocP,lsloc,comments,blankLine,cyclomatic_complexity,numberOfFunction,gender
155 ms,15900 KB,India,Asia,81,341,433.2506894,2161.888851,45.2,97717.37606,15,12,12,3,0,14,1,male
77 ms,9000 KB,China,Asia,76,253,399.1845378,1580.725661,27.74390244,43855.49852,34,25,22,9,3,11,2,male
62 ms,9000 KB,India,Asia,75,267,392.4020294,1663.09459,29.3125,48749.46018,34,25,22,9,3,11,2,male
77 ms,12600 KB,India,Asia,75,267,392.4020294,1663.09459,29.3125,48749.46018,34,25,22,9,3,11,2,male
109 ms,8100 KB,India,Asia,67,218,339.9564924,1322.407444,22.2972973,29486.11192,29,22,21,7,1,10,2,male
31 ms,500 KB,China,Asia,77,323,405.551932,2024.172053,45.30769231,91710.56454,27,18,16,9,2,12,1,female
93 ms,12600 KB,Iran,Asia,75,267,392.4020294,1663.09459,29.3125,48749.46018,34,25,22,9,3,11,2,male
62 ms,16100 KB,China,Asia,58,303,287.9357738,1774.968242,22.22222222,39443.7387,25,16,16,9,0,7,1,male
62 ms,31300 KB,China,Asia,80,344,426.6582949,2174.743265,29.94444444,65121.47887,42,35,33,7,2,14,1,male
62 ms,19500 KB,China,Asia,67,322,339.5249056,1953.280719,31.08571429,60719.12636,56,49,49,7,0,16,2,female
202 ms,31500 KB,Mexico,America,40,229,197.504662,1218.721534,18.5,22546.34837,27,19,19,8,0,5,1,male
46 ms,4100 KB,Belarus,Europe,54,320,263.4212455,1841.564001,21.375,39363.43051,32,26,26,6,0,18,1,male
265 ms,15800 KB,China,Asia,67,375,339.4387425,2274.783446,40.27941176,91626.93911,45,34,29,11,5,20,3,male
46 ms,35200 KB,China,Asia,66,357,333.3240179,2157.848701,30,64735.46102,38,31,31,7,0,15,2,male
93 ms,31500 KB,China,Asia,58,352,284.2247957,2062.00931,40.90909091,84354.92633,41,36,36,5,0,21,1,female
62 ms,15900 KB,China,Asia,63,346,316.1697866,2068.138854,30.0625,62173.42428,38,26,26,12,0,7,1,female
623 ms,110000 KB,Japan,Asia,53,311,258.0246044,1781.383261,38,67692.56393,54,45,45,9,0,10,2,male
46 ms,4000 KB,Iran,Asia,75,346,392.9423377,2155.171267,45.18181818,97374.55633,51,43,42,8,1,18,2,male
62 ms,700 KB,Jordan,Asia,75,370,392.9423377,2304.662915,44.39285714,102310.5716,36,23,19,13,4,14,2,male
77 ms,700 KB,Finland,Europe,80,351,425.8985773,2218.996761,48.63157895,107913.3162,40,37,37,3,0,13,1,male
514 ms,4000 KB,China,Asia,84,417,453.8154506,2665.596365,42.5106383,113316.2029,39,31,31,8,0,18,2,male
529 ms,4000 KB,China,Asia,84,417,453.8154506,2665.596365,42.5106383,113316.2029,39,31,31,8,0,18,2,male
61 ms,15900 KB,Mexico,America,68,376,346.1173001,2288.886028,52.3125,119737.3504,47,35,31,12,4,18,3,male
140 ms,4200 KB,Romania,Europe,61,428,302.2137048,2538.35558,79.2,201037.762,58,50,50,8,0,18,2,male
904 ms,31300 KB,India,Asia,71,343,366.1306865,2109.363262,34.734375,73267.41455,60,54,54,6,0,16,2,male
78 ms,15800 KB,China,Asia,95,443,532.5126722,2910.446034,32.85344828,95618.18825,46,28,28,18,0,12,1,male
46 ms,500 KB,South Korea,Asia,83,398,446.2065082,2537.265694,50.23255814,127453.3465,46,30,26,16,4,13,1,male
62 ms,15800 KB,Iran,Asia,0,0,0,0,0,0,49,38,33,11,5,16,4,female
46 ms,700 KB,Finland,Europe,79,357,419.0808777,2250.449727,47.47368421,106837.1397,43,37,37,6,0,13,1,male
202 ms,15700 KB,China,Asia,95,384,531.8959763,2522.824554,33.66666667,84935.0933,44,37,35,7,2,15,1,male
108 ms,31600 KB,Bangladesh,Asia,65,339,326.7316235,2041.582689,37.33333333,76219.08704,52,44,44,8,0,14,3,male
46 ms,4000 KB,Poland,Europe,71,333,367.3587806,2047.865791,47.79310345,97873.86159,67,39,28,28,11,14,1,male
77 ms,20400 KB,Iran,Asia,62,362,308.3287327,2155.419064,43.61538462,94009.4315,48,40,40,8,0,19,3,male
124 ms,19800 KB,Iran,Asia,80,346,425.7903187,2187.387121,44.15384615,96581.55441,56,41,36,15,5,12,1,male
140 ms,31800 KB,India,Asia,74,279,385.6555921,1732.437489,33.42857143,57912.91035,40,31,31,9,0,12,2,male
109 ms,4100 KB,Finland,Europe,59,318,288.6764386,1870.68049,41.25,77165.5702,55,31,24,24,7,16,2,male
46 ms,700 KB,Finland,Europe,72,361,372.8771238,2227.342926,51.25,114151.3249,41,35,35,6,0,13,1,male
62 ms,700 KB,Finland,Europe,78,367,412.2983693,2306.742614,46.31578947,106838.6053,42,37,37,5,0,13,1,male
171 ms,15900 KB,Bangladesh,Asia,63,342,315.5176503,2044.229734,50.92,104092.178,55,39,37,16,2,15,3,male
61 ms,20400 KB,India,Asia,63,367,314.9612072,2193.661732,44.82692308,98335.10571,56,44,40,12,4,19,3,male
61 ms,700 KB,Finland,Europe,72,361,372.8771238,2227.342926,51.25,114151.3249,45,39,39,6,0,13,1,male
156 ms,15900 KB,India,Asia,61,313,301.7363383,1856.320787,34.32692308,63721.78085,85,49,25,36,24,14,2,male
108 ms,35500 KB,Hong Kong,Asia,73,362,380.5361023,2240.71649,39.41666667,88321.57499,48,36,36,12,0,14,2,male
77 ms,32900 KB,Ukraine,Europe,78,353,412.4094067,2218.746983,47.37804878,105119.9028,51,40,35,11,5,10,1,male
77 ms,15800 KB,China,Asia,59,387,288.6764386,2276.58286,64.09615385,145920.2052,57,43,37,14,6,15,2,male
171 ms,15900 KB,Bangladesh,Asia,60,293,297.5287411,1730.718945,44.90909091,77725.01442,45,41,41,4,0,17,2,male
62 ms,16500 KB,China,Asia,64,383,322.9162238,2298,27.5,63195,63,54,54,9,0,17,2,female
77 ms,4200 KB,Bangladesh,Asia,58,321,282.2114327,1880.411899,35.07692308,65959.06355,47,41,39,6,2,17,3,male
109 ms,16400 KB,Bulgaria,Europe,87,361,473.9427998,2325.902602,54.04255319,125697.7151,41,32,28,9,4,12,1,male
373 ms,31800 KB,India,Asia,49,293,237.4749933,1645.109984,25.90909091,42623.30414,60,50,49,10,1,17,3,male
46 ms,16000 KB,India,Asia,71,329,367.3587806,2023.266802,42.72413793,86442.32993,43,39,39,4,0,19,2,male
46 ms,21400 KB,China,Asia,77,381,405.551932,2387.645672,35.92105263,85766.74585,65,56,56,9,0,18,1,female
171 ms,9000 KB,Lebanon,Asia,58,346,284.2247957,2026.861424,38.45454545,77942.03477,60,48,47,12,1,16,2,male
62 ms,15900 KB,China,Asia,60,386,295.6213103,2280.05977,40.6,92570.42666,66,57,57,9,0,18,2,male
171 ms,59200 KB,South Korea,Asia,107,483,618.5896441,3256.128554,43.17424242,140580.8836,45,36,34,9,2,21,1,male
155 ms,16000 KB,India,Asia,60,324,298.3693524,1913.832553,44.57142857,85302.25093,69,54,46,15,8,14,2,male
62 ms,16000 KB,China,Asia,68,440,345.9899115,2678.48365,41.89393939,112212.2317,50,45,45,5,0,16,1,male
31 ms,800 KB,Ukraine,Europe,42,261,214.8771238,1407.394847,20,28147.89695,47,34,30,13,4,14,1,male
452 ms,9900 KB,Syria,Asia,63,313,314.9612072,1870.888616,41.98076923,78541.34325,65,41,26,24,15,15,2,male
202 ms,4200 KB,Brazil,America,47,255,227.9505705,1416.420157,23.22222222,32892.42365,56,43,37,13,6,16,2,male
171 ms,4100 KB,China,Asia,78,381,413.1887278,2394.738245,58.23529412,139458.2861,55,35,31,20,4,20,3,female
280 ms,15800 KB,China,Asia,97,411,544.452116,2712.564178,38.56363636,104606.3386,54,47,47,7,0,17,4,female
77 ms,4100 KB,China,Asia,68,407,346.6279634,2477.597376,44.33333333,109840.1504,45,30,30,15,0,19,1,male
46 ms,32000 KB,China,Asia,74,473,386.4773318,2937.071442,37.71428571,110769.5515,48,42,42,6,0,16,2,male
171 ms,16900 KB,India,Asia,63,368,314.1308434,2199.639012,50.625,111356.725,40,34,31,6,3,11,1,male
46 ms,4000 KB,Iran,Asia,90,431,494.7804146,2797.988685,55.64285714,155688.0847,53,43,41,10,2,16,1,male
77 ms,32100 KB,China,Asia,58,369,283.5668306,2161.594987,40.32608696,87168.66742,74,68,68,6,0,15,1,male
280 ms,8100 KB,South Korea,Asia,71,440,366.4572094,2705.888733,78.06451613,211233.8946,67,41,29,26,12,19,3,male
109 ms,16000 KB,China,Asia,71,384,365.7235111,2361.502894,32.10294118,75811.18849,72,62,62,10,0,15,2,male
78 ms,4100 KB,China,Asia,81,375,432.9647657,2377.443751,33.63636364,79968.56254,53,32,29,21,3,7,2,female
46 ms,20700 KB,China,Asia,86,471,466.9609738,3026.770699,42.17391304,127650.7643,55,48,48,7,0,19,2,female
264 ms,15900 KB,Mexico,America,71,399,366.1306865,2453.749101,45.703125,112144.0019,72,55,47,17,8,17,2,male
62 ms,65500 KB,South Korea,Asia,46,407,223.4212455,2248.089716,19,42713.70461,64,56,56,8,0,19,1,male
77 ms,16100 KB,China,Asia,75,510,392.17102,3176.697532,73.94594595,234903.904,57,48,48,9,0,16,1,female
62 ms,16000 KB,Bangladesh,Asia,36,262,174.9737366,1354.52035,17,23026.84596,57,40,31,17,9,15,2,male
124 ms,39000 KB,Poland,Europe,72,397,372.3949821,2449.460226,37.13157895,90952.32574,60,42,36,18,6,9,3,male
390 ms,15800 KB,Romania,Europe,82,426,439.6362367,2708.317154,51.81818182,140340.0707,62,55,55,7,0,18,3,male
46 ms,15900 KB,Romania,Europe,64,335,321.1317371,2010,35.62962963,71615.55556,55,46,41,9,5,14,2,male
296 ms,44200 KB,Italy,Europe,73,468,378.8670746,2896.837894,61.66666667,178638.3368,66,46,37,20,9,21,3,male
46 ms,15900 KB,China,Asia,94,473,525.8801978,3100.320527,45.31034483,140476.5921,33,24,24,9,0,19,1,male
592 ms,31900 KB,India,Asia,64,316,322.2270913,1896,46.02,87253.92,50,41,40,9,1,14,3,male
77 ms,47400 KB,Iran,Asia,72,368,372.2346001,2270.532401,42,95362.36082,57,40,34,17,6,14,3,male
343 ms,4000 KB,Canada,America,67,355,342.5737365,2153.461663,55.44,119387.9146,49,46,45,3,1,15,1,male
62 ms,4000 KB,Bangladesh,Asia,70,409,359.2147805,2506.876754,59.42424242,148969.252,54,46,45,8,1,15,2,male
156 ms,16000 KB,Bangladesh,Asia,59,313,290.159225,1841.267274,39.13043478,72049.589,58,46,41,12,5,16,2,male
46 ms,15900 KB,Norway,Europe,68,392,347.0121354,2386.285434,72.62068966,173293.6939,52,46,44,6,2,22,1,male
46 ms,4000 KB,Romania,Europe,87,421,474.5420279,2712.479212,44.20408163,119902.6525,55,43,39,12,4,17,2,male
78 ms,15700 KB,United States,America,82,398,439.3544556,2530.305698,50.95238095,128925.0998,55,43,37,12,6,13,1,male
78 ms,15800 KB,India,Asia,63,432,314.4992626,2582.184927,44,113616.1368,63,61,61,2,0,25,1,male
124 ms,63600 KB,Bangladesh,Asia,56,361,275.6175548,2096.455127,24.08823529,50499.90438,70,45,33,25,12,16,2,male
46 ms,4200 KB,China,Asia,89,457,487.5430078,2959.410178,41.10638298,121650.6482,66,57,57,9,0,20,2,male
62 ms,4000 KB,Bangladesh,Asia,70,416,359.2147805,2549.781735,59.42424242,151518.848,55,47,46,8,1,15,2,male
31 ms,500 KB,Japan,Asia,67,356,341.2590864,2159.527752,60,129571.6651,51,38,35,13,3,11,1,male
46 ms,4000 KB,Moldova,Asia,72,386,372.5956925,2381.591051,62.63636364,149174.2031,57,46,46,11,0,18,2,male
46 ms,4000 KB,China,Asia,54,365,263.4212455,2100.533938,33.25,69842.75345,71,62,61,9,1,17,2,male
78 ms,4000 KB,Finland,Europe,73,404,378.9461511,2500.689122,64.6,161544.5173,59,42,35,17,7,16,1,female
46 ms,15800 KB,Poland,Europe,67,423,340.3026944,2565.955728,26.20689655,67245.73631,46,31,28,15,3,23,1,male
217 ms,47600 KB,South Korea,Asia,78,382,412.2983693,2401.023648,31.57894737,75821.7994,66,43,31,23,12,18,2,male
77 ms,51100 KB,United States,America,62,407,307.9068682,2423.357898,54.44444444,131938.3745,49,35,30,14,5,15,1,male
77 ms,15900 KB,India,Asia,66,382,333.6312234,2308.958554,45.93103448,106052.8549,71,51,44,20,7,15,3,male
61 ms,15700 KB,India,Asia,55,410,270.1306865,2370.357483,41.4375,98221.68818,56,52,50,4,2,20,2,male
343 ms,43500 KB,China,Asia,87,499,474.942584,3215.028804,32.19,103491.7772,44,34,34,10,0,19,1,male
997 ms,15900 KB,India,Asia,42,292,210.885574,1574.556687,26,40938.47387,44,34,32,10,2,19,2,male
46 ms,15600 KB,China,Asia,64,330,320.1804545,1980,24.93333333,49368,54,43,41,11,2,19,4,female
545 ms,31700 KB,India,Asia,64,325,322.2270913,1950,46.02,89739,51,41,40,10,1,14,3,male
327 ms,15900 KB,Lebanon,Asia,66,385,333.6312234,2327.091736,54.22413793,126184.5433,48,33,27,15,6,16,3,male
124 ms,4200 KB,India,Asia,65,322,327.8032081,1939.202436,45.74074074,88700.55586,50,36,29,14,7,15,2,male
46 ms,19400 KB,China,Asia,69,482,353.0013311,2944.308788,36.77419355,108274.5812,59,54,54,5,0,16,1,male
62 ms,16300 KB,Indonesia,Asia,66,419,334.0271833,2532.601136,69.89285714,177010.7294,64,44,29,20,15,16,2,male
46 ms,4800 KB,Italy,Europe,70,357,359.7107722,2188.154037,63.53225806,139018.367,78,45,34,33,11,14,2,male
140 ms,4100 KB,Syria,Asia,64,305,322.9162238,1830,41.66666667,76250,65,47,39,18,8,15,2,male
46 ms,4100 KB,China,Asia,69,422,359.1731716,2577.797321,36.31818182,93620.91179,50,38,34,12,4,22,3,male
171 ms,31900 KB,India,Asia,73,355,379.3421297,2197.387718,46.66666667,102544.7602,64,50,46,14,4,15,2,male
156 ms,16200 KB,Brazil,America,72,361,372.2746801,2227.342926,43.34285714,96539.40623,53,36,27,17,9,16,3,male
31 ms,600 KB,China,Asia,90,444,494.5555318,2882.382775,51.1875,147541.9683,52,40,40,12,0,13,1,male
30 ms,600 KB,China,Asia,90,444,494.5555318,2882.382775,51.1875,147541.9683,52,40,40,12,0,13,1,male
46 ms,15900 KB,South Korea,Asia,66,375,333.3240179,2266.647795,47.4,107439.1055,56,41,37,15,4,15,2,male
46 ms,3900 KB,Jordan,Asia,85,513,460.4869215,3288.01755,51.74468085,170137.4188,56,34,31,22,3,12,2,male
296 ms,15800 KB,Iran,Asia,86,427,466.9609738,2744.01505,56.08695652,153903.4528,63,47,36,16,11,17,1,male
46 ms,35400 KB,China,Asia,83,477,446.5546348,3040.893809,43.06666667,130961.16,44,35,35,9,0,25,4,male
61 ms,4000 KB,Bangladesh,Asia,82,414,439.3192644,2632.02653,52,136865.3796,56,47,43,9,4,14,2,male
31 ms,35400 KB,China,Asia,83,477,446.5546348,3040.893809,43.06666667,130961.16,44,35,35,9,0,25,4,male
514 ms,31800 KB,India,Asia,70,397,359.4212455,2433.325358,41.5625,101135.0852,72,57,51,15,6,19,3,male
389 ms,16000 KB,India,Asia,64,369,322.2270913,2214,59.28,131245.92,72,56,47,16,9,18,3,male
46 ms,17200 KB,India,Asia,63,405,314.4992626,2420.798369,44,106515.1282,58,53,52,5,1,15,1,male
62 ms,4100 KB,China,Asia,82,562,439.6362367,3572.944227,44.47727273,158914.8148,58,49,49,9,0,25,1,female
46 ms,15800 KB,India,Asia,57,444,277.0156616,2589.803166,53.2173913,137822.5685,71,67,66,4,1,25,1,male
78 ms,32200 KB,Tajikistan,Asia,75,385,393.3293845,2398.095196,56.4375,135342.4976,63,50,46,13,4,18,1,male
78 ms,15800 KB,Colombia,America,74,387,386.1246381,2403.058452,44.10606061,105989.4417,68,47,35,21,12,15,4,male
46 ms,19500 KB,United States,America,62,404,308.8461793,2405.495309,65.12,156645.8545,65,59,57,6,2,21,1,male
31 ms,500 KB,Ukraine,Europe,90,371,494.3950605,2408.477499,57.63829787,138820.5435,56,41,35,15,6,16,3,male
171 ms,34800 KB,India,Asia,66,362,334.5126491,2188.070671,50.55555556,110619.1284,66,48,41,18,7,16,2,male
62 ms,31600 KB,Brazil,America,67,470,339.9564924,2851.06192,76.46666667,218011.2014,70,49,35,21,14,17,2,male
483 ms,16100 KB,Bangladesh,Asia,74,427,386.1246381,2651.436587,60.87878788,161416.2456,73,58,52,15,6,19,3,male
78 ms,21800 KB,Bosnia and Herzegovina,Europe,61,345,301.3556992,2046.104381,44.7037037,91468.44402,58,40,31,18,9,17,3,male
156 ms,31600 KB,Thailand,Asia,92,472,510.1851706,3079.121243,43.62962963,134340.9194,54,37,31,17,6,18,4,male
78 ms,19600 KB,United States,America,76,460,398.9944238,2874.046656,55.35,159078.4824,62,50,44,12,6,18,3,male
202 ms,6800 KB,India,Asia,83,411,446.3456778,2620.141206,51.85227273,135860.2764,66,32,16,34,16,16,3,male
62 ms,16000 KB,Peru,America,73,366,378.8670746,2265.475789,44.75675676,101395.3488,62,47,41,15,6,18,3,male
61 ms,19900 KB,Thailand,Asia,74,396,385.5385456,2458.943533,46.89473684,115311.5099,60,44,39,16,5,21,3,male
124 ms,18300 KB,Italy,Europe,66,438,333.6312234,2647.444624,65.70689655,173955.3701,79,50,26,29,24,20,3,male
498 ms,96900 KB,India,Asia,58,333,283.0128366,1950.707671,29.75,58033.55322,54,37,36,17,1,13,2,male
452 ms,15900 KB,India,Asia,65,355,328.9735285,2137.940574,33.6,71834.80327,56,34,23,22,11,19,3,male
140 ms,32400 KB,India,Asia,83,469,446.5546348,2989.893493,52.77777778,157799.9344,63,46,37,17,9,17,3,male
93 ms,4900 KB,United Kingdom,Europe,69,370,355.5408171,2260.154049,38.86538462,87841.7564,79,66,66,13,0,16,2,male
264 ms,15900 KB,Syria,Asia,75,362,392.6333688,2254.832366,42.80882353,96526.72084,72,45,32,27,13,18,2,male
156 ms,4100 KB,Ukraine,Europe,83,368,446.1369639,2346.014511,36.60714286,85880.88834,66,44,37,22,7,7,1,male
218 ms,4800 KB,India,Asia,61,368,309.7018595,2182.51134,49.17647059,107328.2047,64,49,47,15,2,18,2,male
140 ms,4500 KB,Syria,Asia,97,421,544.452116,2778.563307,43.14545455,119882.3768,78,59,54,19,5,17,4,male
452 ms,14100 KB,India,Asia,56,369,271.0812322,2142.913966,37.86363636,81138.51518,54,39,30,15,9,18,1,male
108 ms,16000 KB,Bangladesh,Asia,60,340,297.5287411,2008.342803,57.86363636,116210.0176,59,32,19,27,13,10,3,male
124 ms,15900 KB,Bangladesh,Asia,60,340,297.5287411,2008.342803,57.86363636,116210.0176,59,32,19,27,13,10,3,male
202 ms,31900 KB,Bangladesh,Asia,44,269,220.8771238,1468.587105,20,29371.74211,59,50,50,9,0,16,2,male
171 ms,31500 KB,Lebanon,Asia,62,450,307.5796744,2679.38834,58.89285714,157796.8347,86,53,38,33,15,20,4,male
62 ms,31600 KB,China,Asia,102,445,581.4346098,2969.229277,37.63934426,111759.843,85,58,52,27,6,14,2,male
46 ms,4100 KB,Canada,America,89,423,487.7378322,2739.235241,43.5625,119327.9352,47,35,35,12,0,15,1,male
46 ms,600 KB,Iran,Asia,75,389,392.6333688,2423.010471,51.85294118,125640.2194,60,33,24,27,9,15,2,male
78 ms,4000 KB,Iran,Asia,81,436,432.9647657,2764.174601,70.16216216,193940.4666,91,53,25,38,28,18,2,male
545 ms,96800 KB,India,Asia,62,349,307.9068682,2078.014512,35,72730.50793,61,58,58,3,0,18,3,male
46 ms,900 KB,India,Asia,58,397,285.8598074,2325.618455,51.3,119304.2267,59,47,46,12,1,20,1,male
93 ms,19500 KB,Indonesia,Asia,86,401,466.692323,2576.932167,48.20454545,124219.8438,67,46,39,21,7,15,3,male
62 ms,8100 KB,Austria,Europe,92,405,508.2931913,2642.042592,44,116249.8741,73,59,54,14,5,20,2,male
436 ms,99300 KB,India,Asia,57,444,277.6324012,2589.803166,42.95454545,111243.8178,73,55,53,18,2,18,2,male
124 ms,16900 KB,Sweden,Europe,63,358,314.9612072,2139.866213,39.13461538,83742.84121,59,36,31,23,5,7,1,male
93 ms,15800 KB,Jordan,Asia,81,474,432.536756,3005.088901,61.46341463,184703.0252,61,53,53,8,0,15,2,male
655 ms,96900 KB,Cuba,America,72,378,372.3949821,2332.231651,46.94117647,109477.6975,71,39,20,32,19,14,3,female
421 ms,99300 KB,India,Asia,57,444,277.6324012,2589.803166,42.95454545,111243.8178,73,55,53,18,2,18,2,male
93 ms,4400 KB,Vietnam,Asia,66,412,332.9300119,2490.290377,35,87160.1632,78,38,31,40,7,18,3,male
155 ms,58200 KB,South Korea,Asia,87,551,473.5443757,3550.061866,71.34090909,253264.6409,60,52,51,8,1,19,2,female
31 ms,3900 KB,China,Asia,77,436,405.7769322,2732.318932,20.63414634,56379.06869,76,32,-6,44,38,20,1,male
31 ms,4000 KB,Indonesia,Asia,68,405,348.6887644,2465.422451,55.73076923,137399.8897,45,31,31,14,0,18,1,male
78 ms,15900 KB,South Korea,Asia,82,407,439.3544556,2587.523666,47.61904762,123215.4127,77,50,34,27,16,19,4,male
46 ms,15800 KB,China,Asia,76,479,398.8804611,2992.757279,50.59459459,151417.3412,66,35,24,31,11,6,1,male
139 ms,31500 KB,South Korea,Asia,82,407,439.3544556,2587.523666,47.61904762,123215.4127,77,50,34,27,16,19,4,male
62 ms,16100 KB,India,Asia,63,472,313.8551855,2821.276124,62.72413793,176962.1127,82,71,64,11,7,25,3,male
77 ms,35600 KB,India,Asia,62,416,308.3287327,2476.945665,41.53846154,102888.5122,77,70,67,7,3,21,1,male
779 ms,16000 KB,Indonesia,Asia,62,389,307.9068682,2316.182365,56.38888889,130606.95,71,42,32,29,10,17,4,male
46 ms,4200 KB,China,Asia,77,427,405.7769322,2675.917853,38.19512195,102207.0087,79,49,42,30,7,17,1,male
46 ms,15800 KB,China,Asia,77,430,406.6799972,2694.718212,36.66666667,98806.33446,72,60,60,12,0,21,3,male
31 ms,900 KB,Sweden,Europe,54,419,264.7340455,2411.297863,42.9,103444.6783,67,41,29,26,12,7,1,male
46 ms,15900 KB,South Korea,Asia,68,370,346.1173001,2252.361251,36,81085.00505,55,36,33,19,3,21,2,male
78 ms,31500 KB,India,Asia,91,454,504.7367812,2954.538767,38.125,112641.7905,65,55,52,10,3,14,1,male
46 ms,800 KB,India,Asia,66,448,334.0271833,2707.888565,52.92857143,143324.6734,80,76,75,4,1,23,2,male
139 ms,15900 KB,Syria,Asia,65,375,326.9987489,2258.38793,52.13793103,117747.6741,60,51,49,9,2,20,4,male
139 ms,31600 KB,Canada,America,88,377,480.9553238,2435.20572,43.75,106540.2503,62,54,50,8,4,15,3,male
217 ms,31700 KB,India,Asia,69,358,353.3374044,2186.851756,58.5,127930.8277,56,40,33,16,7,17,3,male
46 ms,700 KB,Finland,Europe,78,367,412.2983693,2306.742614,46.31578947,106838.6053,42,37,37,5,0,13,1,male
171 ms,4000 KB,South Korea,Asia,65,422,326.5538222,2541.439217,47.86764706,121652.7155,83,57,51,26,6,19,4,female
139 ms,31600 KB,India,Asia,70,399,361.711347,2445.583924,54.14814815,132423.8406,71,52,52,19,0,17,3,male
15 ms,600 KB,China,Asia,71,471,366.1306865,2896.530893,36.5625,105904.4108,51,19,19,32,0,10,1,female
265 ms,31700 KB,Ukraine,Europe,75,340,392.4020294,2117.798355,35.42857143,75030.57028,59,36,28,23,8,15,1,male
61 ms,16000 KB,China,Asia,83,470,446.2065082,2996.268533,33.95348837,101733.7688,52,31,31,21,0,12,1,female
77 ms,63100 KB,Estonia,Europe,66,411,334.5126491,2484.245983,44.77777778,111239.0146,42,33,32,9,1,17,1,male
93 ms,16000 KB,Chile,America,63,336,316.1697866,2008.366054,41.4375,83221.66837,66,46,36,20,10,10,2,male
62 ms,16000 KB,China,Asia,83,470,446.2065082,2996.268533,33.95348837,101733.7688,52,31,31,21,0,12,1,male
62 ms,15900 KB,Croatia,Europe,79,490,419.4466845,3088.852567,53.58139535,165505.0305,73,51,42,22,9,21,5,male
46 ms,16200 KB,South Korea,Asia,82,470,439.3544556,2988.049442,50,149402.4721,63,44,38,19,6,20,1,female
717 ms,16000 KB,Bangladesh,Asia,67,354,341.8710649,2147.395573,47.30769231,101588.3291,54,41,37,13,4,18,3,male
171 ms,16200 KB,Bangladesh,Asia,70,359,359.0910367,2200.412603,43.94117647,96688.7185,60,44,40,16,4,17,3,male
623 ms,155300 KB,India,Asia,58,436,284.2247957,2554.079714,73.63636364,188073.1426,62,56,53,6,3,14,2,male
218 ms,31700 KB,Bangladesh,Asia,43,261,211.030886,1416.255101,22.8,32290.6163,61,54,54,7,0,17,2,male
46 ms,16200 KB,China,Asia,79,532,419.0078103,3353.611358,78.4875,263216.5715,56,48,48,8,0,23,1,male
46 ms,4000 KB,China,Asia,70,445,359.4212455,2727.530943,57,155469.2637,74,46,40,28,6,17,1,female
327 ms,15900 KB,India,Asia,62,444,310.1726115,2643.663162,53.41304348,141206.0954,92,84,84,8,0,27,3,male
888 ms,15800 KB,India,Asia,72,350,372.8771238,2159.473751,44.375,95826.64768,50,39,38,11,1,14,2,male
546 ms,16100 KB,India,Asia,0,0,0,0,0,0,50,42,42,8,0,16,2,male
46 ms,17100 KB,China,Asia,63,440,314.4992626,2630.003166,65.33333333,171826.8735,61,55,52,6,3,20,1,male
62 ms,15900 KB,Vietnam,Asia,91,458,501.8524417,2980.569945,52.07,155198.277,56,41,37,15,4,13,2,male
374 ms,47200 KB,China,Asia,89,522,490.9485208,3380.332851,33.38181818,112841.6566,70,63,63,7,0,20,3,female
61 ms,15900 KB,China,Asia,83,456,446.1369639,2907.017981,47.12195122,136984.3595,65,55,55,10,0,22,2,male
576 ms,157600 KB,China,Asia,58,442,284.9884404,2589.2276,55.5,143702.1318,48,36,36,12,0,17,2,male
46 ms,34900 KB,India,Asia,64,456,320.4063545,2736,68.79310345,188217.931,61,52,48,9,4,20,1,male
77 ms,7700 KB,India,Asia,62,423,310.1726115,2518.625039,33.91304348,85414.24046,88,68,53,20,15,23,2,male
826 ms,129400 KB,Iran,Asia,65,337,327.3557123,2029.537953,46.25,93866.13033,62,44,34,18,10,15,3,male
124 ms,4000 KB,Iran,Asia,76,480,399.4510684,2999.005206,91.41176471,274144.3583,59,49,46,10,3,21,2,male
140 ms,15900 KB,Bangladesh,Asia,69,403,354.8592943,2461.735356,76.22222222,187638.9394,62,54,52,8,2,16,3,female
62 ms,4000 KB,China,Asia,80,460,426.079159,2908.086924,47.64864865,138566.4121,69,51,48,18,3,20,2,male
61 ms,19900 KB,Bangladesh,Asia,74,367,385.5385456,2278.869385,43.80555556,99827.13946,61,46,40,15,6,16,2,male
546 ms,47400 KB,India,Asia,75,446,392.17102,2778.053136,33.59210526,93320.65337,82,70,70,12,0,20,3,male
670 ms,157400 KB,Hong Kong,Asia,74,442,385.4995491,2744.578388,69,189375.9087,49,38,35,11,3,19,3,male
31 ms,20800 KB,China,Asia,73,478,380.0574174,2958.736139,43.35483871,128275.5281,63,36,35,27,1,21,1,female
108 ms,36700 KB,Iran,Asia,67,437,340.3026944,2650.880976,43.89655172,116364.5339,65,48,48,17,0,19,3,male
78 ms,15900 KB,China,Asia,63,340,314.1308434,2032.275174,31.25,63508.59919,60,38,33,22,5,10,2,male
109 ms,20500 KB,United States,America,83,400,446.2065082,2550.015773,51.1627907,130465.9232,54,36,29,18,7,14,4,male
966 ms,158400 KB,Vietnam,Asia,73,480,380.0574174,2971.115788,60.96774194,181142.2206,64,44,40,20,4,12,3,male
62 ms,31600 KB,India,Asia,71,476,365.7235111,2927.279629,44.07352941,129015.5448,76,56,49,20,7,21,3,male
467 ms,236200 KB,China,Asia,82,530,439.6362367,3369.502562,54.42105263,183371.8763,62,52,52,10,0,20,3,female
171 ms,4000 KB,Brazil,America,60,457,296.1564001,2699.449002,46.5,125524.3786,56,47,43,9,4,23,1,male
561 ms,31700 KB,India,Asia,41,278,208.1306865,1489.399457,19.5,29043.28942,61,45,42,16,3,15,3,male
451 ms,236200 KB,China,Asia,82,530,439.6362367,3369.502562,54.42105263,183371.8763,62,52,52,10,0,20,3,female
811 ms,16100 KB,Canada,America,65,353,327.8032081,2125.895838,57.7037037,122672.0635,64,47,38,17,9,15,3,male
327 ms,20700 KB,Bangladesh,Asia,69,408,353.3374044,2492.277978,70.2,174957.9141,72,58,52,14,6,17,3,male
93 ms,31500 KB,United States,America,84,456,453.5050955,2914.896745,59.06521739,172169.0099,60,46,39,14,7,16,2,male
46 ms,15800 KB,India,Asia,69,439,352.582306,2681.642237,43.09090909,115554.4018,78,63,63,15,0,21,2,male
61 ms,3900 KB,China,Asia,73,413,379.1044231,2556.397543,32.69230769,83574.53505,58,53,53,5,0,20,1,male
46 ms,15800 KB,Israel,Asia,87,467,473.5443757,3008.854613,68.40909091,205833.0087,66,45,38,21,7,20,2,male
733 ms,32100 KB,India,Asia,69,502,352.7497745,3066.479277,42.78125,131187.8166,79,68,63,11,5,23,3,male
46 ms,16200 KB,India,Asia,77,377,405.551932,2362.578526,31.66666667,74814.98665,80,39,26,41,13,11,4,male
607 ms,16100 KB,India,Asia,0,0,0,0,0,0,50,42,42,8,0,16,2,male
498 ms,16000 KB,Peru,America,74,349,386.1246381,2167.099225,50.31818182,109044.4928,64,43,30,21,13,16,3,male
108 ms,35100 KB,India,Asia,69,412,353.7585727,2516.712076,60,151002.7246,72,53,46,19,7,18,2,male
468 ms,15900 KB,India,Asia,65,398,328.9735285,2396.90239,33.6,80535.92029,62,38,25,24,13,23,3,male
46 ms,15900 KB,Romania,Europe,56,333,270.5069309,1933.849189,19.36956522,37457.81799,50,44,44,6,0,19,1,female
155 ms,31700 KB,India,Asia,0,0,0,0,0,0,73,40,27,33,13,12,2,male
93 ms,48100 KB,China,Asia,62,456,307.9068682,2715.113518,68.05555556,184778.5588,83,69,67,14,2,20,3,male
936 ms,4000 KB,India,Asia,61,330,302.2137048,1957.143321,32.4,63411.44361,66,57,53,9,4,13,2,male
654 ms,21400 KB,Macedonia,Europe,84,389,453.2640759,2486.611477,48.1,119606.0121,65,52,45,13,7,16,5,male
529 ms,16000 KB,Bangladesh,Asia,64,421,322.2270913,2526,77.22,195057.72,63,40,30,23,10,20,2,male
109 ms,16000 KB,Brazil,America,82,465,440.5905816,2956.261682,78.55714286,232235.4713,75,49,38,26,11,20,2,male
61 ms,500 KB,Romania,Europe,102,498,580.8907675,3322.86782,61.25,203525.654,68,50,41,18,9,20,5,male
155 ms,4100 KB,China,Asia,84,499,453.2640759,3189.766394,64.03846154,204267.7325,72,50,45,22,5,27,4,female
156 ms,31500 KB,Brazil,America,91,480,501.5981141,3123.741427,59.14285714,184746.993,70,51,44,19,7,16,3,male
78 ms,15700 KB,United States,America,79,437,419.4466845,2754.752187,47.30232558,130306.1848,58,49,45,9,4,19,2,male
467 ms,17000 KB,India,Asia,63,377,314.9612072,2253.434531,48.38461538,109031.5631,67,55,55,12,0,16,4,male
311 ms,31800 KB,India,Asia,72,395,372.5956925,2437.120376,52.59090909,128170.3761,86,51,29,35,22,17,4,male
31 ms,15800 KB,China,Asia,84,588,452.9546635,3758.682645,56.5,212365.5694,83,65,65,18,0,30,3,male
93 ms,4100 KB,Brazil,America,86,359,466.7930215,2307.029047,44.64444444,102996.0301,82,58,40,24,18,14,3,male
155 ms,62600 KB,India,Asia,37,339,181.5249056,1766.004691,17.5,30905.08209,71,54,44,17,10,7,2,female
155 ms,4200 KB,China,Asia,84,500,453.2640759,3196.158711,64.03846154,204677.0867,72,50,45,22,5,27,4,female
77 ms,31600 KB,China,Asia,91,439,502.1708162,2856.921847,45.88235294,131082.2965,64,45,45,19,0,16,1,male
62 ms,900 KB,South Korea,Asia,70,454,364.12295,2782.69449,67.08333333,186672.422,76,48,37,28,11,21,1,male
61 ms,35200 KB,Belarus,Europe,65,398,327.8032081,2396.90239,55.59259259,133250.018,66,43,30,23,13,18,2,male
62 ms,4000 KB,India,Asia,75,433,392.6333688,2697.078493,72.35294118,195141.5616,67,43,36,24,7,20,2,male
93 ms,17000 KB,Cuba,America,73,502,378.8670746,3107.291929,63.20833333,196406.744,79,58,40,21,18,18,1,male
93 ms,31800 KB,Kuwait,Asia,72,422,373.2397178,2603.708351,34.38709677,89533.97102,82,65,65,17,0,11,3,male
62 ms,4000 KB,Hungary,Europe,68,416,347.0121354,2532.384542,63.87931034,161766.9781,50,41,39,9,2,20,1,male
124 ms,19900 KB,Jordan,Asia,78,537,412.5946318,3375.260992,77,259895.0963,78,62,56,16,6,22,2,male
139 ms,17100 KB,Croatia,Europe,63,490,314.9612072,2928.867163,53.36538462,156300.1226,66,51,50,15,1,20,3,female
187 ms,19600 KB,Brazil,America,89,396,488.323496,2564.390439,46.02,118013.248,53,44,40,9,4,15,2,male
46 ms,22100 KB,Brazil,America,78,437,412.2613731,2746.72077,61,167549.9669,76,44,27,32,17,14,2,male
202 ms,16000 KB,China,Asia,85,483,459.8746234,3095.735822,42.86363636,132694.4946,82,62,59,20,3,14,2,male
342 ms,16800 KB,India,Asia,68,395,346.6279634,2404.547822,58.9,141627.8667,79,66,60,13,6,14,2,male
77 ms,33700 KB,China,Asia,75,508,392.4020294,3164.239895,74.85714286,236865.9578,54,42,38,12,4,17,2,male
61 ms,4000 KB,Hungary,Europe,93,562,515.5221939,3675.007252,68.8,252840.4989,52,44,41,8,3,26,2,male
78 ms,15700 KB,Czechia,Europe,82,426,441.0519366,2708.317154,29.04166667,78654.04401,61,43,43,18,0,16,2,male
77 ms,900 KB,United States,America,75,491,392.9423377,3058.349977,77,235492.9482,63,53,46,10,7,19,1,male
529 ms,16000 KB,Brazil,America,85,485,460.8279746,3108.554604,57.8125,179713.313,81,54,43,27,11,21,3,male
249 ms,16900 KB,United States,America,58,401,285.8598074,2349.050379,73.15,171833.0352,64,42,31,22,11,15,3,male
77 ms,31800 KB,Mexico,America,68,440,347.4830616,2678.48365,65,174101.4373,64,57,53,7,4,17,1,male
31 ms,4000 KB,Serbia,Europe,87,343,473.6107211,2209.929619,37.5,82872.36072,54,38,38,16,0,8,1,male
187 ms,15800 KB,Croatia,Europe,83,455,446.2065082,2900.642941,90.8375,263487.1532,72,35,22,37,13,14,3,female
685 ms,97100 KB,Brazil,America,62,416,310.1726115,2476.945665,43.23913043,107100.9767,85,49,32,36,17,15,2,male
234 ms,19400 KB,Czechia,Europe,79,432,419.0808777,2723.233283,66.89473684,182169.9738,75,57,51,18,6,16,2,male
764 ms,4300 KB,United States,America,64,408,320.4063545,2448,54.9137931,134428.9655,68,52,48,16,4,18,3,male
93 ms,39600 KB,Brazil,America,85,499,460.0105131,3198.286077,50.66666667,162046.4946,93,57,32,36,25,16,5,male
935 ms,20300 KB,Peru,America,71,490,365.6422056,3013.376089,61.25,184569.2854,71,64,64,7,0,19,5,female
46 ms,6200 KB,Serbia,Europe,94,474,522.6230769,3106.875116,44.68627451,138834.6743,57,48,48,9,0,19,2,male
109 ms,55500 KB,Peru,America,55,365,271.4804827,2110.196295,33.33333333,70339.87651,77,59,51,18,8,14,3,male
389 ms,16000 KB,Colombia,America,76,406,398.8804611,2536.65857,48.85897436,123938.5361,63,44,44,19,0,21,4,male
171 ms,51200 KB,Peru,America,68,421,347.0121354,2562.821856,64.55172414,165434.5695,81,42,17,39,25,18,4,male
46 ms,4000 KB,Belarus,Europe,63,439,314.9612072,2624.025886,86.80769231,227785.6318,54,52,52,2,0,20,2,male
61 ms,15900 KB,Brazil,America,73,409,379.1044231,2531.638245,57.35294118,145196.8993,69,43,27,26,16,18,2,male
78 ms,24900 KB,Brazil,America,77,425,405.551932,2663.38428,41.05263158,109338.9336,70,49,40,21,9,16,2,male
202 ms,19600 KB,Brazil,America,84,404,453.2640759,2582.496239,49.4,127575.3142,55,46,42,9,4,14,2,male
530 ms,4200 KB,Canada,America,64,346,320.4063545,2076,51.29310345,106484.4828,53,44,41,9,3,16,3,male
374 ms,39200 KB,Colombia,America,60,442,295.6213103,2610.845643,57.4,149862.5399,57,50,50,7,0,20,4,male
374 ms,39200 KB,Colombia,America,60,442,295.6213103,2610.845643,57.4,149862.5399,57,50,50,7,0,20,4,male
140 ms,3900 KB,Macedonia,Europe,90,415,494.2667787,2694.119035,40,107764.7614,83,51,38,32,13,11,2,male
93 ms,4000 KB,Belarus,Europe,83,390,446.2065082,2486.265378,59.6625,148336.8081,61,40,35,21,5,14,1,male
857 ms,81000 KB,United States,America,93,454,515.149526,2968.7781,60.79347826,180482.3469,75,48,39,27,9,16,3,male
327 ms,70500 KB,Belarus,Europe,67,401,339.6973857,2432.501765,42.38709677,103106.6877,62,43,37,19,6,20,1,male
93 ms,4000 KB,Macedonia,Europe,67,309,340.7366244,1874.42156,45.96428571,86156.44813,75,44,34,31,10,13,3,male
405 ms,19900 KB,Bosnia and Herzegovina,Europe,74,452,385.8508604,2806.672921,77.64705882,217929.8974,54,40,32,14,8,20,2,male
62 ms,34600 KB,Germany,Europe,91,515,501.5981141,3351.51424,51,170927.2262,76,57,51,19,6,20,2,male
218 ms,157200 KB,Ukraine,Europe,73,514,379.3421297,3181.569823,57.57575758,183181.2929,93,81,78,12,3,25,1,male
499 ms,101000 KB,Mexico,America,66,387,335.0885565,2339.180524,37.69230769,88169.11207,61,37,36,24,1,10,2,male
62 ms,16600 KB,Peru,America,70,427,359.2147805,2617.203848,57.18181818,149656.4746,68,44,38,24,6,15,2,male
124 ms,34500 KB,United States,America,128,606,778.127614,4242,48.81764706,207084.4588,71,51,45,20,6,20,3,male
61 ms,34800 KB,Canada,America,70,480,359.7107722,2942.055848,51.58064516,151753.1387,75,40,34,35,6,17,2,male
46 ms,800 KB,Bulgaria,Europe,67,465,340.3026944,2820.731474,64.20689655,181110.4139,76,56,42,20,14,20,1,male
186 ms,15800 KB,United States,America,90,473,495.0699333,3070.646515,50,153532.3257,60,49,45,11,4,20,2,male
187 ms,16000 KB,Brazil,America,67,393,340.7366244,2383.973052,45.96428571,109577.6185,85,41,24,44,17,16,3,male
78 ms,15800 KB,Cuba,America,68,498,346.6279634,3031.556495,91.2,276477.9523,67,45,29,22,16,19,2,male
78 ms,700 KB,Romania,Europe,75,442,393.7950768,2753.137861,89.41935484,246183.8113,68,50,37,18,13,15,1,male
62 ms,3900 KB,Belarus,Europe,91,361,501.2806672,2349.313865,57.14772727,134257.948,71,53,43,18,10,17,3,male
670 ms,97100 KB,Brazil,America,62,411,310.1726115,2447.174684,43.23913043,105813.7053,85,49,32,36,17,15,2,male
109 ms,4600 KB,Romania,Europe,61,389,303.4631705,2307.056824,33.86956522,78139.01157,59,48,47,11,1,21,2,male
93 ms,15900 KB,Brazil,America,76,399,399.1845378,2492.923078,65.6,163535.7539,101,54,32,47,22,15,2,male
109 ms,188400 KB,Estonia,Europe,73,426,378.9461511,2636.865262,45.6,120241.056,61,49,48,12,1,20,2,male
93 ms,16000 KB,Croatia,Europe,79,511,419.0078103,3221.231962,53.625,172738.564,93,63,50,30,13,23,2,male
311 ms,31500 KB,Bulgaria,Europe,71,383,366.4572094,2355.353147,57.41935484,135242.8581,75,52,42,23,10,13,2,male
187 ms,16200 KB,United States,America,68,426,346.6279634,2593.25917,69.66666667,180663.7222,79,58,44,21,14,19,2,male
124 ms,19700 KB,United States,America,77,439,405.6268983,2751.119291,67.02702703,184399.3471,67,47,40,20,7,16,3,male
61 ms,17200 KB,Belarus,Europe,63,444,314.4992626,2653.912286,65.33333333,173388.936,65,55,52,10,3,20,1,male
218 ms,15900 KB,Brazil,America,40,159,174.0391,846.1865671,76.5,64733.27238,71,47,37,24,10,23,5,male
93 ms,31500 KB,Hungary,Europe,61,388,305.1157897,2301.126087,47.61904762,109577.4327,66,57,55,9,2,21,2,male
78 ms,15900 KB,Colombia,America,82,511,439.6362367,3248.709074,73.52631579,238865.6093,68,46,39,22,7,23,3,male
124 ms,15700 KB,United States,America,61,438,306.0981941,2597.662954,33.825,87865.94941,54,41,41,13,0,15,2,male
46 ms,4400 KB,Croatia,Europe,83,516,446.3456778,3289.520347,62.61538462,205974.5817,81,60,49,21,11,22,4,male
62 ms,15800 KB,Colombia,America,77,508,405.7769322,3183.527563,66.29268293,211044.5833,88,63,52,25,11,20,4,male
155 ms,17400 KB,Germany,Europe,72,470,372.2346001,2899.864751,62,179791.6145,83,59,50,24,9,19,4,male
46 ms,8200 KB,Ukraine,Europe,47,350,244.9698787,1944.106098,29.33333333,57027.11221,66,56,56,10,0,18,1,male
234 ms,15800 KB,Canada,America,66,398,334.0271833,2405.66886,55.64285714,133858.2887,61,50,48,11,2,13,2,male
61 ms,4000 KB,Latvia,Europe,73,450,381.0964401,2785.421051,81.17241379,226099.3502,70,49,42,21,7,17,2,male
327 ms,16900 KB,Belarus,Europe,68,471,346.3298602,2867.194998,66.24193548,189928.5461,82,54,47,28,7,18,3,male
46 ms,17200 KB,Serbia,Europe,61,433,302.7888745,2568.009267,70.14583333,180135.1501,55,49,46,6,3,20,1,female
187 ms,71300 KB,Lithuania,Europe,84,631,453.092115,4033.552294,85.45454545,344685.3778,60,52,52,8,0,25,4,male
639 ms,31900 KB,Canada,America,74,486,385.4995491,3017.794336,55,165978.6885,75,53,45,22,8,25,5,male
78 ms,4300 KB,Bulgaria,Europe,70,377,359.7107722,2310.739697,45.91935484,106107.6761,62,44,38,18,6,18,2,male
77 ms,9100 KB,Brazil,America,70,427,360.541081,2617.203848,59.37931034,155407.7595,70,44,36,26,8,18,3,male
46 ms,4400 KB,Ukraine,Europe,96,607,538.0889994,3997.072238,71.42857143,285505.1599,76,49,42,27,7,23,3,male
312 ms,16000 KB,Brazil,America,67,409,340.7366244,2481.030479,73.125,181425.3538,85,47,17,38,30,21,3,male
280 ms,63000 KB,Netherlands,Europe,46,315,228.3868988,1739.922016,23.33333333,40598.18038,64,50,45,14,5,14,1,male
46 ms,4000 KB,Argentina,America,71,411,366.8663501,2527.546066,47.15,119173.797,71,49,43,22,6,20,3,male
810 ms,97000 KB,Brazil,America,64,443,320.4063545,2658,33.79310345,89822.06897,100,77,71,23,6,18,4,male
717 ms,31600 KB,Ukraine,Europe,82,435,439.3544556,2765.535122,60.95238095,168565.9503,67,48,42,19,6,17,2,male
61 ms,16800 KB,Germany,Europe,59,400,290.8572701,2353.05722,46.25,108828.8964,63,54,50,9,4,17,1,female
77 ms,31700 KB,Mexico,America,82,515,439.3544556,3274.139282,54.6,178768.0048,90,57,42,33,15,12,4,male
483 ms,16000 KB,Argentina,America,81,519,432.75063,3290.382151,50.35526316,165688.0591,77,57,52,20,5,23,3,male
452 ms,16000 KB,Argentina,America,81,519,432.75063,3290.382151,50.35526316,165688.0591,77,57,52,20,5,23,3,male
467 ms,15800 KB,France,Europe,93,539,515.7710242,3524.606599,47.76470588,168351.7976,78,51,43,27,8,16,2,male
62 ms,15800 KB,Poland,Europe,62,440,307.3464548,2619.846377,43.24137931,113285.7709,74,63,59,11,4,22,1,female
187 ms,700 KB,United States,America,81,387,432.75063,2453.521951,46.39473684,113830.5053,59,35,27,24,8,14,1,male
249 ms,59000 KB,Croatia,Europe,80,546,425.7903187,3451.77274,85.15384615,293931.7248,86,68,61,18,7,20,2,male
46 ms,900 KB,Canada,America,67,443,340.7366244,2687.277511,66.16071429,177792.1996,53,50,49,3,1,20,1,male
358 ms,800 KB,Belarus,Europe,74,553,385.6555921,3433.827711,80.22857143,275491.0918,75,62,52,13,10,30,2,female
62 ms,31500 KB,Poland,Europe,98,517,553.2066264,3419.804989,43.29661017,148065.9635,79,49,40,30,9,15,2,male
124 ms,47300 KB,Cuba,America,99,454,557.6636341,3009.727906,56.8490566,171100.1921,85,57,44,28,13,17,4,male
31 ms,4000 KB,Serbia,Europe,89,482,487.5430078,3121.303514,68.36170213,213377.6211,66,52,51,14,1,17,4,male
139 ms,1000 KB,Brazil,America,79,526,419.0808777,3315.788674,60.42105263,200343.442,115,60,23,55,37,22,5,male
61 ms,16100 KB,Mexico,America,89,528,487.4132344,3419.187252,65.90217391,225331.8729,98,63,41,35,22,22,4,male
374 ms,48500 KB,Belarus,Europe,64,425,321.6326782,2550,46.03846154,117398.0769,59,47,37,12,10,17,2,male
140 ms,7800 KB,United States,America,70,476,359.0498112,2917.538716,60.5,176511.0923,81,50,39,31,11,20,3,male
61 ms,4000 KB,United States,America,93,535,515.5221939,3498.449964,59.30232558,207466.2188,88,52,40,36,12,13,4,male
171 ms,31600 KB,Peru,America,70,492,360.541081,3015.607244,79.17241379,238752.9046,59,50,50,9,0,24,3,male
186 ms,31700 KB,Netherlands,Europe,68,384,346.3298602,2337.585731,53.70967742,125550.9756,84,45,28,39,17,13,3,male
280 ms,16800 KB,Romania,Europe,75,432,392.6333688,2690.849674,59.08823529,158997.5587,70,52,46,18,6,16,3,male
92 ms,33700 KB,Spain,Europe,64,461,320.1804545,2766,66.86666667,184953.2,98,49,28,49,21,16,3,male
156 ms,31700 KB,Netherlands,Europe,74,417,385.6555921,2589.342053,41.78571429,108197.5072,92,45,32,47,13,13,3,male
155 ms,600 KB,Germany,Europe,44,320,214.9310205,1747.018118,22.16666667,38725.56828,60,38,34,22,4,15,1,male
187 ms,700 KB,Germany,Europe,44,320,214.9310205,1747.018118,22.16666667,38725.56828,60,38,34,22,4,15,1,male
763 ms,141800 KB,Slovenia,Europe,79,499,419.0078103,3145.586593,54.1125,170215.5545,70,62,58,8,4,23,2,male
46 ms,31500 KB,Ukraine,Europe,72,487,372.2346001,3004.753476,62.5,187797.0922,72,54,47,18,7,21,3,male
78 ms,15900 KB,Brazil,America,64,566,322.2270913,3396,114.66,389385.36,97,61,35,36,26,28,4,male
311 ms,31700 KB,Ukraine,Europe,47,439,232.5286082,2438.464506,25.71428571,62703.37301,87,44,24,43,20,15,1,male
93 ms,47300 KB,Ukraine,Europe,70,424,359.0910367,2598.815999,45.52941176,118322.5637,82,63,56,19,7,20,3,male
62 ms,8000 KB,Argentina,America,88,456,480.4299824,2945.500818,44.5,131074.7864,77,48,38,29,10,13,5,male
77 ms,15900 KB,Brazil,America,86,555,466.9609738,3566.576939,60.43478261,215545.302,92,65,45,27,20,23,3,male
249 ms,125400 KB,Brazil,America,81,553,432.536756,3505.937052,46.125,161711.3465,76,53,49,23,4,22,2,male
155 ms,39500 KB,Finland,Europe,68,516,345.9899115,3141.130826,61.51515152,193227.1387,58,49,47,9,2,15,1,male
62 ms,900 KB,Belarus,Europe,72,600,372.3949821,3701.955001,90.52941176,335135.8086,82,68,57,14,11,32,2,female
46 ms,9500 KB,France,Europe,73,491,380.0574174,3039.203858,81.29032258,247057.862,81,63,51,18,12,20,1,female
155 ms,37000 KB,Serbia,Europe,104,622,595.637503,4167.673505,45.72580645,190570.232,88,46,46,42,0,18,5,male
46 ms,17200 KB,Armenia,Europe,70,412,359.4212455,2525.264603,59.375,149937.5858,66,0,-2,66,2,0,5,male
483 ms,102600 KB,Latvia,Europe,57,397,278.3559659,2315.657336,29.14285714,67484.87092,81,64,64,17,0,17,4,male
218 ms,16700 KB,Colombia,America,87,442,474.2088866,2847.781025,46.15384615,131436.0473,69,48,43,21,5,16,4,male
46 ms,17200 KB,Ukraine,Europe,62,523,307.9068682,3114.04467,66.11111111,205872.9532,76,45,32,31,13,20,1,male
78 ms,8100 KB,Brazil,America,81,552,432.75063,3499.597202,54.31578947,190083.3848,104,62,41,42,21,23,4,male
46 ms,900 KB,Cuba,America,69,433,353.3374044,2644.99109,66.3,175362.9093,78,61,50,17,11,18,1,male
61 ms,16000 KB,Italy,Europe,74,541,386.1246381,3359.314271,62.74242424,210771.5211,73,61,61,12,0,21,3,male
46 ms,3600 KB,Lithuania,Europe,82,525,439.460071,3337.714802,69.46153846,231842.8051,85,58,54,27,4,17,3,male
639 ms,16000 KB,Brazil,America,80,560,426.3322913,3540.279733,56.22222222,199042.3939,104,60,37,44,23,23,4,male
62 ms,4100 KB,Romania,Europe,56,384,273.4603973,2230.02429,25.31578947,56454.82545,92,82,79,10,3,23,3,male
46 ms,4100 KB,Latvia,Europe,75,481,392.17102,2996.06179,64.75,193995.0009,83,56,35,27,21,21,2,male
217 ms,35200 KB,Poland,Europe,74,515,385.5385456,3197.868483,59.11111111,189029.5592,81,46,36,35,10,13,2,male
202 ms,4200 KB,Brazil,America,80,543,425.8985773,3432.806956,55.64285714,191011.187,103,65,56,38,9,18,4,male
77 ms,8000 KB,Brazil,America,87,565,473.5443757,3640.263075,52.77272727,192106.6105,105,63,42,42,21,23,4,male
140 ms,15800 KB,United States,America,74,498,385.5385456,3092.307776,61.10526316,188956.2804,59,41,41,18,0,16,1,male
312 ms,32000 KB,Cuba,America,96,470,537.2412569,3094.932375,45.5,140819.4231,101,42,9,59,33,12,2,male
46 ms,8200 KB,Mexico,America,80,551,426.079159,3483.38238,56.94594595,198364.5047,107,78,78,29,0,21,6,male
62 ms,15900 KB,Romania,Europe,65,451,327.3557123,2716.087884,70.69642857,192017.7131,96,60,32,36,28,20,1,male
78 ms,21400 KB,Romania,Europe,60,429,297.5287411,2534.056066,39.72727273,100671.1364,82,61,48,21,13,18,1,male
311 ms,15800 KB,Armenia,Europe,0,0,0,0,0,0,110,61,50,49,11,17,4,male
234 ms,33500 KB,Italy,Europe,73,460,378.8670746,2847.319297,40.59722222,115593.2542,68,63,61,5,2,15,1,male
62 ms,31700 KB,Armenia,Europe,79,484,419.4466845,3051.029882,45.20930233,137934.9323,78,41,34,37,7,13,3,male
61 ms,16100 KB,Cuba,America,68,459,346.6279634,2794.145444,69.03333333,192889.1738,95,51,32,44,19,18,3,male
46 ms,4200 KB,Slovakia,Europe,81,497,432.75063,3150.905451,78.07894737,246019.3809,79,39,36,40,3,14,1,male
93 ms,16200 KB,Argentina,America,64,513,321.6326782,3078,46.03846154,141706.3846,104,60,39,44,21,12,3,male
62 ms,15900 KB,Romania,Europe,69,486,352.4986422,2968.742886,37.57352941,111546.1481,95,65,43,30,22,22,1,male
483 ms,31600 KB,Netherlands,Europe,98,529,550.7131734,3499.181508,68.3490566,239165.7549,60,43,35,17,8,19,2,male
280 ms,4000 KB,Bulgaria,Europe,65,472,327.3557123,2842.557608,79.28571429,225374.2103,80,54,45,26,9,21,4,male
78 ms,4400 KB,United States,America,78,518,412.2613731,3255.838349,66.5,216513.2502,122,87,64,35,23,21,2,male
46 ms,15700 KB,United States,America,88,477,480.5611817,3081.148882,56.15217391,173013.2079,84,46,29,38,17,13,1,male
109 ms,16600 KB,Bulgaria,Europe,94,605,522.1313521,3965.526255,77,305345.5217,95,62,45,33,17,24,6,male
904 ms,202300 KB,United States,America,72,483,374.2108333,2980.073776,64.5,192214.7585,63,50,47,13,3,17,2,male
46 ms,6400 KB,Canada,America,67,460,340.3026944,2790.401028,74.68965517,208414.0905,78,53,40,25,13,17,1,male
46 ms,6400 KB,Canada,America,67,460,340.3026944,2790.401028,74.68965517,208414.0905,78,53,40,25,13,17,1,male
46 ms,15800 KB,Romania,Europe,79,498,419.0078103,3139.282813,66.66666667,209285.5208,91,66,55,25,11,21,4,male
124 ms,8100 KB,Brazil,America,65,523,327.8032081,3149.698366,54.88888889,172883.4437,91,58,46,33,12,14,3,male
296 ms,219600 KB,Ukraine,Europe,54,545,263.4212455,3136.413689,34.4375,108010.2464,98,72,70,26,2,14,2,male
46 ms,15900 KB,Serbia,Europe,52,486,247.1756287,2770.413703,23.44736842,64958.91077,100,69,50,31,19,27,2,female
61 ms,16900 KB,Romania,Europe,74,596,385.6555921,3700.834206,83.01428571,307222.1082,108,80,61,28,19,28,2,male
77 ms,15900 KB,Serbia,Europe,81,508,432.6080183,3220.643801,78.07692308,251457.9583,82,68,64,14,4,20,2,male
62 ms,4000 KB,Romania,Europe,67,486,341.2590864,2948.119347,44.44444444,131027.5265,83,62,57,21,5,13,3,male
888 ms,4000 KB,Romania,Europe,76,499,398.8804611,3117.715829,73.25675676,228393.7501,92,59,48,33,11,21,3,male
46 ms,17100 KB,Brazil,America,88,726,481.2514689,4689.547355,82.7755102,388179.6749,78,48,43,30,5,20,1,male
311 ms,68000 KB,Poland,Europe,91,530,501.2806672,3449.131159,68.80851064,237329.5781,83,65,54,18,11,19,4,male
62 ms,17200 KB,United States,America,74,551,385.8508604,3421.408804,74.11764706,253586.7702,86,64,56,22,8,23,2,male
46 ms,700 KB,United States,America,80,453,425.7542476,2863.833427,63.5,181853.4226,71,55,51,16,4,15,2,male
46 ms,4200 KB,Belarus,Europe,42,411,204.359415,2216.242461,18.5,41000.48552,78,72,72,6,0,22,2,male
124 ms,15900 KB,United States,America,65,510,329.6987322,3071.407585,43.5625,133798.1929,108,72,53,36,19,26,3,male
467 ms,35000 KB,Brazil,America,71,571,366.1306865,3511.505605,57.890625,203283.2542,99,65,50,34,15,26,3,male
436 ms,31400 KB,Italy,Europe,59,486,295.9642001,2858.964522,54.35294118,155393.1305,74,45,34,29,11,19,3,male
46 ms,900 KB,Germany,Europe,77,476,406.6799972,2982.990393,48.66666667,145172.1991,73,50,44,23,6,12,1,male
31 ms,5000 KB,Armenia,Europe,69,463,353.0013311,2828.246823,60.06451613,169877.2769,87,63,57,24,6,19,2,male
46 ms,16900 KB,Slovakia,Europe,68,422,350.2540912,2568.909319,44,113032.01,75,43,37,32,6,11,2,male
46 ms,16000 KB,Spain,Europe,82,569,439.460071,3617.447091,72.55813953,262475.2308,79,68,61,11,7,22,3,male
685 ms,103100 KB,Colombia,America,79,465,419.0078103,2931.258048,54.6,160046.6894,85,60,48,25,12,17,4,male
389 ms,79900 KB,Cuba,America,81,543,432.6080183,3442.538552,71.61538462,246538.7224,114,58,33,56,25,19,3,male
295 ms,47500 KB,France,Europe,73,468,379.3421297,2896.837894,54.54545455,158009.3396,87,55,43,32,12,18,2,male
93 ms,15800 KB,Slovenia,Europe,119,751,706.6329384,5178.00814,69.62837838,360536.31,91,59,50,32,9,26,10,male
61 ms,800 KB,Ukraine,Europe,77,419,406.0022373,2625.783561,51,133914.9616,74,62,57,12,5,17,3,female
77 ms,31600 KB,Argentina,America,51,383,257.3293845,2172.538906,26.875,58386.9831,97,59,44,38,15,15,4,male
77 ms,700 KB,Cuba,America,68,486,347.0121354,2958.506941,66.56896552,196944.7465,83,69,58,14,11,22,1,female
108 ms,31500 KB,Bulgaria,Europe,84,513,453.092115,3279.258838,55.90909091,183340.3805,98,54,40,44,14,15,5,male
93 ms,4200 KB,Ukraine,Europe,101,622,572.689722,4141.407542,82.21052632,340467.2937,71,57,57,14,0,24,3,male
62 ms,15900 KB,Brazil,America,77,540,405.6268983,3384.064732,68.64864865,232311.4708,104,62,43,42,19,20,4,male
62 ms,4000 KB,Hungary,Europe,69,588,354.26557,3591.812381,43.19642857,155153.4669,89,71,66,18,5,18,1,male
77 ms,19400 KB,Venezuela,America,73,489,379.3421297,3026.824209,42.42424242,128410.724,83,40,31,43,9,15,2,male
155 ms,15700 KB,United Kingdom,Europe,96,547,536.9091685,3601.974488,49.49056604,178263.7563,110,69,41,41,28,17,2,male
124 ms,63500 KB,Belarus,Europe,68,427,346.3298602,2599.346633,48.93548387,127200.2852,84,63,58,21,5,10,1,male
93 ms,31600 KB,Argentina,America,51,388,257.3293845,2200.901033,26.875,59149.21525,99,59,43,40,16,15,4,male
62 ms,800 KB,Netherlands,Europe,48,407,251.8882768,2273.079738,22.5,51144.2941,81,58,44,23,14,22,3,male
78 ms,31600 KB,Argentina,America,50,388,250.4773318,2189.816202,26.25,57482.67529,99,59,43,40,16,15,4,male
78 ms,15800 KB,Venezuela,America,73,489,379.3421297,3026.824209,42.42424242,128410.724,87,40,30,47,10,15,2,male
171 ms,15800 KB,Cuba,America,67,481,340.3026944,2917.788901,49.79310345,145285.7646,101,63,55,38,8,18,2,male
77 ms,3900 KB,Ukraine,Europe,81,457,432.9647657,2897.311451,63.62162162,184331.6529,104,63,61,41,2,16,1,male
78 ms,15600 KB,Ukraine,Europe,79,546,419.4466845,3441.864289,64.46511628,221880.1816,96,59,47,37,12,19,2,male
78 ms,35400 KB,United States,America,77,438,405.551932,2744.852505,43.35897436,119013.9894,97,68,56,29,12,19,2,male
171 ms,4100 KB,Romania,Europe,81,515,432.75063,3265.022751,57.88372093,188991.6658,92,61,47,31,14,21,2,male
46 ms,3900 KB,Serbia,Europe,86,500,466.7930215,3213.132377,51.58536585,165750.6092,80,50,45,30,5,19,2,male
46 ms,45400 KB,Armenia,Europe,75,581,393.7950768,3618.943659,46.12903226,166938.3688,98,48,40,50,8,10,1,male
124 ms,900 KB,Cuba,America,67,444,340.7366244,2693.343601,69.64285714,187572.1436,58,49,48,9,1,21,1,male
61 ms,3900 KB,Serbia,Europe,85,508,459.8746234,3255.970596,52.58536585,171216.405,80,49,44,31,5,19,2,male
171 ms,15700 KB,United Kingdom,Europe,98,551,551.3041687,3644.705124,48.47272727,176668.7975,112,69,40,43,29,17,2,male
280 ms,48500 KB,Italy,Europe,57,508,277.6324012,2963.108127,39.77272727,117850.8914,94,77,70,17,7,20,3,male
62 ms,36200 KB,Brazil,America,94,667,523.6410489,4371.910764,65.92592593,288222.2652,117,57,38,60,19,16,3,male
202 ms,8100 KB,Latvia,Europe,59,457,300.4363582,2688.367874,45,120976.5543,81,32,25,49,7,18,5,male
62 ms,4200 KB,Ukraine,Europe,86,561,467.4994455,3605.134527,74.52631579,268677.3943,81,66,65,15,1,23,2,male
109 ms,16000 KB,Poland,Europe,90,616,494.5555318,3998.981507,78.28571429,313063.1237,110,67,48,43,19,28,6,male
202 ms,16900 KB,Brazil,America,79,595,419.4466845,3750.749545,74.65277778,280003.8723,103,76,65,27,11,29,5,male
77 ms,15900 KB,Venezuela,America,94,541,523.6410489,3546.032569,44.44444444,157601.4475,100,44,31,56,13,11,4,male
62 ms,32000 KB,Argentina,America,80,571,426.6582949,3609.820942,66.21428571,239021.7152,85,53,48,32,5,12,3,male
62 ms,4100 KB,United States,America,70,446,361.711347,2733.660226,46.18518519,126254.6038,85,41,35,44,6,11,1,male
61 ms,4100 KB,Armenia,Europe,86,534,466.9609738,3431.625379,63.04347826,216341.6,97,49,35,48,14,17,2,male
46 ms,17200 KB,Canada,America,81,495,432.6080183,3138.225751,56.64285714,177758.0729,59,53,51,6,2,20,1,male
124 ms,15800 KB,Bosnia and Herzegovina,Europe,84,572,452.9546635,3656.405566,68.5,250463.7813,109,92,92,17,0,29,5,male
46 ms,900 KB,Germany,Europe,67,511,340.3026944,3099.771576,75.34482759,233551.755,88,65,48,23,17,23,3,female
46 ms,33000 KB,Belarus,Europe,75,474,392.6333688,2952.460059,60.89705882,179796.1339,104,69,57,35,12,15,1,male
78 ms,8100 KB,Bulgaria,Europe,90,521,494.3950605,3382.255463,65.41489362,221249.8813,100,67,44,33,23,19,4,male
62 ms,900 KB,Portugal,Europe,45,522,221.6404615,2866.747316,26,74535.43022,89,59,57,30,2,15,3,male
31 ms,200 KB,Romania,Europe,72,501,372.3949821,3091.132426,65.38235294,202105.5112,93,79,78,14,1,22,4,male
93 ms,114600 KB,Peru,America,79,663,419.0078103,4179.406636,46.15384615,192895.6909,123,84,75,39,9,15,4,male
343 ms,4000 KB,Poland,Europe,87,581,473.5443757,3743.350171,89.02325581,333245.2199,120,52,12,68,40,25,2,male
93 ms,15800 KB,Belarus,Europe,83,628,447.1829761,4003.524763,74.29787234,297453.3717,92,44,14,48,30,23,2,male
218 ms,31600 KB,Croatia,Europe,84,565,452.9546635,3611.659344,68,245592.8354,94,65,48,29,17,22,2,male
639 ms,52600 KB,United States,America,75,621,393.3293845,3868.096407,55.09375,213107.9364,110,78,73,32,5,24,3,male
374 ms,15800 KB,Brazil,America,96,643,537.2412569,4234.130888,73.88888889,312855.2267,102,49,33,53,16,20,3,male
124 ms,101700 KB,Lithuania,Europe,71,506,366.4572094,3111.772042,62.58064516,194736.702,85,71,64,14,7,25,1,male
46 ms,4000 KB,Bulgaria,Europe,85,517,461.2380824,3313.655114,70.77777778,234533.1453,115,84,65,31,19,21,7,female
46 ms,16200 KB,Poland,Europe,100,675,564.6454601,4484.602928,63.71276596,285726.4568,102,2,-1,100,3,2,2,male
46 ms,1100 KB,Belarus,Europe,55,509,267.8084246,2942.712094,51.38888889,151222.7048,82,59,53,23,6,21,2,male
109 ms,32300 KB,Czechia,Europe,48,387,232.6405265,2161.380488,22.8,49279.47512,96,47,40,49,7,22,5,male
61 ms,700 KB,Poland,Europe,55,549,282.613175,3173.966483,56.22222222,178447.4489,100,57,47,43,10,11,4,female
62 ms,700 KB,Germany,Europe,93,550,515.149526,3596.537346,46.48913043,167199.8938,91,51,42,40,9,11,3,male
108 ms,19700 KB,Mexico,America,78,508,412.4094067,3192.984327,51.52702703,164524.9897,114,69,59,45,10,12,4,male
46 ms,15800 KB,Netherlands,Europe,85,590,461.2380824,3781.540652,53.08333333,200736.783,104,56,40,48,16,15,5,male
46 ms,4200 KB,Ukraine,Europe,92,562,508.6701412,3666.241819,47.61904762,174582.9438,114,64,42,50,22,13,4,male
389 ms,800 KB,Bosnia and Herzegovina,Europe,73,464,379.3421297,2872.078595,68.48484848,196693.8674,65,0,-1,65,1,0,4,male
78 ms,4200 KB,Germany,Europe,82,495,439.6362367,3146.988242,50.36842105,158508.8288,89,68,58,21,10,12,1,male
46 ms,9100 KB,Belarus,Europe,41,432,200.7497745,2314.462466,18.5,42817.55562,132,61,23,71,38,18,3,female
202 ms,51900 KB,United States,America,69,564,353.3374044,3445.207794,75.4,259768.6676,100,74,59,26,15,22,1,male
436 ms,16100 KB,Ukraine,Europe,73,461,381.7393272,2853.509122,47.41071429,135286.9057,96,68,63,28,5,11,3,male
31 ms,400 KB,Argentina,America,88,708,480.4627738,4573.277586,60.2,275311.3107,138,117,105,21,12,27,8,male
342 ms,160600 KB,Mexico,America,61,522,303.4631705,3095.84489,35.52173913,109969.7946,86,54,47,32,7,25,2,male
343 ms,4000 KB,Poland,Europe,86,702,467.4994455,4511.237858,115.5789474,521404.1229,112,74,58,38,16,35,4,male
78 ms,8100 KB,Brazil,America,81,566,433.6087556,3588.355102,46,165064.3347,106,53,26,53,27,19,6,male
436 ms,97100 KB,Poland,Europe,69,492,353.3374044,3005.394033,40.95,123070.8856,101,52,41,49,11,13,3,male
187 ms,16800 KB,Ukraine,Europe,84,677,453.8154506,4327.598895,74.31081081,321587.3828,99,49,32,50,17,15,3,male
61 ms,27500 KB,Ukraine,Europe,88,618,480.4627738,3991.92874,73.1,291809.9909,97,65,54,32,11,20,1,male
78 ms,8200 KB,Brazil,America,81,573,433.6087556,3632.734052,46,167105.7664,107,54,27,53,27,19,6,male
624 ms,51100 KB,Poland,Europe,78,520,412.85429,3268.409154,54.67142857,178688.5976,103,62,51,41,11,20,4,male
280 ms,40200 KB,Cuba,America,89,535,487.3483806,3464.517386,48.88888889,169376.4055,104,59,36,45,23,22,2,male
15 ms,300 KB,Peru,America,89,673,487.9979062,4358.168599,64.89795918,282836.2479,108,81,80,27,1,22,4,male
93 ms,700 KB,United States,America,80,550,426.6582949,3477.060452,67.5,234701.5805,82,50,30,32,20,24,7,male
171 ms,4000 KB,Bulgaria,Europe,92,625,508.1990654,4077.226223,72.58888889,295961.3212,72,51,46,21,5,20,4,male
592 ms,1700 KB,Peru,America,83,601,446.2065082,3831.398698,69.3375,265659.6072,92,71,64,21,7,28,4,female
77 ms,16500 KB,Germany,Europe,75,483,392.17102,3008.519428,47.75675676,143677.1305,118,58,34,60,24,14,3,male
108 ms,500 KB,Italy,Europe,39,378,190.8721876,1997.882039,18,35961.8767,81,56,47,25,9,19,1,male
62 ms,15900 KB,Poland,Europe,103,783,585.7165578,5235.529913,82.38461538,431327.1182,116,80,60,36,20,30,7,male
171 ms,15900 KB,Cuba,America,84,601,453.092115,3841.782771,85.8,329624.9618,107,78,57,29,21,27,4,male
61 ms,8800 KB,Romania,Europe,90,565,494.7804146,3667.896999,75.7244898,277749.6289,105,79,62,26,17,26,5,male
62 ms,74400 KB,Ukraine,Europe,88,702,482.043467,4534.520996,79.07843137,358582.8074,113,80,66,33,14,21,1,male
61 ms,8200 KB,Poland,Europe,73,624,379.6596322,3862.450525,88.40625,341464.7667,92,78,75,14,3,24,1,male
171 ms,31600 KB,Ukraine,Europe,75,636,392.6333688,3961.528687,65.11764706,257965.4269,120,92,71,28,21,31,4,male
46 ms,15900 KB,United States,America,71,507,366.1306865,3117.92179,71.90625,224198.0637,114,48,34,66,14,19,2,male
78 ms,15900 KB,Iceland,Europe,78,512,413.1887278,3218.125936,44.64705882,143679.858,108,56,40,52,16,16,4,male
124 ms,43500 KB,United States,America,87,530,473.7434822,3414.760053,48.13043478,164353.886,116,66,40,50,26,19,3,male
701 ms,158400 KB,Brazil,America,71,593,366.8663501,3646.800042,94.98333333,346385.224,96,52,35,44,17,25,3,male
140 ms,16600 KB,Brazil,America,58,578,291.9327434,3385.913015,48.73333333,165006.8276,92,68,68,24,0,19,3,male
46 ms,4900 KB,United States,America,54,566,283.587975,3257.266326,28,91203.45713,120,68,49,52,19,16,2,male
61 ms,4300 KB,Belarus,Europe,102,506,580.8907675,3376.247223,50.4,170162.86,97,40,26,57,14,18,1,male
124 ms,47300 KB,Poland,Europe,77,619,405.6268983,3879.140869,42.16216216,163552.9664,101,75,70,26,5,16,3,male
46 ms,6300 KB,Belarus,Europe,50,423,242.4407955,2387.351168,20.58333333,49139.64488,129,51,16,78,35,19,1,male
280 ms,15900 KB,United States,America,85,578,460.0105131,3704.627961,44.44444444,164650.1316,121,63,44,58,19,27,7,male
670 ms,95000 KB,Hungary,Europe,71,537,366.8663501,3302.414203,76.53333333,252744.767,119,66,33,53,33,25,1,male
109 ms,4000 KB,Canada,America,95,625,530.851908,4106.159755,58.54545455,240396.9893,95,59,54,36,5,17,3,male
171 ms,4600 KB,Brazil,America,74,583,385.5385456,3620.111312,61.75,223541.8735,87,75,72,12,3,22,2,male
46 ms,4400 KB,Romania,Europe,69,500,352.4986422,3054.262228,28.65714286,87526.429,88,62,49,26,13,21,3,male
186 ms,47400 KB,Brazil,America,121,787,719.9353928,5445.145368,69.04109589,375938.8035,106,70,54,36,16,30,7,male
15 ms,900 KB,Poland,Europe,88,639,480.9553238,4127.576804,45,185740.9562,104,63,53,41,10,19,7,male
140 ms,3900 KB,France,Europe,97,646,543.3775424,4263.543696,59.98039216,255729.0229,98,70,61,28,9,17,4,male
187 ms,17000 KB,United States,America,104,703,595.104362,4710.409122,63.44262295,298840.7099,134,70,49,64,21,23,7,male
31 ms,700 KB,Ukraine,Europe,70,548,362.4264239,3358.847093,67.69230769,227368.1109,111,66,56,45,10,15,5,female
233 ms,17000 KB,United States,America,104,705,595.104362,4723.810001,63.44262295,299690.8968,134,69,48,65,21,22,7,male
560 ms,126900 KB,Belarus,Europe,91,613,501.4075845,3989.278114,57.78125,230505.4761,159,77,45,82,32,21,4,male
187 ms,15800 KB,Ukraine,Europe,87,603,473.7434822,3885.094928,77.97560976,302942.646,122,82,71,40,11,19,4,male
93 ms,16100 KB,Brazil,America,69,637,352.582306,3891.130079,77.45454545,301385.7116,123,98,83,25,15,19,4,male
920 ms,81000 KB,Ukraine,Europe,78,578,412.85429,3632.962483,73.71428571,267801.2344,117,66,58,51,8,23,4,male
31 ms,4000 KB,United States,America,100,554,564.8477751,3680.696329,49.40740741,181853.6631,105,55,40,50,15,7,1,male
155 ms,196100 KB,Romania,Europe,88,789,480.5611817,5096.491547,64.82608696,330385.6042,117,88,81,29,7,23,2,male
61 ms,800 KB,Switzerland,Europe,82,604,439.8831639,3839.961411,74.7972973,287218.7353,119,64,50,55,14,20,3,male
140 ms,48400 KB,Armenia,Europe,98,656,550.2710095,4339.249658,64.0625,277983.1812,117,101,101,16,0,24,10,male
62 ms,15800 KB,United States,America,80,652,427.0575866,4121.897118,90.64705882,373637.8505,94,65,57,29,8,30,6,male
61 ms,20100 KB,Poland,Europe,101,801,572.345265,5333.227398,50.625,269994.637,116,65,62,51,3,12,2,male
31 ms,100 KB,Poland,Europe,103,682,585.8847075,4560.19336,81.21296296,370346.8144,117,77,61,40,16,26,8,male
186 ms,71300 KB,Lithuania,Europe,86,681,466.9609738,4376.286298,88.26086957,386254.8341,97,57,53,40,4,25,4,male
155 ms,63600 KB,United States,America,46,489,242.2149912,2701.021797,22,59422.47952,108,65,52,43,13,12,4,male
265 ms,8200 KB,Peru,America,89,612,487.5430078,3963.14886,51.38297872,203638.3935,112,83,82,29,1,26,9,male
62 ms,19700 KB,Poland,Europe,101,720,571.8296011,4793.912268,78.12765957,374537.1457,103,2,-15,101,17,2,2,male
155 ms,33300 KB,Peru,America,102,812,578.7005665,5418.009378,75.81132075,410746.4468,137,104,92,33,12,28,9,male
46 ms,100 KB,Ukraine,Europe,81,500,432.75063,3169.925001,70.15789474,222395.2646,100,84,80,16,4,25,3,male
233 ms,66500 KB,Ukraine,Europe,82,549,439.3544556,3490.296051,64.28571429,224376.1747,101,69,51,32,18,21,1,male
31 ms,0 KB,Romania,Europe,80,530,426.079159,3350.62189,45.32432432,151864.6732,145,107,91,38,16,29,3,male
109 ms,40300 KB,Brazil,America,76,790,399.7943904,4935.862736,87.3030303,430915.774,141,95,78,46,17,33,4,male
31 ms,4000 KB,United States,America,82,653,439.3544556,4151.481459,88.57142857,367702.6435,112,96,87,16,9,28,6,male
61 ms,19700 KB,Colombia,America,81,596,432.6080183,3778.550602,49.53846154,187183.5837,115,84,76,31,8,29,10,male
155 ms,59100 KB,United States,America,86,757,466.9609738,4864.682419,64.4,313285.5478,135,97,92,38,5,28,3,male
46 ms,19800 KB,Cuba,America,90,618,494.2667787,4011.965214,53,212634.1563,110,49,27,61,22,22,2,male
280 ms,5400 KB,Venezuela,America,84,771,453.2640759,4928.476733,40.73333333,200753.2856,147,83,60,64,23,33,3,male
109 ms,16000 KB,Colombia,America,99,851,558.5412601,5641.582484,82.16071429,463516.4466,131,89,76,42,13,28,5,male
62 ms,20800 KB,United States,America,83,690,446.2065082,4398.777208,76.27906977,335534.6335,80,40,31,40,9,20,1,male
186 ms,165300 KB,United States,America,81,590,432.75063,3740.511502,42.41860465,158667.2786,115,87,73,28,14,10,3,male
186 ms,59300 KB,United States,America,86,759,466.9609738,4877.534949,64.4,314113.2507,136,97,92,39,5,28,3,male
624 ms,15700 KB,United States,America,92,674,508.2931913,4396.880758,69.81818182,306982.2202,118,50,36,68,14,17,4,male
420 ms,46800 KB,United States,America,86,546,466.7930215,3508.740556,71.34146341,250318.686,128,86,68,42,18,22,5,male
124 ms,15800 KB,Brazil,America,92,781,508.6701412,5094.901888,77.7,395873.8767,125,64,32,61,32,28,3,male
967 ms,16000 KB,United States,America,88,716,480.9553238,4624.953039,58.75,271715.991,146,85,63,61,22,38,10,male
46 ms,4100 KB,Canada,America,104,730,593.0955666,4891.320994,58.8,287609.6745,96,47,35,49,12,27,8,male
654 ms,15700 KB,United States,America,93,681,515.3357736,4453.16715,71.27272727,317389.3678,121,52,38,69,14,17,4,male
109 ms,31900 KB,Peru,America,141,853,876.2199695,6090.037304,67.61290323,411765.1028,101,58,58,43,0,26,5,male
217 ms,3900 KB,Argentina,America,114,810,668.0313232,5534.640911,71.02941176,393122.2883,153,86,57,67,29,23,10,male
93 ms,4100 KB,United States,America,57,517,290.1529393,3015.604137,30,90468.12412,153,101,76,52,25,23,3,male
140 ms,17100 KB,Mexico,America,102,782,580.4053244,5217.836617,67.77966102,353663.1972,145,112,93,33,19,31,3,male
124 ms,900 KB,Mexico,America,65,612,334.7944727,3685.689102,30.26315789,111540.5912,137,75,59,62,16,15,4,male
108 ms,31900 KB,Peru,America,136,834,837.4059514,5910.94401,67.59550562,399553.249,105,58,58,47,0,26,5,male
623 ms,15800 KB,United States,America,96,748,536.2766595,4925.551951,75,369416.3963,135,66,52,69,14,19,4,male
405 ms,16900 KB,United States,America,92,666,508.1990654,4344.692263,67.5,293266.7277,120,73,67,47,6,20,5,male
93 ms,700 KB,Argentina,America,72,815,374.820929,5028.488876,72.28571429,363487.9102,143,92,83,51,9,20,7,male
77 ms,49100 KB,United States,America,90,645,494.2667787,4187.245247,92,385226.5627,138,73,48,65,25,22,2,male
109 ms,23700 KB,Peru,America,111,952,643.4988053,6468.283905,73.59322034,476021.8426,157,99,83,58,16,41,9,male
93 ms,47200 KB,Venezuela,America,116,954,683.7654348,6542.513869,46.90140845,306853.1153,145,73,51,72,22,36,21,male
436 ms,33600 KB,United States,America,92,681,508.1990654,4442.545692,66.54255319,295618.333,124,76,70,48,6,20,5,male
93 ms,4100 KB,United States,America,186,5996,1241.932348,45204.79623,1022.142857,46205759.58,77,54,41,23,13,39,13,male
171 ms,700 KB,United States,America,99,742,557.4885414,4918.982612,58.63829787,288440.7676,107,52,45,55,7,27,9,male
62 ms,39600 KB,Cuba,America,74,720,386.1246381,4470.806423,57.15151515,255513.361,165,82,57,83,25,25,2,male
795 ms,4000 KB,Canada,America,127,781,766.0768791,5458.16274,73.51898734,401278.5974,147,67,47,80,20,33,8,male
46 ms,4100 KB,United States,America,188,6038,1258.94989,45614.60749,1009.551852,46050311.46,83,54,40,29,14,39,13,male
62 ms,31500 KB,Canada,America,127,1178,764.1361835,8232.670561,70.46052632,580078.3007,116,80,75,36,5,63,20,male
467 ms,35600 KB,United States,America,189,6044,1267.474731,45706.19321,1003.102941,45848016.84,85,59,45,26,14,40,13,male
390 ms,35600 KB,United States,America,189,6044,1267.474731,45706.19321,1003.102941,45848016.84,85,59,45,26,14,40,13,male
108 ms,4200 KB,United States,America,115,821,675.0131492,5620.147332,58.40441176,328241.3989,135,47,33,88,14,18,8,male
139 ms,189100 KB,United States,America,87,724,473.7434822,4664.691091,92,429151.5804,158,99,78,59,21,24,4,male
451 ms,94300 KB,Cuba,America,98,842,550.5067153,5569.585689,62.80769231,349812.8242,147,84,68,63,16,28,4,male
295 ms,700 KB,United States,America,108,1034,621.5278502,6984.553677,70,488918.7574,177,105,87,72,18,41,10,male
62 ms,55200 KB,United States,America,96,703,538.6054173,4629.228638,66.71052632,308818.2789,153,65,41,88,24,18,6,male
62 ms,4000 KB,United States,America,131,1202,796.4400467,8454.174448,76.18902439,644115.3032,126,66,60,60,6,49,27,male
577 ms,96700 KB,United States,America,142,1471,879.9200594,10517.27801,86.34831461,908149.2307,210,108,81,102,27,54,22,male
202 ms,31400 KB,Canada,America,154,1298,975.1495441,9432.28893,72.63,685067.145,140,66,59,74,7,32,18,male
31 ms,600 KB,United States,America,165,1530,1061.099865,11270.47299,86.72897196,977476.5358,193,102,83,91,19,54,35,male
482 ms,157400 KB,United States,America,145,1556,902.2415629,11171.93854,84.94444444,948994.113,211,121,93,90,28,58,40,male
62 ms,700 KB,United States,America,114,1209,665.1773609,8260.964027,73.88888889,610393.4531,277,143,91,134,52,46,16,male
77 ms,4000 KB,United States,America,176,1690,1156.31388,12606.43944,92.95081967,1171778.879,202,110,89,92,21,63,34,male
31 ms,500 KB,United States,America,100,1404,564.6454601,9327.97409,68.78723404,641645.5369,212,118,86,94,32,45,31,male
655 ms,47700 KB,United States,America,169,2082,1089.728203,15408.63099,81.72169811,1259219.49,284,173,144,111,29,88,56,male
