time,memory,country,continent,program_vocabulary,program_length,calculated_estimated_program_length,volume,difficulty,effort,loc,slocP,lsloc,comments,blankLine,cyclomatic_complexity,numberOfFunction,gender
93 ms,47000 KB,India,Asia,62,263,307.3464548,1565.95363,23.32758621,36529.91829,31,24,24,7,0,15,3,male
156 ms,5600 KB,Mongolia,Asia,68,258,345.9899115,1570.565413,33.93939394,53304.03826,26,23,23,3,0,16,1,male
77 ms,67100 KB,India,Asia,50,313,235.9518742,1766.526987,24.26470588,42864.25778,48,42,39,6,3,18,2,male
202 ms,68100 KB,United States,America,72,418,372.5956925,2579.028651,53.30769231,137482.0658,42,36,35,6,1,26,2,male
202 ms,68100 KB,India,Asia,72,418,372.5956925,2579.028651,53.30769231,137482.0658,41,36,36,5,0,26,2,male
248 ms,68100 KB,Serbia,Europe,72,418,372.5956925,2579.028651,53.30769231,137482.0658,41,36,36,5,0,26,2,male
77 ms,50600 KB,Poland,Europe,67,325,339.6973857,1971.478987,47.61290323,93867.83821,52,43,41,9,2,19,2,male
77 ms,72000 KB,India,Asia,50,345,235.9518742,1947.130385,24.26470588,47246.54612,57,51,51,6,0,34,2,male
77 ms,72000 KB,India,Asia,50,345,235.9518742,1947.130385,24.26470588,47246.54612,57,51,51,6,0,34,2,male
202 ms,35200 KB,India,Asia,65,424,326.4650059,2553.483953,49.5,126397.4557,66,58,58,8,0,25,3,male
62 ms,4700 KB,India,Asia,66,420,333.3240179,2538.64553,72,182782.4782,53,50,50,3,0,24,4,male
78 ms,67100 KB,Italy,Europe,60,408,295.1851693,2410.011363,56.23076923,135516.7928,65,50,43,15,7,30,2,male
46 ms,36800 KB,United States,America,80,463,428.700868,2927.052708,34.79591837,101849.4871,59,50,48,9,2,26,2,male
61 ms,48600 KB,China,Asia,84,448,455.1665461,2863.758205,51,146051.6685,40,30,27,10,3,23,2,male
124 ms,4200 KB,India,Asia,61,328,301.3556992,1945.281847,26.44444444,51441.89772,36,27,23,9,4,21,1,male
92 ms,68000 KB,Mexico,America,56,397,270.0391,2305.519904,56,129109.1146,64,55,50,9,5,24,2,male
62 ms,75500 KB,China,Asia,55,420,265.2124025,2428.17108,23.47619048,57004.20678,48,42,42,6,0,44,2,male
109 ms,115300 KB,South Korea,Asia,33,345,166.4650059,1740.315971,0,0,84,78,78,6,0,28,2,male
62 ms,43600 KB,China,Asia,70,448,359.0498112,2745.918792,36.5,100226.0359,77,60,53,17,7,31,2,male
202 ms,69000 KB,China,Asia,54,399,258.7036718,2296.200113,46.35714286,106445.2767,83,78,78,5,0,34,2,male
62 ms,42900 KB,China,Asia,76,515,400.2149912,3217.682669,42.54545455,136897.7718,50,42,40,8,2,33,2,male
139 ms,99100 KB,Poland,Europe,75,405,392.6333688,2522.67157,37.31707317,94138.71955,52,39,33,13,6,22,2,male
46 ms,5800 KB,China,Asia,85,541,461.2380824,3467.480496,49.2244898,170684.9583,53,39,36,14,3,29,2,male
93 ms,36900 KB,Indonesia,Asia,73,424,379.3421297,2624.485613,42.9,112590.4328,59,46,42,13,4,17,2,male
77 ms,55400 KB,China,Asia,67,441,339.5249056,2675.145333,40.22857143,107617.2751,72,66,66,6,0,27,2,female
62 ms,55700 KB,China,Asia,84,514,455.1665461,3285.651155,41.14,135171.6885,59,54,54,5,0,27,3,male
77 ms,55500 KB,China,Asia,82,405,439.8831639,2574.808562,37.41111111,96326.4492,53,41,37,12,4,24,2,male
171 ms,52500 KB,South Korea,Asia,93,533,519.2878033,3485.371646,50.68965517,176672.2869,58,50,47,8,3,26,2,male
248 ms,121900 KB,Italy,Europe,60,453,294.4615345,2675.82144,49.58064516,132668.9533,63,55,52,8,3,32,2,male
77 ms,68000 KB,China,Asia,62,479,307.3464548,2852.060033,51.20689655,146045.1431,65,60,59,5,1,31,3,male
46 ms,16600 KB,Belarus,Europe,66,434,332.9300119,2623.267048,19.5,51153.70743,40,34,34,6,0,31,1,male
46 ms,7600 KB,India,Asia,53,350,255.6041684,2004.772159,25.41176471,50944.7984,80,74,74,6,0,31,1,female
62 ms,37000 KB,China,Asia,85,593,461.7177151,3800.768825,65.45,248760.3196,38,34,34,4,0,36,3,male
61 ms,5800 KB,Brazil,America,67,424,339.6973857,2572.021817,54.58064516,140382.6101,64,45,30,19,15,20,1,male
249 ms,73900 KB,India,Asia,59,385,288.6764386,2264.817574,46.32692308,104922.0295,98,91,89,7,2,32,2,male
202 ms,41600 KB,South Korea,Asia,82,476,440.5905816,3026.194754,46.54255319,140846.8303,64,58,57,6,1,31,3,female
124 ms,115500 KB,United States,America,70,398,360.0838417,2439.454641,71.33333333,174014.431,75,60,51,15,9,22,3,male
249 ms,68100 KB,Iran,Asia,71,457,365.6422056,2810.434434,43.26388889,121590.3231,69,56,52,13,4,32,2,male
62 ms,52400 KB,China,Asia,83,530,450.002951,3378.770899,42.625,144020.1096,55,46,46,9,0,34,2,male
92 ms,71100 KB,India,Asia,64,398,320.1804545,2388,64.6,154264.8,51,38,31,13,7,26,2,male
46 ms,4800 KB,Singapore,Asia,78,547,414.08385,3438.115014,38.60869565,132741.1362,56,53,52,3,1,31,1,male
46 ms,4800 KB,China,Asia,59,428,288.6764386,2517.771225,46.96153846,118238.4102,82,64,62,18,2,26,1,male
249 ms,40000 KB,Iran,Asia,65,485,326.4650059,2920.848389,67.39393939,196847.4793,51,39,36,12,3,32,2,male
46 ms,5600 KB,Iran,Asia,59,426,289.0701413,2506.005939,76.84,192561.4964,68,57,53,11,4,28,1,male
93 ms,11700 KB,China,Asia,89,509,489.1726399,3296.148316,28.81730769,94986.12023,49,43,43,6,0,32,2,male
77 ms,42800 KB,Poland,Europe,85,484,461.7177151,3102.145213,33.6,104232.0792,59,43,39,16,4,31,2,male
61 ms,36900 KB,Romania,Europe,70,432,359.0910367,2647.850263,48.70588235,128965.8834,67,59,58,8,1,25,2,male
139 ms,103600 KB,South Korea,Asia,76,613,399.4510684,3829.979566,63.95238095,244936.3122,47,36,31,11,5,40,3,female
264 ms,145200 KB,India,Asia,41,367,188.529325,1966.221586,17.77777778,34955.05041,73,54,44,19,10,30,3,female
436 ms,82900 KB,Iran,Asia,60,488,294.8469685,2882.562611,70.27777778,202580.0946,68,54,46,14,8,34,4,male
46 ms,5500 KB,India,Asia,59,477,288.1860234,2806.020735,54.25,152226.6248,50,42,38,8,4,31,1,male
93 ms,68000 KB,Hungary,Europe,68,453,346.1173001,2757.620667,61.875,170627.7788,49,43,42,6,1,35,3,male
93 ms,63400 KB,Bangladesh,Asia,59,370,288.6764386,2176.577928,30.46153846,66301.91228,62,54,52,8,2,24,2,female
62 ms,38800 KB,Singapore,Asia,64,478,320.0450916,2868,76.64516129,219818.3226,70,56,49,14,7,27,3,male
77 ms,68000 KB,Poland,Europe,66,486,334.0271833,2937.575542,73.96428571,217275.6767,93,69,51,24,18,34,3,male
218 ms,33200 KB,Bangladesh,Asia,83,521,450.002951,3321.395544,36.36538462,120783.8264,74,56,56,18,0,25,2,female
46 ms,5600 KB,Iran,Asia,52,429,249.0117739,2445.488639,71.02941176,173701.6195,70,63,59,7,4,33,1,male
62 ms,21400 KB,Mexico,America,42,393,210.885574,2119.180747,19.5,41324.02457,47,38,38,9,0,23,1,male
46 ms,8500 KB,China,Asia,58,564,282.2114327,3303.901281,80.61538462,266345.2725,68,62,61,6,1,34,1,male
61 ms,55600 KB,China,Asia,73,459,378.8670746,2841.129473,43.2972973,123013.2274,55,47,47,8,0,29,2,female
93 ms,83700 KB,Italy,Europe,53,482,252.2386659,2760.857659,51.04761905,140935.21,86,61,42,25,19,37,2,male
186 ms,85400 KB,Canada,America,74,529,385.4995491,3284.80083,67.5,221724.0561,56,47,47,9,0,33,3,male
92 ms,82700 KB,India,Asia,53,450,253.6843594,2577.564205,35.78947368,92249.66627,91,73,65,18,8,37,2,male
77 ms,68000 KB,United States,America,65,558,326.5538222,3360.48124,56.07352941,188434.0436,74,63,59,11,4,29,2,male
109 ms,72300 KB,Norway,Europe,58,449,283.5668306,2630.233467,92.06521739,242153.0159,67,60,56,7,4,26,2,male
77 ms,70100 KB,China,Asia,84,468,453.092115,2991.604554,51.36363636,153659.6884,51,39,37,12,2,28,3,male
109 ms,75500 KB,India,Asia,68,573,346.1173001,3488.116208,88.44444444,308504.5002,53,47,45,6,2,30,2,male
124 ms,107100 KB,India,Asia,68,438,346.3298602,2666.308724,56.09677419,149571.3184,88,69,62,19,7,31,4,male
46 ms,3900 KB,Iran,Asia,72,378,372.5956925,2332.231651,33.09090909,77175.66553,78,54,46,24,8,15,2,female
61 ms,55700 KB,China,Asia,79,545,419.2271063,3435.560508,47.13095238,161921.2387,72,62,61,10,1,36,3,male
77 ms,46400 KB,Bangladesh,Asia,78,476,412.85429,2991.851456,53.31395349,159507.4294,72,55,49,17,6,25,3,male
62 ms,71000 KB,China,Asia,79,478,419.0808777,3013.207198,39.3902439,118690.9664,64,50,50,14,0,21,3,male
77 ms,36300 KB,China,Asia,99,535,561.9099458,3546.705792,54.90322581,194725.589,52,37,33,15,4,24,3,male
202 ms,37800 KB,Iran,Asia,75,520,392.9423377,3238.985719,64.42857143,208683.2228,80,57,42,23,15,32,3,male
31 ms,13700 KB,China,Asia,77,541,405.551932,3390.331519,47.74358974,161866.5971,56,43,43,13,0,24,1,female
46 ms,13700 KB,China,Asia,77,541,405.551932,3390.331519,47.74358974,161866.5971,56,43,43,13,0,24,1,female
46 ms,8700 KB,Jordan,Asia,89,592,487.9979062,3833.634191,50.6122449,194028.8325,55,43,38,12,5,28,4,male
46 ms,5300 KB,Poland,Europe,63,258,314.4992626,1542.13822,34,52432.69949,65,44,31,21,13,18,1,male
61 ms,36900 KB,Romania,Europe,78,469,414.08385,2947.853641,34.43478261,101508.6993,55,43,38,12,5,32,2,male
46 ms,3700 KB,Denmark,Europe,65,450,326.4650059,2710.065516,55.75757576,151106.6833,85,66,53,19,13,22,2,male
93 ms,38800 KB,China,Asia,86,544,467.1963626,3495.888027,60.15957447,210311.1361,67,44,41,23,3,29,5,male
61 ms,35900 KB,South Korea,Asia,75,541,392.4020294,3369.790912,33.6875,113519.8313,70,46,33,24,13,30,2,male
109 ms,83600 KB,Vietnam,Asia,59,427,288.6764386,2511.888582,74.88461538,188101.8104,61,51,47,10,4,27,2,male
124 ms,99900 KB,United States,America,65,454,327.3557123,2734.154987,86.55357143,236650.879,67,58,54,9,4,28,2,male
46 ms,4600 KB,Hungary,Europe,75,558,392.4020294,3475.680829,83.125,288915.9689,48,38,36,10,2,29,1,male
124 ms,100000 KB,Brazil,America,81,485,433.6087556,3074.827251,42.98913043,132184.1498,64,47,37,17,10,25,2,male
108 ms,103700 KB,Finland,Europe,63,489,314.4992626,2922.889883,87.33333333,255265.7164,68,59,59,9,0,28,3,female
77 ms,37800 KB,Iran,Asia,80,446,425.7542476,2819.57993,56.5,159306.2661,53,39,37,14,2,19,3,male
140 ms,4800 KB,Croatia,Europe,61,495,301.3556992,2935.714982,54.77777778,160811.9429,72,65,64,7,1,26,1,male
77 ms,42900 KB,Iran,Asia,83,526,446.8336245,3353.270741,67.56521739,226564.4666,61,57,57,4,0,35,4,male
187 ms,149600 KB,China,Asia,75,555,392.17102,3456.994373,35.53947368,122859.7606,58,37,37,21,0,24,2,female
170 ms,149600 KB,China,Asia,75,555,392.17102,3456.994373,35.53947368,122859.7606,58,37,37,21,0,24,2,male
46 ms,5800 KB,South Korea,Asia,84,554,454.1955001,3541.343852,56.625,200528.5956,80,54,37,26,17,26,1,male
46 ms,5800 KB,India,Asia,84,554,454.1955001,3541.343852,56.625,200528.5956,80,54,37,26,17,26,1,female
46 ms,2300 KB,India,Asia,84,554,454.1955001,3541.343852,56.625,200528.5956,80,54,37,26,17,26,1,male
124 ms,90500 KB,China,Asia,48,394,227.6306219,2200.475225,24.23076923,53319.20738,93,76,76,17,0,28,2,male
77 ms,73900 KB,China,Asia,65,622,326.7316235,3745.91278,77,288435.284,69,64,64,5,0,44,3,male
62 ms,12000 KB,Iran,Asia,66,462,333.3240179,2792.510083,72,201060.726,59,42,35,17,7,23,1,male
46 ms,5600 KB,India,Asia,52,321,249.0117739,1829.84115,23.67647059,43324.18016,63,43,40,20,3,18,1,male
187 ms,101000 KB,Taiwan,Asia,76,579,399.1845378,3617.55003,81.09756098,293374.4842,69,62,61,7,1,32,2,male
140 ms,55900 KB,Turkmenistan,Asia,78,590,414.08385,3708.387309,50.7826087,188321.5816,60,43,40,17,3,22,3,male
108 ms,83700 KB,India,Asia,42,389,194.994331,2097.611477,45.83333333,96140.52605,84,72,72,12,0,21,2,male
92 ms,71100 KB,China,Asia,69,441,352.582306,2693.859285,53.45454545,143999.0236,57,51,51,6,0,32,2,male
124 ms,52600 KB,Iran,Asia,73,501,378.8670746,3101.102104,70.05405405,217244.7744,77,62,57,15,5,27,2,male
248 ms,69100 KB,India,Asia,58,434,281.9620482,2542.363752,45.35185185,115300.9042,88,75,70,13,5,24,2,male
77 ms,55400 KB,China,Asia,89,558,488.714938,3613.459254,67.80392157,245006.7079,56,44,41,12,3,29,2,male
77 ms,53700 KB,China,Asia,83,578,446.8336245,3684.772791,63.14130435,232661.3603,73,65,65,8,0,31,3,male
61 ms,62500 KB,China,Asia,68,396,345.9474732,2410.635285,26.5,63881.83506,68,56,55,12,1,24,2,female
77 ms,36900 KB,India,Asia,81,485,433.6087556,3074.827251,42.98913043,132184.1498,64,47,37,17,10,25,2,female
62 ms,36400 KB,Czechia,Europe,70,479,359.4212455,2935.926565,61.05263158,179246.0429,92,75,68,17,7,27,2,male
93 ms,67100 KB,Bangladesh,Asia,62,486,307.1601712,2893.739407,59.5,172177.4947,65,56,52,9,4,33,2,male
92 ms,52400 KB,India,Asia,44,397,212.401259,2167.394353,26.42857143,57281.13646,94,81,81,13,0,30,3,male
62 ms,17100 KB,China,Asia,82,516,439.8831639,3280.496834,35.35555556,115983.7881,66,42,42,24,0,19,2,female
77 ms,68000 KB,India,Asia,62,458,308.3287327,2727.02191,31.84615385,86845.15929,86,72,61,14,11,28,3,male
249 ms,116000 KB,India,Asia,42,440,207.4212455,2372.619666,19,45079.77365,97,82,79,15,3,39,2,male
109 ms,53400 KB,Bangladesh,Asia,78,471,413.1887278,2960.424445,52.15909091,154413.0478,69,45,29,24,16,29,4,male
186 ms,84700 KB,South Korea,Asia,58,523,281.8126557,3063.72406,69.64285714,213366.4971,43,32,31,11,1,21,2,male
77 ms,67100 KB,China,Asia,92,503,508.6701412,3281.351664,65.94,216372.3287,67,55,54,12,1,23,1,male
92 ms,67100 KB,China,Asia,92,503,508.6701412,3281.351664,65.94,216372.3287,67,55,54,12,1,23,1,male
171 ms,8800 KB,China,Asia,68,467,345.9899115,2842.845147,39.24242424,111560.1353,64,56,55,8,1,32,2,male
62 ms,36800 KB,Finland,Europe,52,483,245.8187515,2753.312384,92.26190476,254025.8449,91,70,64,21,6,28,2,male
77 ms,75100 KB,South Korea,Asia,51,428,239.4453837,2427.798046,26.42857143,64163.23408,72,66,66,6,0,29,2,male
46 ms,9200 KB,China,Asia,81,574,432.75063,3639.073902,48.1627907,175267.9547,85,77,77,8,0,29,3,female
93 ms,65000 KB,South Korea,Asia,71,523,365.6422056,3216.317744,67.56944444,217324.8031,74,58,56,16,2,25,2,male
77 ms,51500 KB,Croatia,Europe,80,483,425.7903187,3053.49127,69.91463415,213483.725,90,66,53,24,13,26,9,male
77 ms,52900 KB,Germany,Europe,78,544,412.2613731,3419.258807,81,276959.9634,63,50,44,13,6,24,3,male
46 ms,8800 KB,China,Asia,92,625,509.2999891,4077.226223,48.46153846,197588.6554,69,55,55,14,0,34,3,male
77 ms,65200 KB,Bangladesh,Asia,70,536,359.2147805,3285.295697,95.3030303,313098.6354,80,71,68,9,3,32,3,female
202 ms,68100 KB,India,Asia,56,490,273.4603973,2845.603912,44.78947368,127453.1015,94,85,81,9,4,46,2,male
233 ms,50700 KB,Vietnam,Asia,81,509,433.2506894,3226.983651,53.6,172966.3237,57,47,43,10,4,26,3,male
92 ms,68000 KB,India,Asia,62,447,310.1726115,2661.525751,76.30434783,203085.9866,89,60,37,29,23,34,3,male
62 ms,52700 KB,China,Asia,73,623,379.3421297,3856.2607,55.275,213154.8102,77,65,63,12,2,40,3,male
93 ms,67100 KB,India,Asia,66,494,333.3240179,2985.930695,75.6,225736.3605,88,62,54,26,8,27,2,male
46 ms,54800 KB,India,Asia,81,586,432.6080183,3715.152102,59.42857143,220786.182,97,85,85,12,0,34,3,female
77 ms,81800 KB,India,Asia,56,420,271.7635715,2439.089067,106.6666667,260169.5005,66,55,51,11,4,26,2,male
156 ms,104000 KB,Finland,Europe,64,554,320.7232379,3324,86.78571429,288475.7143,67,63,61,4,2,28,1,male
62 ms,44800 KB,Syria,Asia,54,395,257.6220106,2273.180563,47.17391304,107234.8222,78,67,67,11,0,28,3,male
62 ms,32200 KB,China,Asia,87,462,474.942584,2976.639895,39.22,116743.8167,81,56,49,25,7,23,3,female
46 ms,8200 KB,Mexico,America,76,489,398.9944238,3055.236554,39.15,119612.5111,93,54,35,39,19,16,4,male
93 ms,9200 KB,Brazil,America,91,583,502.1708162,3794.044275,65.88235294,249960.564,79,61,51,18,10,28,4,male
109 ms,81900 KB,India,Asia,83,568,446.8336245,3621.022397,56.30434783,203879.3045,105,80,65,25,15,27,3,male
93 ms,67700 KB,India,Asia,66,489,333.3240179,2955.708724,83.4,246506.1076,61,51,45,10,6,35,4,male
77 ms,52500 KB,Bangladesh,Asia,73,534,378.8670746,3305.366314,41.625,137585.8728,101,77,65,24,12,35,3,male
686 ms,102100 KB,Finland,Europe,62,590,307.9068682,3512.975823,70,245908.3076,90,62,48,28,14,40,2,male
77 ms,69100 KB,India,Asia,71,504,365.7235111,3099.472548,73.45588235,227674.4909,78,54,45,24,9,31,3,male
124 ms,87900 KB,Sweden,Europe,82,534,439.460071,3394.93277,47.1627907,160114.5037,72,54,45,18,9,23,2,male
202 ms,7800 KB,Jordan,Asia,58,552,283.0128366,3233.605509,80.04166667,258823.1743,76,61,51,15,10,34,2,male
265 ms,71300 KB,China,Asia,69,576,353.3374044,3518.510087,37.7,132647.8303,83,69,69,14,0,28,4,female
62 ms,68300 KB,China,Asia,76,513,399.1845378,3205.186814,38.41463415,123126.0788,57,51,51,6,0,40,3,male
155 ms,146100 KB,India,Asia,0,0,0,0,0,0,63,52,47,11,5,36,3,female
62 ms,39900 KB,South Korea,Asia,83,556,447.1829761,3544.521924,54.76595745,194119.1368,84,64,57,20,7,32,3,female
61 ms,36900 KB,Croatia,Europe,89,571,489.1726399,3697.643789,64.39423077,238106.9275,78,49,34,29,15,26,2,male
61 ms,39800 KB,South Korea,Asia,75,464,392.9423377,2890.171872,43.60714286,126032.1377,67,57,55,10,2,28,3,male
436 ms,68500 KB,India,Asia,71,395,365.6422056,2429.150112,42.68571429,103690.0076,51,46,44,5,2,25,3,male
155 ms,7900 KB,Ukraine,Europe,73,603,378.8670746,3732.464209,91.45945946,341369.159,68,51,48,17,3,30,1,male
249 ms,68100 KB,India,Asia,62,529,307.2067179,3149.769848,58.66666667,184786.4978,89,81,81,8,0,36,2,male
78 ms,39800 KB,Bangladesh,Asia,85,583,464.3440107,3736.674916,68.31481481,255270.2549,81,57,41,24,16,29,4,male
124 ms,99200 KB,India,Asia,44,487,214.9310205,2658.743198,19,50516.12077,86,80,80,6,0,41,3,male
234 ms,12800 KB,China,Asia,81,549,432.75063,3480.577652,45.06976744,156868.8253,89,73,72,16,1,34,3,male
156 ms,5600 KB,India,Asia,80,497,426.079159,3141.998263,60.43243243,189878.5977,72,65,65,7,0,33,3,male
265 ms,15500 KB,China,Asia,69,614,352.4986422,3750.634016,70,262544.3812,87,81,81,6,0,40,3,female
77 ms,71300 KB,Finland,Europe,56,588,271.0812322,3414.724694,131.3636364,448570.653,92,76,67,16,9,37,2,male
249 ms,84600 KB,China,Asia,64,567,320.7232379,3402,75.85714286,258066,70,63,62,7,1,42,2,male
592 ms,83900 KB,China,Asia,78,643,413.5983953,4041.513627,49.86666667,201536.8129,94,85,84,9,1,33,2,male
109 ms,98900 KB,China,Asia,85,632,460.8279746,4050.735072,59.35416667,240428.0046,83,63,59,20,4,36,2,female
452 ms,83900 KB,China,Asia,78,643,413.5983953,4041.513627,49.86666667,201536.8129,94,85,84,9,1,33,2,male
93 ms,68000 KB,Austria,Europe,70,562,359.4212455,3444.657056,70.0625,241341.285,101,85,76,16,9,39,5,male
233 ms,68000 KB,Armenia,Europe,55,454,263.6191856,2624.73731,62,162733.7132,109,74,64,35,10,25,2,male
109 ms,68100 KB,Ukraine,Europe,63,475,314.9612072,2839.207964,67.59615385,191919.5383,79,58,49,21,9,29,3,male
265 ms,107400 KB,Ukraine,Europe,59,496,290.159225,2917.790952,86.08695652,251183.7429,87,66,56,21,10,27,2,male
77 ms,68100 KB,India,Asia,46,423,217.5786534,2336.466707,27.04545455,63190.80413,100,81,72,19,9,22,2,male
187 ms,106700 KB,India,Asia,67,462,339.5249056,2802.533206,52.5,147132.9933,66,54,49,12,5,36,2,male
46 ms,5500 KB,Japan,Asia,73,469,378.8670746,2903.027718,51.56756757,149702.078,77,63,60,14,3,19,4,male
233 ms,61200 KB,India,Asia,71,484,365.6422056,2976.477606,59.14285714,176037.3898,65,47,36,18,11,32,2,male
46 ms,9700 KB,China,Asia,78,597,412.5946318,3752.385125,39,146343.0199,91,80,80,11,0,34,2,female
77 ms,48800 KB,Philippines,Asia,75,642,392.2479866,3998.901599,76.375,305416.1096,84,78,78,6,0,39,2,male
93 ms,60700 KB,United States,America,77,540,406.0022373,3384.064732,67.5,228424.3694,76,53,49,23,4,29,2,male
217 ms,33200 KB,Romania,Europe,72,517,372.5956925,3189.851226,71.07692308,226724.8102,84,69,62,15,7,33,3,male
77 ms,64600 KB,India,Asia,68,530,346.6279634,3226.355306,49.4,159381.9521,108,80,68,28,12,39,4,male
93 ms,52500 KB,Iran,Asia,68,633,346.1173001,3853.363979,82.22222222,316832.1493,91,80,78,11,2,36,2,male
77 ms,74900 KB,China,Asia,81,631,433.2506894,4000.445352,56.8,227225.296,86,73,73,13,0,41,4,male
62 ms,5800 KB,Switzerland,Europe,84,604,453.8154506,3860.959723,83.05319149,320665.0272,71,59,55,12,4,31,3,male
264 ms,67100 KB,Latvia,Europe,52,397,244.6450378,2263.074568,35.58333333,80527.73671,78,74,73,4,1,31,2,male
187 ms,36900 KB,Taiwan,Asia,88,538,480.9553238,3475.174211,50,173758.7105,75,64,63,11,1,37,2,male
78 ms,37800 KB,South Korea,Asia,77,556,405.551932,3484.333317,79.41025641,276691.8021,95,68,51,27,17,33,3,male
77 ms,83800 KB,China,Asia,65,601,326.4650059,3619.443056,58.78125,212755.3871,102,95,94,7,1,35,2,male
77 ms,50900 KB,Mexico,America,79,491,419.0078103,3095.156347,51.79487179,160313.2262,83,60,57,23,3,24,2,male
46 ms,1900 KB,India,Asia,50,453,236.9737366,2556.666854,57.375,146688.7607,119,110,106,9,4,36,1,male
109 ms,83700 KB,Iran,Asia,86,697,469.3966019,4479.106534,84.67307692,379259.7321,79,45,22,34,23,37,3,male
124 ms,107100 KB,India,Asia,42,315,204.359415,1698.579988,18.5,31423.72978,70,62,61,8,1,23,2,male
62 ms,37900 KB,Ukraine,Europe,88,524,481.2514689,3384.742168,38.60204082,130657.9553,93,65,56,28,9,19,3,male
218 ms,6200 KB,China,Asia,80,541,425.8985773,3420.163099,46.5952381,159363.3139,111,96,93,15,3,33,2,male
61 ms,36900 KB,Iran,Asia,81,686,433.2506894,4349.137102,94.4,410558.5424,66,56,52,10,4,34,3,male
124 ms,83900 KB,India,Asia,65,467,326.7316235,2812.445769,44.33333333,124685.0957,92,87,84,5,3,24,3,male
62 ms,29000 KB,China,Asia,79,615,419.2271063,3876.82516,50.6547619,196379.6554,93,88,88,5,0,42,5,female
46 ms,29000 KB,China,Asia,79,615,419.2271063,3876.82516,50.6547619,196379.6554,93,88,88,5,0,42,5,female
202 ms,13500 KB,China,Asia,77,561,406.6799972,3515.667249,55.875,196437.9076,95,81,75,14,6,32,3,male
171 ms,37800 KB,Bangladesh,Asia,65,465,326.5538222,2800.401033,48.25806452,135141.9337,95,74,62,21,12,29,2,male
77 ms,36800 KB,Moldova,Asia,78,561,412.2983693,3526.110645,76.95,271334.2141,82,69,68,13,1,31,2,male
77 ms,68100 KB,South Korea,Asia,68,524,346.1173001,3189.830529,56.8125,181222.2469,67,59,56,8,3,34,2,male
92 ms,71800 KB,Bangladesh,Asia,67,578,339.5249056,3506.199552,59.0625,207084.911,82,62,60,20,2,37,3,male
93 ms,99000 KB,China,Asia,89,653,487.7378322,4228.65393,65.77083333,278122.0929,85,64,60,21,4,40,2,female
46 ms,6600 KB,Vietnam,Asia,89,603,489.1726399,3904.867259,66.17307692,258397.0815,71,55,51,16,4,29,2,male
62 ms,6600 KB,Taiwan,Asia,82,552,439.460071,3509.368707,58.95348837,206889.5272,79,68,66,11,2,31,1,male
202 ms,53400 KB,India,Asia,49,382,228.6387356,2144.81916,24.11111111,51713.97309,72,60,59,12,1,23,2,male
46 ms,58700 KB,China,Asia,92,669,510.1851706,4364.262949,71.07407407,310185.9481,75,62,57,13,5,46,3,male
61 ms,13200 KB,Canada,America,65,609,326.7316235,3667.621998,93.33333333,342311.3865,74,67,66,7,1,33,4,male
296 ms,123100 KB,India,Asia,77,676,407.6639356,4236.347702,67.72826087,286920.4623,77,64,59,13,5,29,2,male
140 ms,27600 KB,Ukraine,Europe,43,491,217.6320113,2664.295995,20,53285.91989,94,56,34,38,22,34,3,male
92 ms,40800 KB,Romania,Europe,75,533,392.2479866,3319.960362,57.69230769,191536.1747,95,78,72,17,6,35,3,female
217 ms,5800 KB,Bangladesh,Asia,47,491,222.5444556,2727.303126,32.08333333,87500.9753,105,89,89,16,0,37,5,male
171 ms,37000 KB,Canada,America,68,500,346.3298602,3043.731421,53.2027027,161934.7379,90,72,66,18,6,27,2,male
46 ms,36800 KB,China,Asia,71,486,366.8663501,2988.7771,34.75609756,103878.2285,77,70,70,7,0,37,2,male
77 ms,40800 KB,United States,America,70,483,359.4212455,2960.443697,81.9375,242571.3554,101,71,53,30,18,27,3,male
155 ms,65000 KB,India,Asia,72,526,372.5956925,3245.380551,61.76923077,200464.6602,69,58,56,11,2,25,2,male
436 ms,50900 KB,India,Asia,64,607,320.7232379,3642,32.14285714,117064.2857,72,69,68,3,1,33,1,male
77 ms,37800 KB,Iran,Asia,92,566,509.2999891,3692.336067,64.23076923,237161.5859,84,57,47,27,10,32,4,male
93 ms,63300 KB,Brazil,America,87,612,474.5420279,3943.081419,64.75510204,255334.6397,87,58,41,29,17,24,2,male
61 ms,52800 KB,China,Asia,87,721,473.9427998,4645.362261,71.91489362,334070.7328,77,63,61,14,2,32,2,female
888 ms,162000 KB,Ukraine,Europe,35,415,164.7548875,2128.652452,16,34058.43923,103,80,78,23,2,15,2,male
46 ms,34100 KB,Poland,Europe,77,458,405.6268983,2870.188236,49.72972973,142733.6852,81,62,55,19,7,31,2,male
62 ms,8700 KB,China,Asia,112,780,654.1624644,5309.736839,81.52941176,432899.7211,63,44,39,19,5,33,5,male
61 ms,36900 KB,South Korea,Asia,67,440,339.4387425,2669.079244,37.36764706,99737.21115,79,61,61,18,0,26,2,male
93 ms,68100 KB,United Kingdom,Europe,64,453,320.1804545,2718,48.73333333,132457.2,122,88,64,34,24,31,2,male
108 ms,98600 KB,Brazil,America,54,599,261.1759501,3447.177614,70,241302.433,74,61,53,13,8,44,2,male
1699 ms,4700 KB,China,Asia,48,492,222.2653679,2747.80155,44.16666667,121361.2351,123,115,113,8,2,37,1,female
46 ms,5500 KB,India,Asia,66,500,333.6312234,3022.19706,61.87931034,187011.4698,81,75,71,6,4,37,1,male
187 ms,53500 KB,Peru,America,80,634,426.6582949,4008.102412,73.11111111,293036.8208,97,76,63,21,13,33,4,male
139 ms,103700 KB,Bangladesh,Asia,85,696,461.7177151,4460.936092,74.2,331001.458,75,65,63,10,2,39,2,male
202 ms,85300 KB,Tajikistan,Asia,58,486,283.5668306,2846.978764,73.80434783,210119.4109,104,67,52,37,15,29,2,male
452 ms,91100 KB,Brazil,America,80,648,425.7903187,4096.609405,81.32926829,333174.2454,76,48,32,28,16,36,3,male
264 ms,67300 KB,Indonesia,Asia,66,602,333.1049912,3638.72526,67.74193548,246494.2918,91,85,85,6,0,47,3,male
124 ms,107500 KB,India,Asia,73,591,378.9461511,3658.186314,96.08571429,351499.445,97,79,73,18,6,31,2,male
92 ms,58500 KB,Vietnam,Asia,70,487,359.0498112,2984.960829,70,208947.258,71,49,36,22,13,29,2,female
46 ms,2100 KB,India,Asia,75,502,392.6333688,3126.866983,77.17647059,241320.5577,76,68,66,8,2,20,2,male
108 ms,82100 KB,Singapore,Asia,74,556,385.5385456,3452.456071,58.05555556,200434.2552,88,59,57,29,2,33,2,male
264 ms,70400 KB,Ukraine,Europe,55,451,265.2124025,2607.393231,82.57142857,215296.1839,81,61,52,20,9,35,2,male
93 ms,68100 KB,Bulgaria,Europe,57,448,277.6324012,2613.134726,54.09090909,141346.8329,79,67,61,12,6,30,2,male
108 ms,50800 KB,United Kingdom,Europe,65,549,326.4650059,3306.279929,65.484375,216509.6747,89,80,76,9,4,30,2,male
78 ms,56400 KB,Cuba,America,71,500,365.8862514,3074.87356,74.27272727,228379.2453,86,58,39,28,19,30,2,male
92 ms,74000 KB,Serbia,Europe,68,499,346.1173001,3037.643958,70.875,215293.0155,76,63,58,13,5,25,2,female
78 ms,40800 KB,Argentina,America,86,589,466.9609738,3785.069941,66.7,252464.165,70,48,44,22,4,21,3,male
77 ms,44700 KB,Costa Rica,America,71,621,365.7235111,3818.992961,91.95588235,351178.8674,99,70,53,29,17,29,2,male
61 ms,4900 KB,Slovenia,Europe,72,480,372.8771238,2961.564001,46.875,138823.3125,76,71,69,5,2,28,1,male
62 ms,9500 KB,Colombia,America,89,717,488.714938,4643.10087,86.80392157,403039.3638,67,51,51,16,0,37,4,male
46 ms,37800 KB,Poland,Europe,77,458,405.6268983,2870.188236,49.72972973,142733.6852,81,62,55,19,7,31,2,male
77 ms,30400 KB,Estonia,Europe,61,521,301.7363383,3089.914153,57.88461538,178858.4923,69,60,59,9,1,36,1,male
421 ms,86900 KB,Bosnia and Herzegovina,Europe,57,543,275.5886804,3167.259278,76.66666667,242823.2113,67,55,48,12,7,40,3,male
62 ms,54400 KB,Croatia,Europe,83,683,447.1829761,4354.151932,82.72340426,360190.2704,102,83,76,19,7,36,2,male
61 ms,40800 KB,United States,America,71,501,366.1306865,3081.023307,84.09375,259094.8037,105,71,51,34,20,27,3,male
343 ms,68200 KB,Ukraine,Europe,60,631,295.6213103,3727.247966,114.8,427888.0665,114,86,63,28,23,44,3,male
249 ms,68000 KB,Ukraine,Europe,62,661,307.3464548,3935.723761,105.2586207,414268.8545,140,110,85,30,25,45,2,male
46 ms,4600 KB,Lithuania,Europe,59,424,288.6764386,2494.240653,86.94230769,216855.0383,79,63,51,16,12,36,1,female
61 ms,37900 KB,Poland,Europe,87,592,474.5420279,3814.22255,48.08163265,183394.0475,107,64,49,43,15,15,6,male
109 ms,61300 KB,United States,America,79,735,419.0808777,4633.27885,99.17073171,459485.6537,70,52,46,18,6,38,2,male
249 ms,72600 KB,Romania,Europe,50,617,235.05865,3482.259269,125.3333333,436443.1617,141,90,60,51,30,42,6,male
124 ms,68100 KB,Bulgaria,Europe,54,555,258.1074956,3193.962564,106.1818182,339140.7522,72,62,58,10,4,35,2,male
62 ms,17800 KB,Belarus,Europe,65,513,326.7316235,3089.474688,81.08333333,250504.906,82,74,72,8,2,29,1,male
140 ms,82200 KB,Poland,Europe,89,606,487.4132344,3924.294459,39.26086957,154071.2129,79,54,46,25,8,26,5,male
92 ms,36800 KB,Finland,Europe,84,525,454.1955001,3355.966647,64.875,217718.3362,75,52,42,23,10,26,2,female
109 ms,56500 KB,Argentina,America,76,695,399.4510684,4342.309622,63,273565.5062,72,42,29,30,13,31,6,male
108 ms,71200 KB,Colombia,America,91,698,501.8524417,4542.440659,82.82,376204.9354,82,55,47,27,8,30,3,male
62 ms,42800 KB,Romania,Europe,78,578,414.08385,3632.962483,62.60869565,227455.0424,86,72,64,14,8,33,2,male
264 ms,53400 KB,Chile,America,75,515,392.6333688,3207.841626,44.36585366,142318.6321,85,65,53,20,12,33,2,male
62 ms,41100 KB,United States,America,72,513,372.8771238,3165.171526,85,269039.5797,106,72,51,34,21,27,3,male
233 ms,36800 KB,Netherlands,Europe,89,610,488.323496,3950.197393,72.54,286547.3189,67,50,40,17,10,28,2,male
108 ms,69100 KB,Canada,America,110,747,637.6343112,5065.675706,101.0873016,512075.4878,115,78,59,37,19,43,8,male
77 ms,39800 KB,Ukraine,Europe,75,554,392.17102,3450.765555,87.63157895,302396.0341,92,61,40,31,21,35,3,male
62 ms,40000 KB,United States,America,69,525,352.7497745,3206.97534,57.51351351,184444.4195,84,72,65,12,7,36,4,male
108 ms,82300 KB,Germany,Europe,64,483,320.7232379,2898,55.92857143,162081,79,68,62,11,6,36,2,female
187 ms,36900 KB,Croatia,Europe,86,622,467.1963626,3997.136677,88.37234043,353236.3232,109,75,53,34,22,33,5,male
218 ms,4600 KB,Croatia,Europe,51,419,239.4453837,2376.746218,50,118837.3109,83,72,65,11,7,34,1,male
77 ms,55600 KB,Peru,America,82,586,440.20115,3725.525475,42.65217391,158901.7605,88,60,53,28,7,28,2,male
93 ms,72400 KB,United States,America,74,532,385.8508604,3303.429191,84.11764706,277876.6907,107,74,53,33,21,27,3,male
217 ms,121600 KB,United States,America,64,543,320.4063545,3258,59.74137931,194637.4138,101,76,69,25,7,41,4,male
93 ms,72100 KB,Brazil,America,94,893,527.3871723,5853.247845,112.2,656734.4082,67,43,34,24,9,37,3,male
405 ms,39000 KB,Romania,Europe,64,456,320,2736,33,90288,88,65,60,23,5,17,3,male
93 ms,83300 KB,France,Europe,65,492,326.5538222,2963.004964,60.87096774,180360.9796,83,59,48,24,11,23,2,male
124 ms,99400 KB,Sweden,Europe,41,482,204.176133,2582.340066,19,49064.46126,86,61,52,25,9,28,2,male
187 ms,37800 KB,Germany,Europe,78,678,412.2613731,4261.502704,54.5,232251.8974,128,87,74,41,13,19,3,male
46 ms,4100 KB,United States,America,82,456,439.460071,2899.043714,53.05813953,153817.8659,78,62,58,16,4,17,2,male
78 ms,55400 KB,United States,America,76,614,399.7943904,3836.227493,49.51515152,189951.3856,103,69,58,34,11,31,4,male
62 ms,39800 KB,Brazil,America,75,530,392.2479866,3301.273906,56.30769231,185887.1153,81,66,59,15,7,34,2,male
46 ms,6600 KB,Croatia,Europe,73,533,379.1044231,3299.17649,69.97058824,230845.3197,85,56,40,29,16,30,2,female
155 ms,53700 KB,Bulgaria,Europe,78,621,412.85429,3903.234778,47.20930233,184268.9907,76,68,68,8,0,37,2,male
77 ms,37800 KB,United States,America,68,510,346.1173001,3104.606049,75.375,234009.6809,77,61,55,16,6,23,3,male
155 ms,86400 KB,Brazil,America,78,616,412.85429,3871.807767,55.75581395,215875.7935,115,84,72,31,12,28,2,male
46 ms,36000 KB,Brazil,America,74,536,385.8508604,3328.267004,58.225,193788.3463,110,74,46,36,28,26,2,male
93 ms,68100 KB,Denmark,Europe,73,658,380.5361023,4072.90456,108.9333333,443675.07,96,76,66,20,10,33,3,male
139 ms,131200 KB,Armenia,Europe,76,583,398.9944238,3642.54174,51.66666667,188197.9899,96,60,53,36,7,29,3,male
140 ms,55700 KB,Croatia,Europe,83,578,446.2065082,3684.772791,44.18604651,162815.5419,104,66,50,38,16,25,3,male
124 ms,91300 KB,Ukraine,Europe,61,525,301.0709438,3113.637102,53.03571429,165133.9677,106,89,82,17,7,31,4,male
140 ms,12500 KB,Poland,Europe,75,708,392.4020294,4410.003633,84.4375,372369.6818,133,99,82,34,17,32,5,male
187 ms,38000 KB,Romania,Europe,72,492,372.5956925,3035.603101,26.65384615,80910.49803,90,84,84,6,0,30,2,female
264 ms,74100 KB,Belarus,Europe,62,506,307.3464548,3012.823333,82.5,248557.925,93,80,76,13,4,37,2,male
77 ms,36800 KB,Bulgaria,Europe,75,528,392.9423377,3288.816269,65.21428571,214477.8038,104,79,63,25,16,26,3,male
92 ms,71100 KB,Ukraine,Europe,73,556,378.9461511,3441.542455,66.77142857,229796.7062,99,90,88,9,2,36,3,male
61 ms,35900 KB,Romania,Europe,76,588,400.713475,3673.781378,69.92222222,256878.9579,84,70,63,14,7,33,2,male
78 ms,17800 KB,Romania,Europe,75,664,392.4020294,4135.93561,102.8571429,425410.5199,91,74,62,17,12,29,2,male
61 ms,46500 KB,Cuba,America,80,675,426.079159,4267.301464,83.03488372,354334.8809,115,68,42,47,26,34,3,male
46 ms,5400 KB,Belarus,Europe,85,681,461.2380824,4364.795228,71.26530612,311058.4681,83,66,58,17,8,37,2,male
46 ms,18000 KB,Ukraine,Europe,67,569,339.4387425,3451.604749,41.25,142378.6959,85,70,66,15,4,34,1,female
140 ms,111300 KB,Argentina,America,49,430,239.3499675,2414.325233,52.65,127114.2235,101,69,56,32,13,17,2,male
140 ms,99900 KB,Canada,America,71,521,365.7235111,3204.018249,66.92647059,214433.6331,85,53,50,32,3,34,2,male
1279 ms,5800 KB,Brazil,America,69,775,352.7497745,4734.106454,57.234375,270953.6241,95,73,71,22,2,38,1,male
77 ms,69100 KB,Armenia,Europe,51,603,240.7106228,3420.472481,22.73684211,77770.74273,87,82,82,5,0,47,2,male
62 ms,4100 KB,Brazil,America,71,648,365.8862514,3985.036133,82.33333333,328101.3083,127,87,65,40,22,28,3,male
93 ms,72000 KB,United States,America,62,537,307.9068682,3197.403419,94.62962963,302569.1013,95,71,62,24,9,33,3,male
77 ms,52500 KB,Armenia,Europe,78,558,412.5946318,3507.254438,62.57142857,219453.9206,99,73,67,26,6,32,3,male
202 ms,73500 KB,Belarus,Europe,73,748,378.8670746,4629.98877,106.0540541,491029.0793,111,87,72,24,15,44,3,male
280 ms,74000 KB,Romania,Europe,46,440,211.2067179,2430.367261,25.3125,61518.67129,123,105,96,18,9,36,2,male
265 ms,75400 KB,Brazil,America,79,659,419.0808777,4154.191513,77.68421053,322715.0881,126,88,70,38,18,34,2,male
77 ms,21600 KB,Cuba,America,70,698,359.4212455,4278.239546,97.375,416593.5758,132,82,44,50,38,34,5,female
62 ms,35900 KB,United States,America,44,111,196.8070275,605.9969097,19.73684211,11960.46532,118,89,71,29,18,37,4,male
62 ms,9200 KB,Brazil,America,83,743,446.1369639,4736.654297,85.9047619,406901.1597,116,73,49,43,24,31,3,male
77 ms,70100 KB,United States,America,77,616,405.6268983,3860.340509,55.9625,216034.3057,110,76,67,34,9,27,3,male
108 ms,36900 KB,Croatia,Europe,84,681,453.5050955,4353.168165,53.69565217,233746.2036,135,108,101,27,7,44,3,male
46 ms,5000 KB,United Kingdom,Europe,76,514,398.842491,3211.434742,54,173417.4761,119,75,59,44,16,26,4,male
46 ms,8700 KB,Romania,Europe,92,635,509.7104706,4142.461842,66.22641509,274340.3975,122,91,81,31,10,33,2,male
249 ms,103100 KB,France,Europe,73,750,379.3421297,4642.368419,91.575,425124.888,107,75,51,32,24,46,2,male
62 ms,64400 KB,Poland,Europe,81,626,432.536756,3968.746102,68.29268293,271036.3191,112,72,54,40,18,34,5,male
61 ms,70400 KB,Cuba,America,93,569,516.8946117,3720.781364,57.77777778,214978.4788,111,61,43,50,18,39,3,male
140 ms,104300 KB,Brazil,America,67,560,339.5249056,3397.009947,84.11428571,285737.0652,112,92,79,20,13,21,3,male
124 ms,133600 KB,Ukraine,Europe,74,618,385.4995491,3837.44218,83.5,320426.422,94,66,47,28,19,52,2,male
77 ms,53500 KB,Slovenia,Europe,121,851,724.4760109,5887.952615,67.25316456,395983.4461,109,79,73,30,6,34,10,male
421 ms,5400 KB,Serbia and Montenegro,Europe,80,648,425.7903187,4096.609405,67.06097561,274722.6234,109,100,99,9,1,38,5,male
61 ms,51900 KB,Brazil,America,88,727,480.9553238,4696.006787,91.66666667,430467.2888,120,82,65,38,17,32,3,male
264 ms,67400 KB,Peru,America,60,560,294.4615345,3307.858734,27.25862069,90167.66651,88,72,72,16,0,18,2,male
140 ms,5800 KB,United Kingdom,Europe,95,756,531.8959763,4966.81084,72.33333333,359265.9841,101,78,75,23,3,31,3,male
93 ms,71000 KB,Italy,Europe,69,601,352.7497745,3671.223199,74,271670.5167,111,87,81,24,6,38,2,male
61 ms,36900 KB,Brazil,America,77,592,405.7769322,3709.937632,74.19512195,275259.275,95,53,39,42,14,34,3,male
62 ms,36900 KB,Bulgaria,Europe,87,593,474.2088866,3820.665493,69.875,266969.0013,90,59,46,31,13,33,3,male
78 ms,36900 KB,Belarus,Europe,83,614,446.5546348,3914.274211,77.26666667,302442.9207,89,72,68,17,4,27,2,male
217 ms,69000 KB,Brazil,America,55,496,264.5725015,2867.554418,86.25,247326.5685,85,58,36,27,22,33,2,male
139 ms,26500 KB,Brazil,America,88,759,481.614055,4902.708599,75.24,368879.795,106,68,47,38,21,24,3,male
61 ms,6200 KB,Canada,America,86,559,466.7930215,3592.281998,51.02222222,183286.2104,84,74,74,10,0,32,2,male
62 ms,4600 KB,Ukraine,Europe,66,699,334.0271833,4225.031489,105.1785714,444382.7763,98,79,76,19,3,50,1,female
109 ms,97600 KB,Armenia,Europe,38,437,188.1173001,2293.344323,18,41280.19782,111,90,90,21,0,35,2,male
46 ms,9900 KB,United States,America,85,687,460.2145365,4403.251573,89.05128205,392115.1978,101,76,65,25,11,27,4,male
93 ms,55900 KB,Ukraine,Europe,57,580,277.6324012,3383.076208,85.11363636,287945.9182,118,99,85,19,14,30,2,male
436 ms,4100 KB,Brazil,America,72,673,372.3949821,4152.359526,82.14705882,341104.1222,134,94,72,40,22,30,3,male
78 ms,9200 KB,Brazil,America,81,775,432.536756,4913.383752,83.41463415,409848.1081,117,78,56,39,22,33,3,male
61 ms,10600 KB,Brazil,America,75,541,393.7950768,3369.790912,51.80645161,174576.9098,83,49,43,34,6,32,9,male
62 ms,10600 KB,Brazil,America,75,546,393.7950768,3400.935005,51.80645161,176190.3748,83,49,43,34,6,32,9,male
62 ms,39800 KB,Romania,Europe,78,541,412.5946318,3400.4026,69.85714286,237542.4102,102,85,76,17,9,29,3,male
62 ms,35900 KB,Serbia,Europe,89,533,490.2888307,3451.565919,38.88888889,134227.5635,105,73,63,32,10,24,3,male
108 ms,87900 KB,Spain,Europe,56,682,270.0391,3960.616057,130,514880.0874,114,71,43,43,28,34,4,male
202 ms,4600 KB,Czechia,Europe,59,505,288.0881667,2970.73474,67.24137931,199756.3015,126,99,76,27,23,26,1,male
78 ms,68000 KB,Poland,Europe,58,616,282.5614107,3608.516293,56.1,202437.764,93,88,87,5,1,47,2,male
77 ms,36900 KB,Bulgaria,Europe,80,733,426.6582949,4633.973294,87.5,405472.6632,116,90,72,26,18,38,2,male
62 ms,55700 KB,Ukraine,Europe,85,623,461.7177151,3993.050553,69.3,276718.4033,101,83,76,18,7,32,4,male
249 ms,131200 KB,Macedonia,Europe,72,635,372.5956925,3917.902376,45.5,178264.5581,143,106,90,37,16,31,3,male
171 ms,36900 KB,Brazil,America,82,658,439.460071,4183.269219,69.8372093,292147.848,127,84,70,43,14,33,2,male
327 ms,86000 KB,Croatia,Europe,78,504,413.1887278,3167.842718,44,139385.0796,107,69,52,38,17,26,3,male
46 ms,13400 KB,United States,America,73,597,379.6596322,3695.325262,85.84375,317220.5779,86,58,48,28,10,31,1,male
93 ms,83500 KB,Brazil,America,65,526,328.9735285,3167.76547,117.6,372529.2192,97,74,62,23,12,28,2,male
93 ms,59700 KB,Mexico,America,87,664,474.2088866,4278.114481,61.75,264173.5692,91,61,60,30,1,15,3,male
78 ms,51800 KB,United States,America,78,673,412.2983693,4230.075693,76.475,323495.0386,124,89,74,35,15,37,2,male
62 ms,39800 KB,Peru,America,93,662,516.4569079,4328.923133,55.09433962,238499.1613,97,76,75,21,1,26,3,male
62 ms,5800 KB,Peru,America,83,573,447.1829761,3652.897594,37.91489362,138499.2237,112,86,79,26,7,19,5,male
93 ms,50800 KB,Romania,Europe,75,576,392.6333688,3587.799566,76.29268293,273722.8547,91,72,63,19,9,34,3,male
140 ms,145300 KB,Ukraine,Europe,69,590,352.582306,3604.029429,55,198221.6186,141,106,79,35,27,39,2,male
62 ms,27800 KB,Poland,Europe,84,716,452.9890166,4576.899275,39.85365854,182406.1809,116,74,65,42,9,21,4,male
124 ms,103800 KB,Brazil,America,86,701,468.818598,4504.811593,63.1372549,284421.4378,117,64,37,53,27,37,9,male
124 ms,115000 KB,Poland,Europe,71,533,365.6422056,3277.815215,52.97142857,173630.5545,112,84,77,28,7,37,2,female
92 ms,68100 KB,United States,America,76,533,399.1845378,3330.145365,43.92857143,146288.5285,98,64,58,34,6,20,2,male
124 ms,40800 KB,Argentina,America,76,604,398.8804611,3773.748218,66.41025641,250615.5868,91,79,74,12,5,47,3,male
155 ms,52800 KB,Romania,Europe,80,628,428.700868,3970.170844,65.79591837,261221.0367,112,82,63,30,19,32,3,male
109 ms,95600 KB,Ukraine,Europe,62,639,307.5796744,3804.731442,99.57142857,378842.545,107,89,83,18,6,41,2,male
156 ms,56900 KB,Brazil,America,108,689,624.2149912,4654.117489,63.59375,295972.7841,112,77,64,35,13,38,5,male
311 ms,69600 KB,Peru,America,60,564,301.5359818,3331.486296,49,163242.8285,128,102,88,26,14,39,5,male
342 ms,69600 KB,Peru,America,60,564,301.5359818,3331.486296,49,163242.8285,128,102,88,26,14,39,5,male
77 ms,59400 KB,Romania,Europe,72,615,372.3949821,3794.503876,53.68421053,203704.9449,130,102,82,28,20,39,2,male
77 ms,68200 KB,Ukraine,Europe,83,533,446.2065082,3397.896017,52.1375,177157.8036,87,75,69,12,6,32,4,female
171 ms,181500 KB,Ireland,Europe,53,616,252.9035678,3528.399,45.375,160101.1046,122,110,105,12,5,46,2,male
140 ms,68100 KB,Ukraine,Europe,81,618,433.2506894,3918.027302,71.6,280530.7548,107,67,56,40,11,31,3,male
46 ms,13700 KB,Peru,America,98,828,552.134363,5476.979751,90.63157895,496387.3227,114,63,25,51,38,41,3,male
233 ms,68000 KB,Ukraine,Europe,57,583,276.0964047,3400.574878,64.64,219813.1601,106,88,83,18,5,45,2,male
78 ms,46100 KB,Poland,Europe,108,772,621.9557072,5214.773152,71.55172414,373126.01,108,2,-5,106,7,2,2,male
77 ms,49800 KB,Belarus,Europe,61,567,304.2381821,3362.72807,117,393439.1842,102,84,77,18,7,36,2,male
62 ms,17300 KB,Cuba,America,79,861,419.2271063,5427.555224,79.28571429,430327.5928,138,96,62,42,34,32,1,male
202 ms,52600 KB,Croatia,Europe,74,688,385.8508604,4272.103916,85.425,364944.477,110,87,79,23,8,32,2,male
46 ms,8600 KB,Canada,America,69,728,352.582306,4447.005805,78,346866.4528,128,105,94,23,11,48,5,male
109 ms,5700 KB,Belarus,Europe,62,527,309.4603455,3137.861456,79.16666667,248414.0319,89,76,74,13,2,28,1,male
171 ms,5900 KB,Belarus,Europe,55,639,265.9634675,3694.288857,69.125,255367.7172,115,106,102,9,4,42,1,male
140 ms,99500 KB,Czechia,Europe,45,538,216.7497745,2954.616966,25.4375,75158.06907,104,73,70,31,3,41,4,male
202 ms,71000 KB,Canada,America,48,556,225.0683649,3105.23915,42.9,133214.7596,138,114,104,24,10,37,2,male
171 ms,115500 KB,Poland,Europe,79,588,419.0808777,3706.62308,76.06578947,281947.2109,107,71,61,36,10,36,3,male
327 ms,71000 KB,Brazil,America,83,748,446.8336245,4768.529495,76.01086957,362460.0734,132,92,60,40,32,41,2,male
234 ms,99700 KB,Netherlands,Europe,71,662,367.9353223,4071.132593,53.75,218823.3769,101,55,51,46,4,26,3,male
46 ms,35900 KB,Spain,Europe,85,667,462.267429,4275.063754,75.33333333,322054.8028,103,86,76,17,10,34,3,male
62 ms,6500 KB,United States,America,80,731,425.8985773,4621.329437,91.73684211,423946.1689,109,77,56,32,21,45,3,male
124 ms,100900 KB,France,Europe,90,672,495.0699333,4362.525281,71.6,312356.8101,117,96,88,21,8,31,3,male
62 ms,37800 KB,Ukraine,Europe,100,774,564.8477751,5142.344691,58.77777778,302255.5935,114,61,37,53,24,32,7,male
109 ms,99900 KB,Poland,Europe,95,698,529.5086837,4585.759215,74.62745098,342223.521,103,75,59,28,16,32,6,male
296 ms,72400 KB,Brazil,America,79,729,419.0808777,4595.456165,60.24390244,276848.2129,139,118,116,21,2,34,5,male
155 ms,129800 KB,Germany,Europe,57,631,280.1318683,3680.553599,107,393819.2351,124,94,78,30,16,35,3,male
62 ms,11700 KB,Lithuania,Europe,94,865,524.1054708,5669.719357,95.01818182,538726.4247,132,101,94,31,7,44,5,male
108 ms,86700 KB,Serbia,Europe,68,679,347.0121354,4133.387269,131.1206897,541972.5894,117,100,90,17,10,40,3,male
62 ms,48800 KB,Germany,Europe,92,644,508.6701412,4201.1739,45.36,190565.2481,105,65,55,40,10,25,2,male
326 ms,79100 KB,United States,America,72,726,372.5956925,4479.365551,105.7727273,473794.7108,111,94,83,17,11,47,3,male
62 ms,6000 KB,Belarus,Europe,72,649,374.2108333,4004.281326,58.56896552,234526.6149,128,104,89,24,15,26,1,male
77 ms,61000 KB,Mexico,America,103,867,587.2909311,5797.195957,54.44067797,315603.2782,137,91,75,46,16,40,11,female
62 ms,8200 KB,Brazil,America,85,835,460.8279746,5351.841432,85.94791667,459979.6214,139,94,68,45,26,38,8,male
124 ms,91600 KB,Cuba,America,61,590,306.0981941,3499.135029,39.975,139877.9228,142,90,64,52,26,35,5,male
374 ms,73700 KB,Poland,Europe,80,699,425.7903187,4419.027738,71.34146341,315259.9057,126,85,72,41,13,27,8,male
61 ms,8800 KB,Brazil,America,93,879,517.3960298,5747.920595,85.67272727,492440.0335,142,113,102,29,11,43,8,male
62 ms,2900 KB,United States,America,73,615,381.7393272,3806.742104,70.71428571,269191.0488,91,75,69,16,6,35,5,male
93 ms,261800 KB,Ukraine,Europe,75,626,392.17102,3899.2405,72.91891892,284328.4019,131,95,90,36,5,39,2,male
187 ms,83900 KB,Poland,Europe,88,750,483.1046897,4844.573714,75.94339623,367913.3811,119,79,54,40,25,40,2,male
109 ms,20100 KB,Cuba,America,74,681,386.9094701,4228.637742,125.5322581,530830.4443,114,89,74,25,15,32,4,male
62 ms,8200 KB,Brazil,America,87,650,473.7434822,4187.913272,46.79347826,195967.0287,126,75,51,51,24,32,2,male
93 ms,68100 KB,Latvia,Europe,58,518,287.9357738,3034.434155,33.33333333,101147.8052,124,105,105,19,0,38,3,male
77 ms,36900 KB,United States,America,89,725,487.9979062,4694.906737,46.93877551,220373.1734,113,88,88,25,0,29,3,male
92 ms,68100 KB,Mexico,America,91,836,501.4075845,5440.516319,107.5,584855.5043,152,114,91,38,23,45,5,male
218 ms,74600 KB,Brazil,America,88,672,480.4627738,4340.738048,108.8372093,472433.8154,96,75,71,21,4,27,6,male
140 ms,115700 KB,Ukraine,Europe,87,594,473.6107211,3827.108437,53.57142857,205023.6662,128,96,89,32,7,21,4,male
702 ms,46100 KB,Ukraine,Europe,90,846,495.8441109,5492.107719,60.65384615,333117.4567,125,101,97,24,4,43,5,male
93 ms,71100 KB,United States,America,66,616,333.3240179,3723.346778,94.2,350739.2664,114,71,54,43,17,23,2,male
62 ms,11600 KB,Lithuania,Europe,93,901,516.8946117,5891.782089,98.94444444,582959.1056,138,107,100,31,7,46,5,male
61 ms,11800 KB,Lithuania,Europe,89,899,488.323496,5821.684354,104.91,610752.9056,138,107,100,31,7,46,5,male
78 ms,6200 KB,Brazil,America,90,735,494.5555318,4771.512026,51.1875,244241.7718,144,82,54,62,28,29,3,male
46 ms,5500 KB,United States,America,83,518,446.1369639,3302.270425,43.02439024,142078.1715,95,58,47,37,11,20,1,female
46 ms,5500 KB,Belarus,Europe,96,805,536.1564001,5300.894813,82.5,437323.8221,146,114,105,32,9,43,5,male
374 ms,36500 KB,Peru,America,92,680,509.2999891,4436.02213,71.92307692,319052.3609,127,91,76,36,15,33,9,male
202 ms,116900 KB,Belarus,Europe,62,682,307.9068682,4060.761884,117.962963,479019.5037,113,108,108,5,0,46,2,male
62 ms,5300 KB,Bosnia and Herzegovina,Europe,53,734,253.6843594,4204.293614,125.2631579,526643.0948,103,85,80,18,5,41,1,male
108 ms,72000 KB,Argentina,America,75,757,392.2479866,4715.215749,50.91666667,240083.0685,160,119,100,41,19,30,2,male
108 ms,42900 KB,Ukraine,Europe,83,890,446.3456778,5673.785094,111.6818182,633658.6353,157,112,90,45,22,45,4,male
124 ms,91400 KB,Canada,America,66,673,334.0271833,4067.877242,73.96428571,300877.6346,117,98,92,19,6,42,3,male
93 ms,72000 KB,United States,America,67,824,341.2590864,4998.457493,65.92592593,329527.9384,135,99,95,36,4,41,3,male
61 ms,7600 KB,Slovakia,Europe,86,863,466.7930215,5545.866483,111.1555556,616453.87,120,80,77,40,3,38,1,male
140 ms,5800 KB,Mexico,America,66,725,334.0271833,4382.185737,43.42857143,190312.0663,155,102,81,53,21,27,3,male
93 ms,68900 KB,Poland,Europe,95,697,529.2046323,4579.189359,48.34693878,221389.7876,133,87,76,46,11,28,9,male
62 ms,13800 KB,Poland,Europe,63,669,323.5707183,3998.800269,52.76470588,210995.5201,126,82,72,44,10,17,5,female
93 ms,68000 KB,Ukraine,Europe,90,792,494.2667787,5141.547652,52.5,269931.2517,143,79,43,64,36,38,9,male
202 ms,4100 KB,Bulgaria,Europe,63,602,313.8551855,3598.322514,62.72413793,225701.6777,137,117,103,20,14,40,2,male
46 ms,6600 KB,Colombia,America,82,611,440.5905816,3884.464275,64.04255319,248771.0099,116,82,67,34,15,25,2,male
61 ms,6500 KB,Colombia,America,67,641,339.9564924,3888.363171,30.21666667,117493.3738,104,83,79,21,4,39,7,male
202 ms,57800 KB,Iceland,Europe,79,700,419.0808777,4412.646524,43.69736842,192821.0409,123,74,52,49,22,30,3,male
108 ms,82500 KB,Poland,Europe,94,749,522.1313521,4909.38705,54,265106.9007,117,99,93,18,6,20,8,male
61 ms,6600 KB,United States,America,89,753,489.1726399,4876.227274,80.40384615,392067.4275,117,101,93,16,8,32,3,male
124 ms,114100 KB,Armenia,Europe,59,697,290.8572701,4100.202205,105.1136364,430987.1636,153,118,118,35,0,49,4,male
77 ms,8200 KB,Brazil,America,87,650,473.7434822,4187.913272,46.79347826,195967.0287,126,75,51,51,24,32,2,male
62 ms,9500 KB,Bulgaria,Europe,73,798,378.8670746,4939.479998,104.3194444,515283.8092,97,84,84,13,0,43,3,male
62 ms,5500 KB,Cuba,America,84,584,453.092115,3733.113375,68.63636364,256227.3271,142,96,72,46,24,30,1,male
62 ms,36800 KB,United States,America,92,753,509.2999891,4912.242153,55.38461538,272062.6423,148,89,83,59,6,28,2,male
124 ms,113800 KB,Belarus,Europe,62,536,310.1726115,3191.449222,28.82608696,91996.9928,121,85,76,36,9,44,2,male
61 ms,9800 KB,Austria,Europe,77,688,405.6268983,4311.54914,93.8875,404800.5699,113,95,83,18,12,40,2,male
62 ms,31300 KB,Belarus,Europe,42,520,201.6270751,2804.00506,18,50472.09108,158,76,28,82,48,30,3,female
108 ms,88000 KB,Lithuania,Europe,77,597,405.551932,3741.271565,37.51282051,140345.6487,130,73,51,57,22,34,5,male
156 ms,121300 KB,Portugal,Europe,49,728,234.2230164,4087.508767,36,147150.3156,104,73,71,31,2,39,3,male
249 ms,67400 KB,Ukraine,Europe,84,629,453.092115,4020.767659,48.63636364,195555.518,137,86,74,51,12,25,3,female
61 ms,5700 KB,Slovakia,Europe,68,607,348.6887644,3695.089945,45.23076923,167131.7606,99,70,66,29,4,26,1,male
592 ms,114300 KB,United States,America,85,663,459.8067162,4249.426191,60.55813953,257337.3442,145,79,51,66,28,41,6,male
234 ms,4900 KB,Mexico,America,68,550,346.1173001,3348.104563,38.25,128064.9995,101,77,72,24,5,33,1,male
78 ms,48900 KB,Poland,Europe,94,773,523.6410489,5066.697182,85.92592593,435360.6468,157,88,49,69,39,41,3,male
46 ms,19500 KB,Ukraine,Europe,62,638,308.8461793,3798.777246,100.64,382308.942,94,80,73,14,7,33,2,male
46 ms,4100 KB,Germany,Europe,71,636,365.7235111,3911.239168,85.97058824,336251.532,117,99,90,18,9,39,3,female
62 ms,8700 KB,United States,America,79,758,419.4466845,4778.265807,71.58139535,342034.9338,124,80,60,44,20,50,6,male
93 ms,99500 KB,Italy,Europe,61,673,302.2137048,3991.386228,70.56,281632.2123,121,90,80,31,10,41,2,male
62 ms,42900 KB,Germany,Europe,117,932,693.6387335,6403.179919,75.88,485873.2922,116,70,65,46,5,38,3,male
93 ms,42800 KB,United States,America,76,1009,398.842491,6304.158861,123,775411.5399,134,99,95,35,4,49,2,male
46 ms,13000 KB,Romania,Europe,92,812,508.4501668,5297.132308,96.09183673,509011.1729,152,96,85,56,11,37,3,male
62 ms,9200 KB,Mexico,America,71,678,365.6422056,4169.528547,85.55555556,356726.3312,127,94,79,33,15,35,4,male
139 ms,77400 KB,United States,America,58,625,303.6501074,3661.238122,32.66666667,119600.4453,131,90,89,41,1,31,4,male
171 ms,37000 KB,United States,America,78,725,412.85429,4556.916609,87.5,398730.2033,121,98,88,23,10,34,5,male
46 ms,6200 KB,United States,America,88,697,480.5611817,4502.223838,81.5952381,367360.026,122,86,78,36,8,33,1,male
109 ms,87500 KB,Brazil,America,94,982,524.6331211,6436.606252,71.92857143,462975.8926,227,167,133,60,34,62,6,male
109 ms,4400 KB,Canada,America,67,681,339.6973857,4131.006739,95.22580645,393378.4481,101,93,89,8,4,37,2,male
249 ms,185100 KB,Venezuela,America,72,986,372.8771238,6083.546051,73.6,447748.9894,197,150,130,47,20,45,2,male
93 ms,68200 KB,Mexico,America,71,646,365.7235111,3972.736639,66.92647059,265881.2418,139,112,94,27,18,45,2,male
62 ms,33500 KB,United States,America,93,803,515.149526,5250.944525,92.4673913,485541.1421,184,103,85,81,18,24,6,male
170 ms,111300 KB,United States,America,104,771,595.637503,5166.039023,85.69354839,442696.215,137,83,67,54,16,37,12,male
61 ms,9400 KB,Canada,America,83,639,446.2065082,4073.650197,62.3255814,253892.6169,133,89,69,44,20,33,1,male
46 ms,39200 KB,Cuba,America,85,761,459.8067162,4877.546502,48.34883721,235823.7018,125,72,61,53,11,37,2,male
46 ms,23300 KB,Peru,America,94,1047,522.6230769,6862.654528,105.8137255,726163.0423,171,134,121,37,13,40,8,male
62 ms,9300 KB,United States,America,92,865,508.1677,5642.881092,128,722288.7798,135,102,93,33,9,39,5,male
62 ms,24900 KB,Canada,America,101,932,571.6579841,6205.453102,98.26415094,609773.5803,119,96,85,23,11,45,8,male
46 ms,8700 KB,Bolivia,America,101,816,572.689722,5433.10057,52.10526316,283093.135,134,100,100,34,0,37,2,male
46 ms,9100 KB,United States,America,105,757,604.3310316,5082.683857,45.23076923,229893.7006,134,72,52,62,20,19,1,male
62 ms,11800 KB,Brazil,America,97,852,543.1989824,5623.125742,74.01041667,416169.8791,159,113,92,46,21,55,8,male
62 ms,8700 KB,United States,America,80,1040,425.7903187,6574.805219,57.82051282,380158.6094,220,119,70,101,49,28,4,male
124 ms,115800 KB,United States,America,76,880,399.1845378,5498.176212,59.15714286,325256.3956,140,80,68,60,12,26,2,male
46 ms,9900 KB,United States,America,91,849,501.4075845,5525.11765,109.9534884,607505.9592,153,94,55,59,39,41,11,male
155 ms,63400 KB,Canada,America,91,910,501.2172393,5922.093123,103.6956522,614095.3086,119,57,57,62,0,41,9,male
1294 ms,5900 KB,Canada,America,68,850,346.3298602,5174.343415,118.1612903,611407.0945,151,109,80,42,29,32,1,male
77 ms,66600 KB,United States,America,81,681,434.0394126,4317.437852,55.98529412,241713.028,135,87,66,48,21,30,11,male
139 ms,6200 KB,Mexico,America,85,771,460.0105131,4941.640412,34.22222222,169113.9163,146,81,64,65,17,29,5,male
218 ms,58400 KB,Cuba,America,75,676,392.6333688,4210.681435,67.17073171,282834.553,162,123,117,39,6,35,2,male
405 ms,99900 KB,Canada,America,115,1220,673.6467173,8351.497862,72.69230769,607089.6523,124,83,76,41,7,79,20,male
124 ms,39400 KB,United States,America,84,942,454.645688,6021.563012,97.3,585898.0811,113,74,65,39,9,46,12,male
124 ms,130100 KB,Cuba,America,78,885,412.2983693,5562.580964,77.425,430682.8311,183,107,76,76,31,47,2,male
124 ms,18300 KB,Brazil,America,98,1274,550.3593685,8427.140341,159.4313725,1343550.551,175,140,118,35,22,76,4,male
62 ms,8800 KB,Canada,America,165,1379,1069.424165,10158.15833,98.91304348,1004774.357,143,102,92,41,10,54,14,male
140 ms,18300 KB,Brazil,America,99,1284,557.3718925,8512.0939,162.8235294,1385969.172,176,141,119,35,22,77,4,male
61 ms,5800 KB,Peru,America,124,1290,743.6082397,8970.91324,86.06493506,772081.0655,210,153,135,57,18,62,12,male
187 ms,91100 KB,Cuba,America,97,857,545.3518546,5656.125306,56.84210526,321506.07,152,88,71,64,17,37,3,male
108 ms,74000 KB,Brazil,America,65,376,329.6987322,2264.410298,41.85416667,94775.006,200,106,76,94,30,56,9,male
62 ms,6900 KB,Bolivia,America,114,1216,666.1928095,8308.794257,133.984375,1113248.606,171,98,75,73,23,44,6,male
93 ms,91700 KB,United States,America,96,703,538.6054173,4629.228638,66.71052632,308818.2789,186,93,64,93,29,32,8,male
62 ms,18400 KB,United States,America,144,1204,899.2570652,8632.589702,78.65789474,679021.3321,170,89,75,81,14,45,9,male
62 ms,18400 KB,United States,America,145,1205,907.2771824,8651.790453,78.09375,675650.7607,170,89,75,81,14,45,9,male
61 ms,18400 KB,United States,America,144,1204,899.2570652,8632.589702,78.65789474,679021.3321,170,89,75,81,14,45,9,male
61 ms,18400 KB,United States,America,142,1206,883.2625518,8622.595026,81.13978495,699635.5061,171,90,76,81,14,46,9,male
78 ms,94300 KB,United States,America,108,1213,622.4916358,8193.67854,146.4,1199554.538,238,162,112,76,50,63,11,male
78 ms,94300 KB,United States,America,108,1213,622.4916358,8193.67854,146.4,1199554.538,238,162,112,76,50,63,11,male
78 ms,6200 KB,Cuba,America,118,1076,696.1402827,7405.723921,111.3970588,824975.8633,256,145,89,111,56,40,13,male
171 ms,53200 KB,Cuba,America,70,1116,359.4212455,6840.279847,93.21875,637642.337,213,170,156,43,14,58,3,male
62 ms,10100 KB,Brazil,America,78,1196,412.2983693,7517.341054,75.26315789,565778.8267,273,186,122,87,64,65,11,male
124 ms,99600 KB,United States,America,144,1580,895.0307038,11328.4815,97.8,1107925.491,230,127,97,103,30,64,24,male
171 ms,42300 KB,Canada,America,131,1282,795.04794,9016.848288,75.225,678292.4125,171,108,96,63,12,51,7,male
93 ms,69100 KB,United States,America,168,1614,1088.655007,11931.20032,84.44690265,1007552.912,199,106,84,93,22,65,38,male
92 ms,68200 KB,United States,America,109,1193,628.7387094,8074.443899,61.11111111,493438.2383,264,130,79,134,51,53,19,male
77 ms,68000 KB,United States,America,160,1693,1025.950716,12396.02426,100.3888889,1244423.103,226,134,112,92,22,73,34,male
77 ms,66500 KB,Argentina,America,95,1474,529.5086837,9683.967167,91.45098039,885608.2915,266,197,171,69,26,52,13,male
46 ms,5700 KB,United States,America,130,1828,783.4632469,12836.88836,118.2857143,1518420.509,319,218,187,101,31,76,22,male
46 ms,5700 KB,United States,America,134,1892,813.6321704,13369.04075,126.1780822,1686879.922,324,221,188,103,33,77,24,male
61 ms,5800 KB,United States,America,134,1892,813.6321704,13369.04075,126.1780822,1686879.922,324,221,188,103,33,77,24,male
62 ms,5700 KB,United States,America,134,1892,813.6321704,13369.04075,126.1780822,1686879.922,324,221,188,103,33,77,24,male
61 ms,17700 KB,United States,America,121,1803,716.9047961,12474.71042,79.16666667,987581.2413,256,145,103,111,42,69,37,male
62 ms,39900 KB,United States,America,170,2073,1102.186649,15359.66741,95.80357143,1471510.994,296,168,127,128,41,100,56,male
